symbol,datetime,close,high,low,open,volume,change_in_price,down_days,up_days,RSI,low_14,high_14,k_percent,r_percent,MACD,MACD_EMA,Price_Rate_Of_Change,On Balance Volume,Prediction,sentiment
BSESN,8/1/2003,3815.3100590000004,3831.459961,3779.7299799999996,3800.7299799999996,26000,22.699952,0.0,22.699952,75.90951227,3534.0600590000004,3835.75,93.22485167,-6.77514833,20.98607654,8.394436387,0.068840025,143800,1,-0.3802
BSESN,8/4/2003,3832.5,3840.719971,3785.850098,3798.8100590000004,19800,17.189941,0.0,17.189941,78.09818786,3534.0600590000004,3840.719971,97.31951563,-2.680484367,24.85861934,11.7826425,0.078323001,163600,1,0.0
BSESN,8/5/2003,3765.820068,3878.719971,3761.8400880000004,3845.929932,26000,-66.679932,66.679932,0.0,55.52129921,3534.0600590000004,3878.719971,67.24309992,-32.75690008,23.37702193,14.15493773,0.052525422,137600,-1,0.0
BSESN,8/6/2003,3741.6599119999996,3798.8701170000004,3722.080078,3754.649902,29000,-24.160156,24.160156,0.0,49.53463876,3534.0600590000004,3878.719971,60.2332461,-39.7667539,20.43208192,15.43339725,0.020062279,108600,-1,-0.4767
BSESN,8/7/2003,3806.830078,3816.1599119999996,3733.6298829999996,3749.179932,24200,65.17016600000001,0.0,65.17016600000001,62.215214399999994,3534.0600590000004,3878.719971,79.14178862,-20.85821138,22.10093651,16.78640398,0.021567417000000002,132800,1,0.0
BSESN,8/8/2003,3883.76001,3890.780029,3823.389893,3824.26001,29200,76.929932,0.0,76.929932,71.8496092,3534.0600590000004,3890.780029,98.03206448,-1.967935521,28.1351317,19.08262313,0.038505145,162000,1,0.0
BSESN,8/11/2003,3893.4099119999996,3915.899902,3842.139893,3842.139893,21800,9.649902,0.0,9.649902,72.85151866,3551.9799799999996,3915.899902,93.82007177,-6.179928232000001,33.09853425,21.91190083,0.034260069,183800,1,0.0
BSESN,8/12/2003,3889.4099119999996,3938.9099119999996,3879.350098,3907.030029,27400,-4.0,4.0,0.0,71.63214447,3572.639893,3938.9099119999996,86.48538034,-13.51461966,36.27856708,24.80659314,0.028830127999999997,156400,-1,0.0
BSESN,8/13/2003,3926.070068,3935.8000490000004,3874.3400880000004,3910.459961,25200,36.660156,0.0,36.660156,75.89822993,3661.6899409999996,3938.9099119999996,95.36835533,-4.631644666000001,40.80536141,28.02534697,0.035189476000000004,181600,1,0.0
BSESN,8/14/2003,3921.1999509999996,3959.100098,3908.6999509999996,3932.5900880000004,22600,-4.870117,4.870117,0.0,74.18809547,3694.9399409999996,3959.100098,85.65258765,-14.34741235,43.504782399999996,31.13592333,0.027753941,159000,-1,-0.3182
BSESN,8/18/2003,3977.7299799999996,3985.459961,3928.169922,3932.3701170000004,19400,56.530029000000006,0.0,56.530029000000006,80.17179453,3694.9399409999996,3985.459961,97.33926048,-2.660739525,49.02156223,34.72661637,0.03789432,178400,1,0.6249
BSESN,8/19/2003,4006.9099119999996,4026.2700200000004,3981.919922,3985.7700200000004,24400,29.179932,0.0,29.179932,82.57735732,3722.080078,4026.2700200000004,93.63552001,-6.364479993,54.79051521,38.75156078,0.064020543,202800,1,0.0
BSESN,8/20/2003,4056.600098,4066.030029,4027.600098,4027.600098,21200,49.690186,0.0,49.690186,85.93108718,3722.080078,4066.030029,97.2583421,-2.741657899,62.16725002,43.44604921,0.084171248,224000,1,0.0
BSESN,8/21/2003,4095.389893,4106.709961,4073.0600590000004,4075.169922,27000,38.789795,0.0,38.789795,88.00996624,3722.080078,4106.709961,97.05689326,-2.943106737,69.96817782,48.76075507,0.07580055,251000,1,0.0
BSESN,8/22/2003,4125.120117,4149.540039,4084.1899409999996,4146.560059,28000,29.730224,0.0,29.730224,89.39569858,3722.080078,4149.540039,94.28720249,-5.7127975079999995,77.38418347,54.494313,0.062145989000000006,279000,1,0.0
BSESN,8/25/2003,4004.6298829999996,4170.580078,3943.6599119999996,4149.819824,34200,-120.49023400000002,120.49023400000002,0.0,58.03196312,3722.080078,4170.580078,62.99884169,-37.00115831,73.52421976,58.30501177,0.028566211,244800,-1,0.0
BSESN,8/26/2003,4152.290039,4160.02002,4021.9099119999996,4021.9099119999996,28800,147.660156,0.0,147.660156,71.94840267,3722.080078,4170.580078,95.9219534,-4.0780466,80.45707213,62.73981586,0.067588692,273600,1,0.0
BSESN,8/27/2003,4205.560059,4222.390136999999,4173.359863000001,4173.359863000001,25600,53.270019999999995,0.0,53.270019999999995,75.3507637,3733.6298829999996,4222.390136999999,96.55657802,-3.443421977,88.86450125,67.96889584,0.071188233,299200,1,0.0
BSESN,8/28/2003,4212.290039,4256.069824,4179.330078,4256.069824,28600,6.72998,0.0,6.72998,75.77900989,3823.389893,4256.069824,89.88171582,-10.11828418,94.90765479999999,73.36006469,0.074234951,327800,1,0.0
BSESN,8/29/2003,4244.72998,4277.640136999999,4228.850098,4235.259765999999,35200,32.439941,0.0,32.439941,77.9132176,3842.139893,4277.640136999999,92.44313695,-7.556863045,100.9529747,78.88144638,0.067123712,363000,1,0.0
BSESN,9/1/2003,4324.759765999999,4329.569824,4248.069824,4248.069824,24800,80.029786,0.0,80.029786,82.34217503,3874.3400880000004,4329.569824,98.94337790000002,-1.0566221009999999,110.50696770000002,85.20911745,0.079325431,387800,1,-0.7184
BSESN,9/2/2003,4339.200195,4358.299805,4291.959961,4341.72998,31200,14.440429,0.0,14.440429,83.04982671,3874.3400880000004,4358.299805,96.05347112,-3.94652888,117.79384479999999,91.72817847,0.069664273,419000,1,0.0
BSESN,9/3/2003,4257.939941,4367.870117,4248.859863000001,4361.870117,28800,-81.260254,81.260254,0.0,65.90144133,3908.6999509999996,4367.870117,76.0589463,-23.941053699999998,116.0021067,96.58422483,0.039690982,390200,-1,0.0
BSESN,9/4/2003,4310.509765999999,4328.370117,4257.410156,4276.399902,33000,52.569825,0.0,52.569825,70.45521644,3928.169922,4367.870117,86.95466783,-13.04533217,117.25351809999998,100.7189422,0.044941637,423200,1,0.0
BSESN,9/5/2003,4369.169922,4371.97998,4314.680176,4314.680176,30800,58.66015600000001,0.0,58.66015600000001,74.78996232,3943.6599119999996,4371.97998,99.34393501,-0.656064987,121.35158259999999,104.8461561,0.09102964599999999,454000,1,-0.29600000000000004
BSESN,9/8/2003,4434.25,4444.620117,4399.609863000001,4399.609863000001,25200,65.080078,0.0,65.080078,78.77616554,3943.6599119999996,4444.620117,97.92995194,-2.070048059,128.13771979999999,109.50508810000001,0.067904688,479200,1,-0.29600000000000004
BSESN,9/9/2003,4425.200195,4473.569824,4398.089844,4458.640136999999,30400,-9.049805000000001,9.049805000000001,0.0,76.8270431,3943.6599119999996,4473.569824,90.87210337,-9.12789663,131.2863053,113.86179479999998,0.052226132,448800,-1,-0.1027
BSESN,9/10/2003,4434.259765999999,4438.22998,4378.649902,4410.120117,26600,9.059571,0.0,9.059571,77.47092175,3943.6599119999996,4473.569824,92.58174699,-7.418253011,132.9422936,117.6782192,0.052695737,475400,1,0.0
BSESN,9/11/2003,4393.129883,4463.379883,4381.089844,4423.709961,25800,-41.129883,41.129883,0.0,67.62754825,3943.6599119999996,4473.569824,84.8200724,-15.1799276,129.5449846,120.05173390000002,0.034960976,449600,-1,0.128
BSESN,9/12/2003,4305.910156,4437.0,4297.709961,4407.720215,26600,-87.219727,87.219727,0.0,51.58893094,4021.9099119999996,4473.569824,62.87922316,-37.12077684,118.6608777,119.7735475,-0.0043585329999999995,423000,-1,0.0
BSESN,9/15/2003,4193.830078,4310.169922,4184.109863000001,4310.169922,33800,-112.080078,112.080078,0.0,38.16750494,4173.359863000001,4473.569824,6.818632843,-93.18136716,100.0977055,115.8382077,-0.033501592999999996,389200,-1,0.0
BSESN,9/16/2003,4274.75,4290.069824,4134.689941,4195.100098,40400,80.919922,0.0,80.919922,49.18137567,4134.689941,4473.569824,41.33029608,-58.66970392,90.69722449,110.8098358,0.003947932,429600,1,0.0
BSESN,9/17/2003,4235.350098,4330.850098,4222.600098,4299.370117,32200,-39.399902000000004,39.399902000000004,0.0,44.70743192,4134.689941,4473.569824,29.70378652,-70.29621348,79.23286452,104.4942655,-0.017436376,397400,-1,0.0
BSESN,9/18/2003,4134.149902,4251.540039,4126.220215,4243.009765999999,33600,-101.20019599999999,101.20019599999999,0.0,35.21372303,4126.220215,4473.569824,2.282912315,-97.71708768,61.46122266,95.887465,-0.053790542000000004,363800,-1,0.4168
BSESN,9/19/2003,4217.120117,4224.72998,4097.549805,4159.720215,35400,82.970215,0.0,82.970215,46.05117001,4097.549805,4473.569824,31.79892185,-68.20107815,53.31722794,87.37326569,-0.048966540999999995,399200,1,-0.128
BSESN,9/22/2003,4151.720215,4237.419922,4141.799805,4230.910156,24600,-65.399902,65.399902,0.0,39.9700759,4097.549805,4473.569824,14.40625692,-85.59374308,41.21524678,78.14153015,-0.061800589,374600,-1,0.0
BSESN,9/23/2003,4231.689941,4240.02002,4111.540039,4138.009765999999,25200,79.969726,0.0,79.969726,49.39780013,4097.549805,4473.569824,35.67366875,-64.32633125,37.52790901,70.01871317,-0.045682895,399800,1,-0.7506
BSESN,9/24/2003,4356.390136999999,4366.830078,4229.870117,4249.930176,30400,124.70019599999999,0.0,124.70019599999999,60.54629631,4097.549805,4473.569824,68.83684882,-31.16315118,43.98975658,64.8128743,-0.008362999999999999,430200,1,-0.0258
BSESN,9/25/2003,4297.149902,4360.720215,4285.009765999999,4347.22998,31000,-59.240235,59.240235,0.0,54.02224909,4097.549805,4473.569824,53.08230597,-46.91769403,43.89715683,60.62970024,-0.0020344720000000003,399200,-1,0.0
BSESN,9/26/2003,4382.569824,4388.830078,4299.660156,4299.660156,24800,85.419922,0.0,85.419922,61.01185092,4097.549805,4473.569824,75.79916084,-24.20083916,50.03817183,58.51138217,0.045004147,424000,1,0.128
BSESN,9/29/2003,4402.049805,4426.299805,4385.540039,4392.870117,31600,19.479981,0.0,19.479981,62.51146812,4097.549805,4463.379883,83.23536481,-16.76463519,55.81006441,57.971116099999996,0.029779474,455600,1,0.0
BSESN,9/30/2003,4453.240234000001,4456.410156,4413.720215,4428.160156,30400,51.190428999999995,0.0,51.190428999999995,66.42696227,4097.549805,4463.379883,97.2283173,-2.771682705,63.72667158,59.12223149999999,0.051445602,486000,1,-0.2732
BSESN,10/1/2003,4455.080078,4487.049805,4432.930176,4452.069824,26400,1.8398439999999998,0.0,1.8398439999999998,66.57175337,4097.549805,4487.049805,91.79211117,-8.207888832,69.34557009999999,61.16690534,0.077629061,512400,1,0.0772
BSESN,10/3/2003,4552.919922,4556.890136999999,4465.439941,4465.439941,33000,97.839844,0.0,97.839844,73.56671122,4097.549805,4556.890136999999,99.13567028,-0.8643297190000001,80.67689140000002,65.06891189,0.07962775400000001,545400,1,0.1531
BSESN,10/6/2003,4631.390136999999,4637.27002,4552.390136999999,4567.680176,26400,78.470215,0.0,78.470215,77.85500135,4097.549805,4637.27002,98.91056832,-1.089431679,94.83027177,71.02119527,0.115535223,571800,1,0.5574
BSESN,10/7/2003,4632.939941,4688.330078,4601.160156,4644.859863000001,33400,1.5498040000000002,0.0,1.5498040000000002,77.93657048,4097.549805,4688.330078,90.6242406,-9.375759404,104.95785719999999,77.80853805,0.09482027400000001,605200,1,0.6369
BSESN,10/8/2003,4634.859863000001,4667.490234000001,4586.959961,4646.629883,28800,1.9199220000000001,0.0,1.9199220000000001,78.05212776,4097.549805,4688.330078,90.94922132,-9.050778681,111.8457366,84.61598609999999,0.063922128,634000,1,-0.29600000000000004
BSESN,10/9/2003,4698.680176,4710.279785,4643.319824,4643.319824,25400,63.820313,0.0,63.820313,81.72358548,4097.549805,4710.279785,98.10689709999998,-1.893102897,121.01643999999999,91.89608403,0.09344106699999999,659400,1,0.0
BSESN,10/10/2003,4768.899902,4780.77002,4730.310059,4735.089844,33200,70.219726,0.0,70.219726,84.92505853,4111.540039,4780.77002,98.22630212,-1.7736978819999998,132.38077520000002,99.99302862,0.088151494,692600,1,0.2023
BSESN,10/13/2003,4849.27002,4859.930176,4786.689941,4787.75,29600,80.370118,0.0,80.370118,87.75724261,4111.540039,4859.930176,98.57558839,-1.42441161,146.1414137,109.22271140000001,0.101593629,722200,1,0.0
BSESN,10/14/2003,4782.029785,4900.919922,4765.350098,4866.120117,37600,-67.240235,67.240235,0.0,74.28474796,4229.870117,4900.919922,82.28296378,-17.71703622,149.9241198,117.36299720000001,0.073831532,684600,-1,-0.5106
BSESN,10/15/2003,4855.259765999999,4867.910156,4738.720215,4790.540039,31800,73.22998100000001,0.0,73.22998100000001,78.44340270000001,4285.009765999999,4900.919922,92.58655576,-7.413444243,156.9853381,125.2874685,0.089825476,716400,1,0.0
BSESN,10/16/2003,4887.319824,4921.649902,4865.259765999999,4887.040039,39200,32.060058000000005,0.0,32.060058000000005,80.07142938,4299.660156,4921.649902,94.48060387,-5.519396135,163.2704801,132.8840733,0.07344735,755600,1,0.0
BSESN,10/17/2003,4930.529785,4949.22998,4901.589844,4912.27002,35400,43.209961,0.0,43.209961,82.16601097,4385.540039,4949.22998,96.68253881,-3.317461186,169.762144,140.25968930000002,0.064589603,791000,1,0.0
BSESN,10/20/2003,4851.669922,4951.109863000001,4838.700195,4951.109863000001,31000,-78.859863,78.859863,0.0,67.27582238,4413.720215,4951.109863000001,81.49574683,-18.50425317,166.6499153,145.5377356,0.047211918,760000,-1,0.0
BSESN,10/21/2003,4755.720215,4880.660156,4727.430176,4868.0,39400,-95.94970699999999,95.94970699999999,0.0,53.63121177,4432.930176,4951.109863000001,62.29307074,-37.70692926,154.68968590000003,147.368126,0.026076377,720600,-1,0.2023
BSESN,10/22/2003,4741.200195,4801.700195,4705.410156,4772.839844,34000,-14.52002,14.52002,0.0,51.7968828,4465.439941,4951.109863000001,56.77935600000001,-43.220644,142.4019357,146.3748878,0.009049354,686600,-1,0.0
BSESN,10/23/2003,4648.410156,4755.939941,4634.899902,4744.47998,31000,-92.79003900000001,92.79003900000001,0.0,41.36476994,4552.390136999999,4951.109863000001,24.08208391,-75.91791609,123.77640690000001,141.85519109999998,-0.025265732000000003,655600,-1,-0.3612
BSESN,10/24/2003,4757.370117,4772.069824,4599.609863000001,4654.27002,38400,108.959961,0.0,108.959961,53.93522718,4586.959961,4951.109863000001,46.79670517,-53.20329483,116.43572150000001,136.77129680000002,-0.018951286,694000,1,0.5423
BSESN,10/27/2003,4698.279785,4814.319824,4689.089844,4802.069824,31400,-59.090332,59.090332,0.0,47.55564915,4586.959961,4951.109863000001,30.56978002,-69.43021998,104.65810970000001,130.3486589,-0.017513484,662600,-1,-0.29600000000000004
BSESN,10/28/2003,4707.799805,4748.189941,4666.189941,4710.220215,34600,9.52002,0.0,9.52002,48.68399343,4599.609863000001,4951.109863000001,30.77949986,-69.22050014,94.99498411,123.27792360000001,-0.030371178,697200,1,-0.4215
BSESN,10/29/2003,4744.100098,4747.589844,4684.419922,4732.790039,34200,36.300292999999996,0.0,36.300292999999996,53.12147938,4599.609863000001,4951.109863000001,41.10675249,-58.89324751,89.22938972,116.4682165,-0.029304349,731400,1,0.0
BSESN,10/30/2003,4780.52002,4805.720215,4735.77002,4751.830078,42200,36.419922,0.0,36.419922,57.38727669,4599.609863000001,4951.109863000001,51.46803898,-48.53196102,86.59315551,110.4932041,-0.030424675,773600,1,-0.128
BSESN,10/31/2003,4906.870117,4913.180176,4779.089844,4787.049805,32200,126.35009699999999,0.0,126.35009699999999,68.76494116,4599.609863000001,4951.109863000001,87.41401252,-12.58598748,93.59667441,107.11389809999999,0.011377566,805800,1,-0.29600000000000004
BSESN,11/3/2003,5063.029785,5068.660156,4946.930176,4946.930176,40800,156.15966799999998,0.0,156.15966799999998,77.37841109,4599.609863000001,5068.660156,98.79962318,-1.200376822,110.44730729999999,107.7805799,0.064618934,846600,1,0.0
BSESN,11/4/2003,5097.839844,5135.0,5055.569824,5096.160156,44200,34.810059,0.0,34.810059,78.87665427,4599.609863000001,5135.0,93.05923785,-6.940762153,125.16137179999998,111.2567384,0.075221386,890800,1,0.0
BSESN,11/5/2003,5064.910156,5127.790039,5021.970215,5116.859863000001,36400,-32.929688,32.929688,0.0,73.55893508,4599.609863000001,5135.0,86.90864117,-13.09135883,132.6403654,115.5334638,0.089600527,854400,-1,0.0
BSESN,11/6/2003,5047.540039,5118.080078,5030.040039,5080.049805,34000,-17.370117,17.370117,0.0,70.65951843,4599.609863000001,5135.0,83.66425622,-16.33574378,135.6045498,119.5476811,0.060993766,820400,-1,0.0
BSESN,11/7/2003,4971.569824,5092.700195,4965.5,5071.200195,25200,-75.970215,75.970215,0.0,58.93630623,4599.609863000001,5135.0,69.47456356,-30.52543644,130.3302948,121.70420379999999,0.058168107000000004,795200,-1,0.34
BSESN,11/10/2003,4998.569824,5017.899902,4909.660156,4962.220215,34200,27.0,0.0,27.0,61.55217552,4599.609863000001,5135.0,74.51761499,-25.48238501,126.8632584,122.7360148,0.061763463,829400,1,0.0
BSESN,11/11/2003,5030.640136999999,5039.200195,4988.879883,4998.790039,29000,32.070313,0.0,32.070313,64.63937897,4599.609863000001,5135.0,80.50769788,-19.49230212,125.2558063,123.23997309999999,0.06039924,858400,1,-0.0516
BSESN,11/12/2003,5005.77002,5059.97998,4998.259765999999,5040.549805,27200,-24.870117,24.870117,0.0,60.30646665,4599.609863000001,5135.0,75.86246532,-24.13753468,120.5872434,122.7094271,0.047118305,831200,-1,0.0
BSESN,11/13/2003,4949.160156,5053.060059,4941.490234000001,5051.709961,33400,-56.609864,56.609864,0.0,51.27867176,4666.189941,5135.0,60.35924562,-39.64075438,111.0444227,120.37642620000001,0.008618536,797800,-1,0.0
BSESN,11/14/2003,4865.830078,4961.370117,4854.160156,4948.77002,32600,-83.330078,83.330078,0.0,40.88365684,4666.189941,5135.0,42.58443973,-57.41556027,95.66193147,115.43352730000001,-0.038948953,765200,-1,0.0
BSESN,11/17/2003,4940.22998,4959.959961,4882.970215,4907.02002,23400,74.399902,0.0,74.399902,51.09650217,4684.419922,5135.0,56.77349499,-43.22650501,88.44913002,110.03664779999998,-0.03091699,788600,1,0.3818
BSESN,11/18/2003,4891.129883,4981.47998,4875.459961,4956.419922,26800,-49.100097,49.100097,0.0,45.15612823,4735.77002,5135.0,38.91487884,-61.08512116,77.87677968,103.6046742,-0.034310633,761800,-1,0.0
BSESN,11/19/2003,4823.72998,4868.430176,4800.669922,4868.430176,31400,-67.39990300000001,67.39990300000001,0.0,38.13412224,4779.089844,5135.0,12.54252941,-87.45747059,63.33399243,95.55053781,-0.044340423,730400,-1,0.0
BSESN,11/20/2003,4771.22998,4878.810059,4763.529785,4840.799805,28800,-52.5,52.5,0.0,33.45793805,4763.529785,5135.0,2.072897015,-97.92710298,47.03357981,85.84714620000001,-0.0402971,701600,-1,0.0
BSESN,11/21/2003,4838.540039,4851.669922,4736.700195,4770.75,29600,67.310059,0.0,67.310059,43.6754302,4736.700195,5135.0,25.56864019,-74.43135981,39.09224157,76.49616527,-0.032015114,731200,1,0.0
BSESN,11/24/2003,4822.149902,4858.430176,4803.799805,4852.120117,20600,-16.390137,16.390137,0.0,41.869119700000006,4736.700195,5127.790039,21.84912452,-78.15087548,31.11830648,67.42059350000001,-0.041444077,710600,-1,0.0
BSESN,11/25/2003,4894.589844,4900.209961,4843.459961,4845.100098,22200,72.439942,0.0,72.439942,51.99408194,4736.700195,5118.080078,41.39957455,-58.60042545,30.29141146,59.99475709,-0.022210404,732800,1,0.0
BSESN,11/27/2003,4989.040039,5000.410156,4907.379883,4907.379883,38800,94.450195,0.0,94.450195,61.96149806,4736.700195,5092.700195,70.88197865,-29.11802135,36.82849096,55.36150386,0.008057909,771600,1,0.4939
BSESN,11/28/2003,5044.819824,5050.560059,4991.240234000001,4995.149902,30800,55.779785,0.0,55.779785,66.67629483,4736.700195,5059.97998,95.31051532,-4.689484683,45.97766743,53.48473657,0.036785038,802400,1,0.0
BSESN,12/1/2003,5160.850098,5166.560059,5082.819824,5086.859863000001,51200,116.030274,0.0,116.030274,74.31692231,4736.700195,5166.560059,98.67166919,-1.328330807,61.87319348,55.16242796,0.044657864000000005,853600,1,0.0
BSESN,12/2/2003,5186.080078,5204.569824,5123.799805,5187.72998,33400,25.229979999999998,0.0,25.229979999999998,75.71401421,4736.700195,5204.569824,96.04809869,-3.9519013110000003,75.63344938,59.25663224,0.06030308,887000,1,0.0
BSESN,12/3/2003,5221.899902,5246.740234000001,5178.220215,5194.160156,25400,35.819824,0.0,35.819824,77.70109656,4736.700195,5246.740234000001,95.12972902,-4.870270979,88.40845381,65.08699656,0.082543991,912400,1,0.0
BSESN,12/4/2003,5225.899902,5252.209961,5174.859863000001,5229.180176,32200,4.0,0.0,4.0,77.93373072,4736.700195,5252.209961,94.89630251,-5.103697492,97.7287051,71.61533827,0.09529407,944600,1,0.0
BSESN,12/5/2003,5131.720215,5263.109863000001,5125.069824,5245.75,31400,-94.179687,94.179687,0.0,60.72333801,4736.700195,5263.109863000001,75.0404189,-24.9595811,96.40688867,76.57364835,0.060592694,913200,-1,0.0
BSESN,12/8/2003,5131.540039,5163.009765999999,5089.569824,5144.950195,29400,-0.180176,0.180176,0.0,60.69375129,4736.700195,5263.109863000001,75.00619157,-24.99380843,94.25819992,80.11055866,0.064160207,883800,-1,0.0
BSESN,12/9/2003,5229.339844,5232.490234000001,5143.189941,5143.189941,21600,97.799805,0.0,97.799805,69.88400390000001,4736.700195,5263.109863000001,93.58484066,-6.415159342999999,99.29981217,83.94840937,0.06839183900000001,905400,1,0.0
BSESN,12/10/2003,5285.540039,5300.790039,5220.600098,5234.720215,29000,56.200194999999994,0.0,56.200194999999994,73.92620437,4736.700195,5300.790039,97.29652995,-2.7034700519999997,106.600022,88.4787319,0.05943027099999999,934400,1,-0.3612
BSESN,12/11/2003,5299.959961,5317.410156,5253.810059,5306.620117,25600,14.419922,0.0,14.419922,74.92269777,4736.700195,5317.410156,96.99502399,-3.004976007,112.25467320000001,93.23392017,0.050574678,960000,1,0.0
BSESN,12/12/2003,5315.810059,5343.910156,5283.75,5321.490234000001,26400,15.850098000000001,0.0,15.850098000000001,76.08203897,4803.799805,5343.910156,94.79734152,-5.202658484,116.6697183,97.92107979,0.030026052999999997,986400,1,0.4767
BSESN,12/15/2003,5390.879883,5399.080078,5351.029785,5366.930176,24400,75.069824,0.0,75.069824,80.90604377,4843.459961,5399.080078,98.52413641,-1.475863589,124.7862801,103.2941199,0.03949029,1010800,1,0.3612
BSESN,12/16/2003,5437.049805,5445.0,5351.209961,5374.149902,30800,46.169922,0.0,46.169922,83.29674998,4907.379883,5445.0,98.52122442,-1.4787755790000001,133.4055703,109.31641,0.041201461,1041600,1,0.0
BSESN,12/17/2003,5418.22998,5457.879883,5401.089844,5437.259765999999,23600,-18.819825,18.819825,0.0,78.66428411,4991.240234000001,5457.879883,91.50310029,-8.496899714,137.1372155,114.88057109999998,0.036803246,1018000,-1,-0.4939
BSESN,12/18/2003,5455.0,5466.299805,5407.459961,5432.459961,30800,36.77002,0.0,36.77002,81.04123597,5082.819824,5466.299805,97.05335205,-2.94664795,141.4306886,120.1905946,0.06299637799999999,1048800,1,-0.6908
BSESN,12/19/2003,5541.350098,5555.680176,5486.629883,5486.629883,33000,86.350098,0.0,86.350098,85.43736168,5089.569824,5555.680176,96.925604,-3.0743959960000002,150.0698959,126.1664548,0.079861027,1081800,1,0.0
BSESN,12/22/2003,5577.959961,5590.450195,5543.97998,5547.680176,29200,36.609863,0.0,36.609863,86.92096857,5089.569824,5590.450195,97.50634389,-2.493656115,158.048242,132.54281229999998,0.06666618099999999,1111000,1,0.0
BSESN,12/23/2003,5564.330078,5616.25,5550.52002,5590.009765999999,29000,-13.629883,13.629883,0.0,83.27642794,5089.569824,5616.25,90.14203982,-9.857960175,161.41078159999998,138.3164061,0.05274580000000001,1082000,-1,0.25
BSESN,12/24/2003,5641.919922,5648.240234000001,5560.22998,5566.049805,30800,77.589844,0.0,77.589844,86.88768413,5089.569824,5648.240234000001,98.86868682,-1.131313183,168.3944459,144.33201409999998,0.064521235,1112800,1,-0.25
BSESN,12/26/2003,5699.240234000001,5705.299805,5650.740234000001,5650.740234000001,24400,57.320312,0.0,57.320312,88.92605495,5089.569824,5705.299805,99.01587202,-0.9841279759999999,176.5189025,150.7693918,0.07213015,1137200,1,0.0
BSESN,12/29/2003,5797.330078,5814.259765999999,5725.439941,5725.439941,18800,98.089844,0.0,98.089844,91.52687731,5143.189941,5814.259765999999,97.47720917,-2.522790829,188.69649730000003,158.35481289999998,0.075395892,1156000,1,-0.5574
BSESN,12/30/2003,5791.850098,5920.759765999999,5762.600098,5852.700195,34200,-5.47998,5.47998,0.0,90.1618728,5220.600098,5920.759765999999,81.58853275,-18.41146725,195.6498071,165.81381169999997,0.06525603099999999,1121800,-1,-0.7717
BSESN,12/31/2003,5838.959961,5876.549805,5801.52002,5812.379883,28200,47.109863,0.0,47.109863,91.42970553,5253.810059,5920.759765999999,87.73523638,-12.26476362,202.6255712,173.1761636,0.077650816,1150000,1,0.0
BSESN,1/2/2004,6026.589844,6034.379883,5944.22998,5944.22998,31400,187.629883,0.0,187.629883,94.61741391,5283.75,6034.379883,98.96219972,-1.037800276,220.7480199,182.69053490000002,0.10478274,1181400,1,0.0
BSESN,1/5/2004,6039.0,6078.109863000001,5964.649902,6050.47998,33600,12.410156,0.0,12.410156,94.7659872,5351.029785,6078.109863000001,94.62096897,-5.379031029,233.42072369999997,192.8365726,0.08980661599999999,1215000,1,-0.0516
BSESN,1/6/2004,5943.640136999999,6121.200195,5916.330078,6068.680176,37600,-95.359863,95.359863,0.0,76.13380941,5351.209961,6121.200195,76.93995973,-23.06004027,233.08290730000004,200.8858396,0.06555805,1177400,-1,0.4215
BSESN,1/7/2004,5957.02002,5985.299805,5870.549805,5970.350098,36200,13.379883,0.0,13.379883,76.8700511,5401.089844,6121.200195,77.20069226,-22.79930774,231.22925440000003,206.9545225,0.070572726,1213600,1,-0.0516
BSESN,1/8/2004,6108.540039,6118.620117,5992.100098,5992.100098,31600,151.520019,0.0,151.520019,83.51500234,5407.459961,6121.200195,98.22622358,-1.773776424,239.22810609999996,213.40923930000002,0.08270590900000001,1245200,1,0.0
BSESN,1/9/2004,6119.589844,6249.600098,6096.680176,6241.589844,45200,11.049805000000001,0.0,11.049805000000001,83.90410549,5486.629883,6249.600098,82.95998304,-17.04001696,243.65014559999997,219.4574205,0.073755377,1290400,1,-0.4939
BSESN,1/12/2004,6067.759765999999,6152.220215,6037.299805,6152.220215,31600,-51.830078,51.830078,0.0,74.39975356,5543.97998,6249.600098,74.22971265,-25.77028735,240.20368109999998,223.60667259999997,0.046647281,1258800,-1,0.0
BSESN,1/13/2004,6132.970215,6147.740234000001,6011.569824,6084.649902,33200,65.210449,0.0,65.210449,78.01507932,5550.52002,6249.600098,83.31666333,-16.68333667,239.9677722,226.8788926,0.058896572,1292000,1,-0.5994
BSESN,1/14/2004,6194.109863000001,6215.02002,6162.180176,6162.180176,35600,61.139648,0.0,61.139648,80.92872459,5560.22998,6249.600098,91.95058887,-8.049411129,241.92524440000003,229.88816290000003,0.060824170999999996,1327600,1,0.0
BSESN,1/15/2004,6063.910156,6248.810059,6045.299805,6219.810059,38000,-130.19970700000002,130.19970700000002,0.0,61.04848395,5650.740234000001,6249.600098,68.99275554,-31.00724446,230.3160415,229.9737387,0.006192609,1289600,-1,0.0
BSESN,1/16/2004,5946.189941,6072.029785,5914.02002,6068.660156,47800,-117.720215,117.720215,0.0,48.5948035,5725.439941,6249.600098,42.11499044,-57.88500956,209.2054226,225.8200754,-0.015368448,1241800,-1,0.5719
BSESN,1/19/2004,6064.100098,6076.970215,5870.990234000001,5967.390136999999,36200,117.91015700000001,0.0,117.91015700000001,58.40197233,5762.600098,6249.600098,61.90965092,-38.09034908,199.6872228,220.5935049,0.020267035,1278000,1,0.7096
BSESN,1/20/2004,5922.109863000001,6130.089844,5899.709961,6099.939941,41000,-141.990235,141.990235,0.0,46.16431717,5801.52002,6249.600098,26.91256517,-73.08743483,178.6278471,212.20037340000002,-0.005860339,1237000,-1,0.25
BSESN,1/21/2004,5758.189941,5962.359863000001,5728.319824,5927.419922,43200,-163.91992199999999,163.91992199999999,0.0,36.09066866,5728.319824,6249.600098,5.730145277,-94.26985472,147.0168898,199.16367659999997,-0.057354145999999995,1193800,-1,0.0
BSESN,1/22/2004,5593.740234000001,5852.959961,5567.680176,5793.830078,51000,-164.44970700000002,164.44970700000002,0.0,28.81265418,5567.680176,6249.600098,3.821571589,-96.17842841,107.4569749,180.82233630000002,-0.085928898,1142800,-1,0.4767
BSESN,1/23/2004,5816.640136999999,5832.740234000001,5596.569824,5646.330078,37600,222.89990299999997,0.0,222.89990299999997,45.88102985,5567.680176,6249.600098,36.50867983,-63.49132017,93.01884578,163.2616382,-0.041385887999999996,1180400,1,0.0
BSESN,1/27/2004,5993.060059,6005.540039,5791.740234000001,5854.350098,45200,176.41992199999999,0.0,176.41992199999999,55.60252964,5567.680176,6249.600098,62.37974127,-37.62025873,94.71988878,149.55328830000002,-0.022812789,1225600,1,0.0
BSESN,1/28/2004,5876.049805,6030.549805,5815.200195,5980.879883,47800,-117.010254,117.010254,0.0,48.88263371,5567.680176,6249.600098,45.22079779,-54.77920221,85.63925827,136.7704823,-0.051348792000000004,1177800,-1,-0.34
BSESN,1/29/2004,5802.75,5921.720215,5774.310059,5865.209961,45000,-73.299805,73.299805,0.0,44.95548382,5567.680176,6249.600098,34.47176368,-65.52823632,71.70171134,123.75672809999999,-0.043067945999999996,1132800,-1,-0.4215
BSESN,1/30/2004,5695.669922,5854.290039,5685.640136999999,5841.209961,38800,-107.080078,107.080078,0.0,39.59377139,5567.680176,6248.810059,18.79079882,-81.20920118,51.42304624,109.28999170000002,-0.042131182999999996,1094000,-1,0.0258
BSESN,2/3/2004,5620.97998,5715.459961,5550.169922,5715.459961,39600,-74.689942,74.689942,0.0,36.12606112,5550.169922,6248.810059,10.13541225,-89.86458775,28.99113153,93.2302197,-0.07307269200000001,1054400,-1,0.0
BSESN,2/4/2004,5756.759765999999,5769.790039,5574.680176,5633.149902,41800,135.779786,0.0,135.779786,46.03927765,5550.169922,6248.810059,29.5702799,-70.42972009999998,21.91713051,78.96760186,-0.027920808999999998,1096200,1,-0.4404
BSESN,2/5/2004,5720.629883,5820.450195,5648.140136999999,5756.299805,44600,-36.129883,36.129883,0.0,43.94525108,5550.169922,6248.810059,24.39882165,-75.60117835,13.24294678,65.82267084,-0.006522893,1051600,-1,0.0
BSESN,2/6/2004,5786.350098,5800.939941,5683.609863000001,5710.129883,37800,65.720215,0.0,65.720215,48.83007376,5550.169922,6130.089844,40.7263429,-59.2736571,11.53857547,54.96585177,0.034433108,1089400,1,-0.6597
BSESN,2/9/2004,5926.220215,5935.680176,5807.72998,5810.209961,30400,139.870117,0.0,139.870117,57.85008304,5550.169922,6130.089844,64.8452103,-35.1547897,21.229318799999998,48.21854517,0.018839068,1119800,1,0.0
BSESN,2/10/2004,5932.52002,5972.939941,5866.620117,5937.459961,44400,6.299805,0.0,6.299805,58.23271262,5550.169922,6130.089844,65.93153356,-34.06846644,29.08239203,44.39131454,-0.010101691,1164200,1,-0.5574
BSESN,2/11/2004,5949.779785,5958.910156,5905.22998,5936.410156,37200,17.259764999999998,0.0,17.259764999999998,59.39787449,5550.169922,6030.549805,83.18621931,-16.81378069,36.28049031,42.7691497,0.012547542,1201400,1,0.0
BSESN,2/12/2004,5936.959961,5986.410156,5886.97998,5973.709961,37600,-12.819824,12.819824,0.0,58.010943000000005,5550.169922,6030.549805,80.51753470000001,-19.4824653,40.48391909,42.31210358,0.023128682,1163800,-1,0.0
BSESN,2/13/2004,6011.660156,6017.009765999999,5922.379883,5936.649902,32800,74.700195,0.0,74.700195,63.70836308,5550.169922,6030.549805,96.06776852,-3.932231484,49.27477466,43.70463779,0.055479029000000006,1196600,1,0.3182
BSESN,2/16/2004,6012.350098,6063.910156,6001.569824,6025.850098,30800,0.689942,0.0,0.689942,63.76076653,5550.169922,6063.910156,89.9637882,-10.0362118,55.65569703,46.09484964,0.06962667,1227400,1,0.0
BSESN,2/17/2004,6035.799805,6058.990234000001,5999.129883,6018.950195,30800,23.449707,0.0,23.449707,65.70291859,5550.169922,6063.910156,94.52829482,-5.471705181,61.89135577,49.25415087,0.048471719,1258200,1,0.0
BSESN,2/18/2004,6027.02002,6082.799805,6018.810059,6060.140136999999,31200,-8.779785,8.779785,0.0,64.21615174,5550.169922,6082.799805,89.52747738,-10.47252262,65.37115143,52.47755098,0.053558811,1227000,-1,0.0
BSESN,2/19/2004,5855.100098,6041.359863000001,5845.069824,6041.359863000001,40400,-171.91992199999999,171.91992199999999,0.0,42.49157684,5550.169922,6082.799805,57.24991889,-42.75008111,53.63821156,52.7096831,0.01188141,1186600,-1,0.0
BSESN,2/20/2004,5850.720215,5893.620117,5770.870117,5847.970215,41000,-4.379883,4.379883,0.0,42.07317222,5550.169922,6082.799805,56.42760622,-43.57239378,43.48508589,50.86476366,-0.012739992,1145600,-1,0.0
BSESN,2/23/2004,5698.040039,5875.22998,5680.359863000001,5869.609863000001,28600,-152.680176,152.680176,0.0,30.13706649,5574.680176,6082.799805,24.27772043,-75.72227957,22.85526682,45.26286429,-0.039524516,1117000,-1,0.0
BSESN,2/24/2004,5734.439941,5748.149902,5606.839844,5686.810059,42400,36.399902000000004,0.0,36.399902000000004,35.19454917,5606.839844,6082.799805,26.80899812,-73.19100188,9.335523403,38.07739611,-0.03619291,1159400,1,-0.2244
BSESN,2/25/2004,5618.149902,5746.790039,5606.859863000001,5746.790039,33800,-116.290039,116.290039,0.0,27.78100677,5606.839844,6082.799805,2.376262486,-97.62373751,-10.63990086,28.33393672,-0.05369921,1125600,-1,0.0
BSESN,2/26/2004,5567.120117,5723.310059,5556.310059,5639.830078,34400,-51.029785,51.029785,0.0,25.10359361,5556.310059,6082.799805,2.053232391,-97.94676761,-30.23963913,16.61922155,-0.073946302,1091200,-1,0.0
BSESN,2/27/2004,5667.509765999999,5683.290039,5551.640136999999,5595.830078,41600,100.389649,0.0,100.389649,38.54736268,5551.640136999999,6082.799805,21.81446295,-78.18553705,-37.24269476,5.846838287000001,-0.057355330999999996,1132800,1,-0.25
BSESN,3/1/2004,5823.169922,5831.549805,5649.299805,5649.299805,32200,155.660156,0.0,155.660156,53.48519813,5551.640136999999,6082.799805,51.12018125,-48.87981875,-29.88772197,-1.300073764,-0.035228121,1165000,1,0.0
BSESN,3/3/2004,5842.200195,5870.629883,5792.970215,5830.77002,39400,19.030273,0.0,19.030273,55.02729488,5551.640136999999,6082.799805,54.70295949,-45.29704051,-22.26660004,-5.493379019,-0.030665208,1204400,1,0.0
BSESN,3/4/2004,5815.870117,5872.75,5769.339844,5842.410156,36200,-26.330078000000004,26.330078000000004,0.0,52.26127389,5551.640136999999,6082.799805,49.74586662,-50.25413338,-18.14228225,-8.023159665,-0.0067001380000000004,1168200,-1,0.0
BSESN,3/5/2004,5880.350098,5892.779785,5818.77002,5834.370117,37600,64.47998100000001,0.0,64.47998100000001,58.19857478,5551.640136999999,6082.799805,61.88533897,-38.11466103,-9.560545709,-8.330636873,0.005064314,1205800,1,0.0
BSESN,3/8/2004,5935.189941,5951.029785,5898.569824,5899.259765999999,36400,54.839843,0.0,54.839843,62.74548477,5551.640136999999,6082.799805,72.2098885,-27.7901115,1.64666276,-6.335176947000001,0.041619557,1242200,1,-0.25
BSESN,3/9/2004,5850.609863000001,5923.350098,5794.819824,5923.350098,37600,-84.580078,84.580078,0.0,52.56945187,5551.640136999999,6082.799805,56.28622503,-43.71377497,3.661365393,-4.335868479,0.020258286,1204600,-1,0.35700000000000004
BSESN,3/10/2004,5759.290039,5833.189941,5745.560059,5833.189941,35000,-91.319824,91.319824,0.0,43.73346939,5551.640136999999,6041.359863000001,42.40178432,-57.59821568,-2.0866405390000002,-3.886022891,0.025122174,1169600,-1,0.0
BSESN,3/11/2004,5649.859863000001,5763.709961,5634.399902,5737.689941,36200,-109.430176,109.430176,0.0,35.48634406,5551.640136999999,5951.029785,24.59245664,-75.40754336,-15.29573424,-6.167965161000001,0.014862216999999999,1133400,-1,0.0
BSESN,3/12/2004,5700.399902,5735.939941,5570.810059,5632.129883,38400,50.540039,0.0,50.540039,41.37748597,5551.640136999999,5951.029785,37.24677536,-62.75322464,-21.43875431,-9.22212299,0.005803278,1171800,1,0.0
BSESN,3/15/2004,5520.660156,5764.200195,5505.97998,5745.060059,38400,-179.739746,179.739746,0.0,30.09889512,5505.97998,5951.029785,3.298546777,-96.70145322,-40.34552631,-15.44680365,-0.051949327999999996,1133400,-1,0.1027
BSESN,3/16/2004,5525.089844,5551.919922,5434.970215,5471.169922,40800,4.429688,0.0,4.429688,30.63654356,5434.970215,5951.029785,17.46302835,-82.53697165,-54.34538099,-23.22651912,-0.054279268,1174200,1,0.1695
BSESN,3/17/2004,5535.689941,5560.149902,5482.629883,5545.830078,33400,10.600097,0.0,10.600097,32.07900105,5434.970215,5951.029785,19.51707358,-80.48292642,-63.8490169,-31.35101868,-0.048175109,1207600,1,0.3612
BSESN,3/18/2004,5414.939941,5540.680176,5399.049805,5539.720215,36000,-120.75,120.75,0.0,25.19287168,5399.049805,5951.029785,2.878752233,-97.12124777,-80.19972239,-41.12075942,-0.079146675,1171600,-1,0.4404
BSESN,3/19/2004,5443.439941,5496.680176,5386.620117,5410.47998,30600,28.5,0.0,28.5,29.32456843,5386.620117,5951.029785,10.06712451,-89.93287549,-89.82264620000001,-50.86113678,-0.082853288,1202200,1,-0.5267
BSESN,3/22/2004,5365.399902,5446.879883,5347.049805,5446.879883,25400,-78.04003900000001,78.04003900000001,0.0,24.96761397,5347.049805,5951.029785,3.0381962330000003,-96.96180377,-102.5637603,-61.20166149,-0.082933228,1176800,-1,0.0
BSESN,3/23/2004,5400.990234000001,5450.379883,5324.779785,5356.970215,31800,35.590332000000004,0.0,35.590332000000004,30.40850497,5324.779785,5951.029785,12.16933317,-87.83066683,-108.53818570000001,-70.66896633,-0.062212495,1208600,1,0.0
BSESN,3/24/2004,5395.279785,5435.399902,5345.149902,5412.129883,26600,-5.710449,5.710449,0.0,30.00568505,5324.779785,5951.029785,11.25748503,-88.74251497,-112.43763440000001,-79.02269994,-0.045059537999999996,1182000,-1,0.0
BSESN,3/25/2004,5414.439941,5438.859863000001,5368.879883,5403.379883,27000,19.160156,0.0,19.160156,33.42024509,5324.779785,5951.029785,14.31699098,-85.68300902,-112.68297340000002,-85.75475464,-0.050164895,1209000,1,0.0
BSESN,3/26/2004,5528.939941,5552.339844,5448.290039,5448.290039,32400,114.5,0.0,114.5,50.17891422,5324.779785,5923.350098,34.10796552,-65.89203448,-102.4571612,-89.09523594,0.001499782,1241400,1,0.4404
BSESN,3/29/2004,5571.370117,5578.740234000001,5495.310059,5538.52002,27800,42.430176,0.0,42.430176,55.01991205,5324.779785,5833.189941,48.50224353,-51.49775647,-89.89314193,-89.25481714,0.008376384,1269200,1,-0.128
BSESN,3/30/2004,5520.439941,5608.310059,5509.580078,5595.930176,26600,-50.930176,50.930176,0.0,48.49377826,5324.779785,5764.200195,44.52687029,-55.47312971,-83.08791596,-88.02143690000001,-0.0027548509999999996,1242600,-1,0.0
BSESN,3/31/2004,5590.600098,5599.600098,5493.120117,5513.120117,26200,70.160157,0.0,70.160157,56.66422701,5324.779785,5764.200195,60.49339242,-39.50660758,-71.21249866,-84.65964925,0.032439908999999996,1268800,1,0.0
BSESN,4/1/2004,5740.850098,5750.290039,5599.120117,5599.120117,28400,150.25,0.0,150.25,68.86741366,5324.779785,5764.200195,94.68616012,-5.313839883,-49.11111327,-77.54994206,0.054636436,1297200,1,0.4215
BSESN,4/2/2004,5788.080078,5799.160156,5700.600098,5762.810059,33000,47.22998,0.0,47.22998,71.75249455,5324.779785,5799.160156,97.66430513,-2.335694872,-27.46791149,-67.53353595,0.078778876,1330200,1,0.0
BSESN,4/5/2004,5838.02002,5905.350098,5798.370117,5809.740234000001,24000,49.939941999999995,0.0,49.939941999999995,74.62182971,5324.779785,5905.350098,88.4027694,-11.5972306,-6.214152303,-55.26965922,0.080916604,1354200,1,0.0
BSESN,4/6/2004,5822.419922,5897.560059,5780.939941,5886.02002,27400,-15.600098000000001,15.600098000000001,0.0,71.98623962,5324.779785,5905.350098,85.71573948,-14.28426052,9.264018301,-42.36292371,0.079169228,1326800,-1,0.0
BSESN,4/7/2004,5815.129883,5860.669922,5774.879883,5827.069824,22800,-7.290039,7.290039,0.0,70.64094044,5324.779785,5905.350098,84.4600709,-15.5399291,20.70367596,-29.74960378,0.07400395,1304000,-1,0.1779
BSESN,4/8/2004,5838.450195,5864.549805,5783.740234000001,5824.370117,28600,23.320312,0.0,23.320312,72.53543975,5324.779785,5905.350098,88.47686464,-11.52313536,31.29074003,-17.54153502,0.055980035,1332600,1,0.0
BSESN,4/12/2004,5783.790039,5867.069824,5760.25,5856.439941,19800,-54.66015600000001,54.66015600000001,0.0,61.75769686,5324.779785,5905.350098,79.06195748,-20.93804252,34.86850658,-7.059526697000001,0.038127053,1312800,-1,0.0
BSESN,4/13/2004,5904.52002,5920.180176,5743.580078,5823.529785,23400,120.72998100000001,0.0,120.72998100000001,72.26160774,5345.149902,5920.180176,97.27663799,-2.723362005,46.90511511,3.7334016639999996,0.069574179,1336200,1,0.0418
BSESN,4/15/2004,5843.970215,5927.040039,5824.209961,5923.839844,32400,-60.549805000000006,60.549805000000006,0.0,62.351085700000006,5368.879883,5927.040039,85.1172064,-14.8827936,50.97079337,13.18088001,0.045320737,1303800,-1,0.6597
BSESN,4/16/2004,5862.819824,5903.129883,5843.77002,5870.410156,23000,18.849609,0.0,18.849609,64.11872745,5448.290039,5927.040039,86.58585587,-13.41414413,55.07896192,21.56049639,0.021245935,1326800,1,0.0
BSESN,4/19/2004,5800.540039,5895.169922,5782.370117,5875.529785,22000,-62.279785,62.279785,0.0,54.38434579,5493.120117,5927.040039,70.84715553,-29.15284447,52.701745900000006,27.78874629,0.002152693,1304800,-1,-0.0772
BSESN,4/20/2004,5804.810059,5819.919922,5765.379883,5814.879883,20800,4.27002,0.0,4.27002,54.92570204,5493.120117,5927.040039,71.83121267,-28.16878733,50.57929324,32.34685568,-0.005688566,1325600,1,0.3612
BSESN,4/21/2004,5876.419922,5890.02002,5783.919922,5803.700195,21400,71.609863,0.0,71.609863,63.34369844,5493.120117,5927.040039,88.3342261,-11.6657739,54.05246658,36.68797786,0.009274494,1347000,1,0.0
BSESN,4/22/2004,5924.180176,5947.569824,5863.600098,5888.169922,23800,47.760253999999996,0.0,47.760253999999996,67.94997332,5599.120117,5947.569824,93.28751107,-6.712488927000001,59.96756485,41.34389526,0.018752856000000002,1370800,1,0.0
BSESN,4/23/2004,5925.580078,5979.25,5905.580078,5941.100098,31200,1.399902,0.0,1.399902,68.08560674,5700.600098,5979.25,80.73929988,-19.26070012,64.03018306,45.88115282,0.014923461,1402000,1,0.0258
BSESN,4/27/2004,5712.279785,5841.299805,5704.279785,5841.299805,30600,-213.300293,213.300293,0.0,39.03963963,5704.279785,5979.25,2.909406024,-97.09059398,49.46805376,46.59853301,-0.012363909,1371400,-1,-0.3818
BSESN,4/28/2004,5713.089844,5757.52002,5659.830078,5709.430176,26000,0.810059,0.0,0.810059,39.15338665,5659.830078,5979.25,16.67390239,-83.32609761,37.55985968,44.79079834,-0.032420955,1397400,1,0.0
BSESN,4/29/2004,5668.430176,5710.560059,5626.410156,5710.560059,32600,-44.659667999999996,44.659667999999996,0.0,34.99910272,5626.410156,5979.25,11.90909154,-88.09090846,24.23945162,40.680529,-0.030037805,1364800,-1,0.0
BSESN,4/30/2004,5655.089844,5710.450195,5632.990234000001,5674.759765999999,25000,-13.340332,13.340332,0.0,33.764338200000005,5626.410156,5979.25,8.12824529,-91.87175471,12.46281563,35.03698632,-0.035431752000000004,1339800,-1,0.0
BSESN,5/3/2004,5584.990234000001,5645.859863000001,5506.0,5645.859863000001,26800,-70.09961,70.09961,0.0,27.81461059,5506.0,5979.25,16.69101616,-83.30898384,-2.497910468,27.53000697,-0.037160299,1313000,-1,-0.4767
BSESN,5/4/2004,5647.149902,5677.109863000001,5616.410156,5616.410156,22800,62.159668,0.0,62.159668,38.84114806,5506.0,5979.25,29.82565283,-70.17434717,-9.232205708,20.17756443,-0.027160261,1335800,1,0.0
BSESN,5/5/2004,5686.189941,5695.180176,5648.640136999999,5665.669922,31400,39.040039,0.0,39.040039,44.93655489,5506.0,5979.25,38.07500074,-61.92499926,-11.28884802,13.88428194,-0.032371747,1367200,1,0.0
BSESN,5/6/2004,5757.299805,5772.640136999999,5739.259765999999,5749.97998,25000,71.109864,0.0,71.109864,54.47288026,5506.0,5979.25,53.10085684,-46.89914316,-7.098948738,9.687635805,-0.028169361,1392200,1,0.0
BSESN,5/7/2004,5669.580078,5748.339844,5645.790039,5748.339844,22800,-87.719727,87.719727,0.0,43.70034596,5506.0,5979.25,34.56525684,-65.43474316,-10.73294849,5.603518946,-0.043202520999999994,1369400,-1,0.0
BSESN,5/10/2004,5555.839844,5628.609863000001,5501.169922,5628.609863000001,24800,-113.74023400000002,113.74023400000002,0.0,33.72276119,5501.169922,5979.25,11.43530645,-88.56469355,-22.53108032,-0.023400907999999998,-0.027386603,1344600,-1,0.0
BSESN,5/11/2004,5325.899902,5472.029785,5309.419922,5472.029785,33200,-229.939942,229.939942,0.0,22.00384699,5309.419922,5979.25,2.460322482,-97.53967752,-49.86065161,-9.990851048,-0.067772423,1311400,-1,0.0
BSESN,5/12/2004,5358.350098,5387.870117,5296.25,5296.25,28800,32.450196000000005,0.0,32.450196000000005,26.18102581,5296.25,5979.25,9.092254466,-90.90774553,-68.11587696,-21.61585623,-0.05470299,1340200,1,0.0
BSESN,5/13/2004,5399.470215,5487.339844,5131.029785,5234.509765999999,45200,41.120117,0.0,41.120117,31.54171724,5131.029785,5979.25,31.64749263,-68.35250737,-78.36191768,-32.96506852,-0.045201692,1385400,1,0.0
BSESN,5/14/2004,5069.870117,5416.040039,5043.990234000001,5409.339844,49400,-329.600098,329.600098,0.0,18.86877586,5043.990234000001,5841.299805,3.2459014589999997,-96.75409854,-111.7893119,-48.7299172,-0.09223294900000001,1336000,-1,0.0
BSESN,5/17/2004,4505.160156,5020.890136999999,4227.5,5020.890136999999,34000,-564.709961,564.709961,0.0,10.51602289,4227.5,5772.640136999999,17.9699012,-82.0300988,-181.75299750000002,-75.33453327,-0.202224089,1302000,-1,0.0
BSESN,5/18/2004,4877.02002,4949.27002,4547.700195,4547.700195,37200,371.859864,0.0,371.859864,33.03837178,4227.5,5772.640136999999,42.0363179,-57.9636821,-204.8325593,-101.2341385,-0.14230441300000002,1339200,1,-0.3818
BSESN,5/19/2004,5006.100098,5059.890136999999,4892.459961,4941.720215,39600,129.08007800000001,0.0,129.08007800000001,39.17049029,4227.5,5772.640136999999,50.39025777,-49.60974223,-210.2835774,-123.0440263,-0.130477782,1378800,1,0.0
BSESN,5/20/2004,4932.109863000001,5073.700195,4912.169922,5048.169922,37000,-73.990235,73.990235,0.0,36.9334806,4227.5,5772.640136999999,45.60168014,-54.39831986,-218.0602784,-142.0472767,-0.13007492699999998,1341800,-1,0.0
BSESN,5/21/2004,4961.569824,4978.560059,4804.899902,4922.47998,32200,29.459961,0.0,29.459961,38.54585432,4227.5,5772.640136999999,47.5083008,-52.491699200000006,-219.3180358,-157.5014285,-0.10696313,1374000,1,0.0
BSESN,5/24/2004,5123.22998,5132.899902,4993.450195,4993.450195,26600,161.660156,0.0,161.660156,47.1078805,4227.5,5772.640136999999,57.97079233,-42.02920767,-204.9081412,-166.98277109999998,-0.038053647999999995,1400600,1,0.0
BSESN,5/25/2004,5102.220215,5143.930176,4976.009765999999,5117.52002,29000,-21.009764999999998,21.009764999999998,0.0,46.14381841,4227.5,5772.640136999999,56.61106032,-43.38893968,-192.9591948,-172.1780558,-0.04780014,1371600,-1,-0.7269
BSESN,5/26/2004,5081.950195,5163.609863000001,5049.209961,5116.580078,31400,-20.270020000000002,20.270020000000002,0.0,45.11598491,4227.5,5748.339844,56.182786,-43.817214,-183.015501,-174.3455449,-0.058805773,1340200,-1,0.0
BSESN,5/27/2004,5058.549805,5107.600098,5019.390136999999,5054.450195,25000,-23.400389999999998,23.400389999999998,0.0,43.81594045,4227.5,5628.609863000001,59.31367889,-40.68632111,-175.0059087,-174.4776176,-0.00223286,1315200,-1,-0.1027
BSESN,5/28/2004,4835.390136999999,5026.919922,4821.589844,5026.919922,37000,-223.159668,223.159668,0.0,33.26749651,4227.5,5487.339844,48.2513821,-51.7486179,-184.5381278,-176.4897197,0.07330038700000001,1278200,-1,0.4019
BSESN,5/31/2004,4759.620117,4830.080078,4665.209961,4760.279785,35000,-75.77002,75.77002,0.0,30.40026216,4227.5,5487.339844,42.23712399,-57.76287601,-195.9477238,-180.38132050000002,-0.024072057,1243200,-1,-0.29600000000000004
BSESN,6/1/2004,4835.120117,4899.529785,4792.009765999999,4792.009765999999,30800,75.5,0.0,75.5,36.67526477,4227.5,5487.339844,48.22994922,-51.77005078,-196.6310517,-183.6312667,-0.034154327000000005,1274000,1,0.0
BSESN,6/2/2004,4923.689941,4946.149902,4846.089844,4846.089844,26400,88.569824,0.0,88.569824,43.56272467,4227.5,5416.040039,58.57521986,-41.42478014,-187.86021399999998,-184.4770562,-0.001707164,1300400,1,0.0
BSESN,6/3/2004,4817.990234000001,5012.52002,4789.629883,4972.27002,34000,-105.699707,105.699707,0.0,37.88824439,4227.5,5163.609863000001,63.07915955,-36.92084045,-187.2795031,-185.0375456,-0.028938339,1266400,-1,-0.3182
BSESN,6/4/2004,4889.0,4902.27002,4759.350098,4803.310059,38400,71.009766,0.0,71.009766,43.58464573,4547.700195,5163.609863000001,55.41393856,-44.58606144,-179.02569430000003,-183.8351753,-0.045719200999999994,1304800,1,0.0
BSESN,6/7/2004,4938.149902,4991.47998,4905.529785,4927.5,31800,49.149902000000004,0.0,49.149902000000004,47.43479543,4665.209961,5163.609863000001,54.76324131,-45.23675869,-166.59806630000003,-180.3877535,-0.032156651,1336600,1,0.0
BSESN,6/8/2004,4962.629883,4970.390136999999,4891.859863000001,4960.870117,31000,24.479981,0.0,24.479981,49.41863772,4665.209961,5163.609863000001,59.67495596,-40.32504404,-153.0099483,-174.9121925,-0.023479237000000003,1367600,1,0.0
BSESN,6/9/2004,4963.75,5000.589844,4945.240234000001,4972.339844,33000,1.120117,0.0,1.120117,49.51922314,4665.209961,5163.609863000001,59.89969858,-40.10030142,-140.53092969999997,-168.0359399,-0.01874051,1400600,1,0.0
BSESN,6/10/2004,4944.640136999999,4975.75,4919.939941,4954.060059,27000,-19.109863,19.109863,0.0,47.65377197,4665.209961,5163.609863000001,56.06545565,-43.93454435,-130.67686229999998,-160.5641244,0.022593834,1373600,-1,0.4404
BSESN,6/11/2004,4832.709961,4945.859863000001,4823.100098,4931.490234000001,27600,-111.930176,111.930176,0.0,37.98343121,4665.209961,5163.609863000001,33.60755075,-66.39244925,-130.3961468,-154.5305289,0.015356235,1346000,-1,0.0
BSESN,6/14/2004,4746.009765999999,4810.419922,4725.390136999999,4810.419922,29600,-86.700195,86.700195,0.0,32.1520213,4665.209961,5163.609863000001,16.21184207,-83.78815793,-135.6064718,-150.7457175,-0.018429811,1316400,-1,0.2732
BSESN,6/15/2004,4814.850098,4824.029785,4696.509765999999,4696.509765999999,30000,68.84033199999999,0.0,68.84033199999999,40.51832043,4665.209961,5107.600098,33.82537821,-66.17462179,-132.651726,-147.12691919999997,-0.022105341,1346400,1,0.0
BSESN,6/16/2004,4788.799805,4863.629883,4772.100098,4837.359863000001,27400,-26.050293,26.050293,0.0,38.44822516,4665.209961,5026.919922,34.16821689,-65.83178311,-130.9031396,-143.8821632,-0.0060586319999999996,1319000,-1,0.0516
BSESN,6/17/2004,4839.879883,4859.810059,4746.509765999999,4791.299805,28600,51.080078,0.0,51.080078,44.82588196,4665.209961,5012.52002,50.29221512,-49.70778488,-123.96662690000001,-139.899056,-0.010047068000000001,1347600,1,0.0
BSESN,6/18/2004,4769.990234000001,4828.189941,4750.72998,4822.080078,28600,-69.889649,69.889649,0.0,38.52411362,4696.509765999999,5012.52002,23.25255813,-76.74744187,-122.69455459999999,-136.4581557,-0.034053172,1319000,-1,-0.4019
BSESN,6/21/2004,4738.620117,4790.930176,4731.720215,4770.649902,23800,-31.370116999999997,31.370116999999997,0.0,35.90957511,4696.509765999999,5012.52002,13.32562803,-86.67437197,-122.80214769999999,-133.7269541,-0.045139325999999994,1295200,-1,0.0
BSESN,6/22/2004,4735.859863000001,4767.350098,4717.779785,4732.950195,29200,-2.760254,2.760254,0.0,35.66383769,4696.509765999999,5012.52002,12.45215828,-87.54784172,-121.70718079999999,-131.3229994,-0.045910880999999994,1266000,-1,0.0
BSESN,6/23/2004,4644.0,4752.470215,4635.169922,4742.799805,31400,-91.859863,91.859863,0.0,28.24241057,4635.169922,5000.589844,2.416419431,-97.58358057,-126.79017649999999,-130.4164348,-0.060801217000000005,1234600,-1,0.3182
BSESN,6/24/2004,4708.549805,4717.740234000001,4613.939941,4656.810059,40400,64.549805,0.0,64.549805,38.60175674,4613.939941,5000.589844,24.46912912,-75.53087088,-124.1784062,-129.1688291,-0.025691622,1275000,1,0.0
BSESN,6/25/2004,4756.390136999999,4775.660156,4680.419922,4717.830078,39400,47.840332000000004,0.0,47.840332000000004,45.34877054,4613.939941,5000.589844,36.842165200000004,-63.157834799999996,-116.9006861,-126.7152005,0.002187179,1314400,1,0.0
BSESN,6/28/2004,4837.600098,4844.720215,4772.870117,4784.580078,28600,81.20996099999999,0.0,81.20996099999999,55.02836852,4613.939941,5000.589844,57.84565191,-42.15434809,-103.3882796,-122.04981629999999,0.004724965,1343000,1,0.0
BSESN,6/29/2004,4841.379883,4873.709961,4802.040039,4838.740234000001,34200,3.779785,0.0,3.779785,55.452099600000004,4613.939941,4975.75,62.86169672,-37.13830328,-91.32190108,-115.90423329999999,0.010979803,1377200,1,0.0
BSESN,6/30/2004,4795.459961,4877.899902,4788.850098,4859.939941,35600,-45.919922,45.919922,0.0,48.98253714,4613.939941,4945.859863000001,54.68789547,-45.31210453,-84.49060792,-109.6215082,-0.009177898,1341600,-1,0.0
BSESN,7/1/2004,4874.049805,4879.810059,4785.939941,4813.759765999999,33200,78.589844,0.0,78.589844,58.53565108,4613.939941,4879.810059,97.83343309,-2.16656691,-71.90632397,-102.0784714,0.021815467999999998,1374800,1,0.0
BSESN,7/2/2004,4870.580078,4895.47998,4813.160156,4842.459961,32000,-3.469727,3.469727,0.0,57.98255544,4613.939941,4895.47998,91.15582207,-8.844177932000001,-61.5041843,-93.96361395,0.027847761000000002,1342800,-1,-0.7845
BSESN,7/5/2004,4843.77002,4894.390136999999,4831.850098,4861.149902,24200,-26.810058,26.810058,0.0,53.47748951,4613.939941,4895.47998,81.63317723,-18.36682277,-54.79215145,-86.12932145,0.022785758,1318600,-1,0.0
BSESN,7/6/2004,4928.589844,4939.399902,4839.180176,4846.419922,29600,84.819824,0.0,84.819824,63.75705576,4613.939941,4939.399902,96.67852907,-3.321470932,-42.14277055,-77.33201127,0.06128118900000001,1348200,1,0.0
BSESN,7/7/2004,4955.970215,4987.049805,4912.220215,4919.540039,35000,27.380371000000004,0.0,27.380371000000004,66.51304299,4613.939941,4987.049805,91.67012374,-8.329876264,-29.56783831,-67.77917668,0.052547052000000004,1383200,1,-0.5994
BSESN,7/8/2004,4843.839844,5004.169922,4808.629883,4972.060059,47800,-112.130371,112.130371,0.0,48.93099045,4613.939941,5004.169922,58.91395182,-41.08604818,-28.32360086,-59.88806151,0.01838573,1335400,-1,-0.4588
BSESN,7/9/2004,4945.47998,4954.859863000001,4723.040039,4766.490234000001,23600,101.640136,0.0,101.640136,59.99209409,4613.939941,5004.169922,84.96016584,-15.03983416,-18.91794987,-51.69403918,0.022300288999999997,1359000,1,-0.4767
BSESN,7/12/2004,4944.540039,4967.919922,4917.379883,4949.419922,17000,-0.939941,0.939941,0.0,59.85376428,4613.939941,5004.169922,84.71929736,-15.28070264,-11.40824197,-43.63687974,0.021308007,1342000,-1,0.0
BSESN,7/13/2004,4898.990234000001,4978.490234000001,4878.060059,4961.870117,16000,-45.549805,45.549805,0.0,53.01811385,4613.939941,5004.169922,73.04674343,-26.95325657,-9.028161895,-36.71513617,0.021589227000000002,1326000,-1,-0.29600000000000004
BSESN,7/14/2004,4848.299805,4933.339844,4835.339844,4911.220215,24600,-50.690428999999995,50.690428999999995,0.0,46.23748557,4680.419922,5004.169922,51.85479012,-48.14520988,-11.10422269,-31.59295348,-0.005283080999999999,1301400,-1,-0.5106
BSESN,7/15/2004,4888.189941,4900.180176,4844.660156,4849.379883,26600,39.890136,0.0,39.890136,51.8311845,4723.040039,5004.169922,58.74505415,-41.25494585,-9.422103099,-27.158783399999997,0.003615558,1328000,1,0.0
BSESN,7/16/2004,4951.169922,4961.319824,4874.459961,4894.399902,25800,62.979981,0.0,62.979981,59.50640357,4723.040039,5004.169922,81.14750398,-18.85249602,-2.972784687,-22.32158366,0.022172791,1353800,1,0.0
BSESN,7/19/2004,4975.399902,5009.629883,4942.430176,4957.080078,21600,24.229979999999998,0.0,24.229979999999998,62.18143159,4723.040039,5009.629883,88.05610816,-11.94389184,4.046853888999999,-17.04789615,0.009497657,1375400,1,-0.34
BSESN,7/20/2004,4957.879883,4982.040039,4936.600098,4974.52002,21800,-17.520019,17.520019,0.0,58.93331025,4723.040039,5009.629883,81.94283535,-18.05716465,8.102844379,-12.01774804,0.000385327,1353600,-1,0.0
BSESN,7/21/2004,4993.759765999999,5041.189941,4951.549805,4973.879883,20200,35.879883,0.0,35.879883,63.44540173,4723.040039,5041.189941,85.09187817,-14.90812183,14.05048748,-6.8041009379999995,0.030950636,1373800,1,-0.5574
BSESN,7/22/2004,5054.290039,5082.810059,5020.689941,5041.140136999999,37400,60.530273,0.0,60.530273,69.88599945,4723.040039,5082.810059,92.07270799999999,-7.927291996,23.37882806,-0.7675151379999999,0.022001921,1411200,1,0.0
BSESN,7/23/2004,5073.339844,5086.029785,5034.200195,5073.100098,35000,19.049805,0.0,19.049805,71.69685835,4723.040039,5086.029785,96.50404973,-3.4959502689999997,31.94057417,5.774102724,0.026048895,1446200,1,0.0
BSESN,7/26/2004,5118.169922,5126.450195,5034.22998,5046.990234000001,28600,44.830078,0.0,44.830078,75.66961533,4723.040039,5126.450195,97.9474307,-2.052569296,41.86068832,12.99141984,0.044739768,1474800,1,0.0
BSESN,7/27/2004,5075.879883,5155.629883,5068.620117,5130.859863000001,40800,-42.290039,42.290039,0.0,65.64083838,4723.040039,5155.629883,81.56452328,-18.43547672,45.78224829,19.54958553,0.046940182999999996,1434000,-1,-0.5574
BSESN,7/28/2004,5070.290039,5104.660156,5045.459961,5087.660156,28000,-5.589844,5.589844,0.0,64.34031214,4723.040039,5155.629883,80.27234222,-19.72765778,47.88704705,25.21707784,0.037253073,1406000,-1,0.0
BSESN,7/29/2004,5120.450195,5133.799805,5051.490234000001,5082.609863000001,28800,50.160156,0.0,50.160156,70.41035609,4835.339844,5155.629883,89.01630281,-10.98369719,52.99176453,30.77201517,0.034189954,1434800,1,0.0
BSESN,7/30/2004,5170.319824,5200.850098,5134.919922,5134.919922,28800,49.869628999999996,0.0,49.869628999999996,75.24442169,4835.339844,5200.850098,91.64721819,-8.352781807000001,60.36549633,36.69071141,0.039176735,1463600,1,-0.1531
BSESN,8/2/2004,5202.529785,5210.919922,5167.290039,5193.25,22000,32.209961,0.0,32.209961,77.93131943,4835.339844,5210.919922,97.76608572,-2.233914281,68.02416631,42.95740239,0.049345669,1485600,1,-0.6486
BSESN,8/3/2004,5194.629883,5242.149902,5181.990234000001,5213.549805,29400,-7.899902,7.899902,0.0,75.60895325,4844.660156,5242.149902,88.04496984,-11.95503016,72.61915299,48.88975251,0.040224225,1456200,-1,0.1027
BSESN,8/4/2004,5169.069824,5201.560059,5145.220215,5189.879883,27200,-25.560059,25.560059,0.0,68.03944782,4874.459961,5242.149902,80.12453705,-19.87546295,73.35266603,53.78233521,0.022709378,1429000,-1,-0.1027
BSESN,8/5/2004,5252.779785,5257.319824,5178.609863000001,5178.609863000001,24000,83.70996099999999,0.0,83.70996099999999,76.81192387,4936.600098,5257.319824,98.58442165,-1.4155783480000002,79.76914558,58.97969729,0.035369194,1453000,1,0.0
BSESN,8/6/2004,5196.990234000001,5262.890136999999,5166.189941,5249.72998,30200,-55.789551,55.789551,0.0,63.42471409,4936.600098,5262.890136999999,79.80327466,-20.19672534,79.43680333,63.071118500000004,0.015400097,1422800,-1,0.0
BSESN,8/9/2004,5233.209961,5240.290039,5154.319824,5176.390136999999,26200,36.219727,0.0,36.219727,67.64844980000001,4951.549805,5262.890136999999,90.46696719,-9.53303281,81.16048146,66.68899109,0.030995627,1449000,1,0.0
BSESN,8/10/2004,5252.049805,5266.990234000001,5214.990234000001,5248.459961,26000,18.839844,0.0,18.839844,69.74536541,5020.689941,5266.990234000001,93.93405959,-6.0659404089999995,83.08892929999999,69.96897873,0.035848002000000004,1475000,1,-0.3241
BSESN,8/11/2004,5175.160156,5269.220215,5159.529785,5263.27002,28600,-76.889649,76.889649,0.0,53.43538949,5034.200195,5269.220215,59.97785253,-40.02214747,77.51929188,71.47904136,0.0106846,1446400,-1,-0.4588
BSESN,8/12/2004,5139.77002,5194.040039,5117.799805,5167.52002,27000,-35.390136,35.390136,0.0,47.53218285,5034.22998,5269.220215,44.91252158,-55.08747842,69.44906036,71.07304516,-0.005908686999999999,1419400,-1,-0.29600000000000004
BSESN,8/13/2004,5102.919922,5144.700195,5084.509765999999,5126.910156,93800,-36.850097999999996,36.850097999999996,0.0,41.96256549,5045.459961,5269.220215,25.67925267,-74.32074733,59.39517816,68.73747176,-0.019146428,1325600,-1,0.0
BSESN,8/16/2004,5102.370117,5114.790039,5056.069824,5105.259765999999,24600,-0.549805,0.549805,0.0,41.87808773,5045.459961,5269.220215,25.43354103,-74.56645897,50.79747771,65.14947295,-0.017760604,1301000,-1,-0.6808
BSESN,8/17/2004,5102.939941,5148.529785,5083.029785,5124.290039,23400,0.569824,0.0,0.569824,42.01767824,5051.490234000001,5269.220215,23.63005166,-76.36994834,43.52795502,60.82516936,-0.012793381999999999,1324400,1,0.7269
BSESN,8/18/2004,5038.279785,5103.970215,5025.490234000001,5103.970215,24200,-64.660156,64.660156,0.0,31.96582997,5025.490234000001,5269.220215,5.247426249,-94.75257375,32.17833985,55.09580346,-0.040835521,1300200,-1,-0.2023
BSESN,8/19/2004,5123.649902,5132.830078,5056.169922,5056.169922,23200,85.37011700000001,0.0,85.37011700000001,50.13781022,5025.490234000001,5269.220215,40.27394069,-59.72605931,29.72963826,50.02257042,-0.014112078,1323400,1,-0.4939
BSESN,8/20/2004,5064.660156,5128.100098,5047.75,5128.100098,24000,-58.989746,58.989746,0.0,41.33516168,5025.490234000001,5269.220215,16.07103149,-83.92896851,22.76660585,44.57137751,-0.032207728,1299400,-1,-0.5106
BSESN,8/23/2004,5033.689941,5080.220215,5022.290039,5064.419922,27400,-30.970215000000003,30.970215000000003,0.0,37.36152468,5022.290039,5269.220215,4.616650012,-95.38334999,14.58123161,38.57334833,-0.041576122,1272000,-1,0.0
BSESN,8/24/2004,5067.390136999999,5084.740234000001,5040.709961,5048.629883,21000,33.700196000000005,0.0,33.700196000000005,44.10768644,5022.290039,5269.220215,18.26431209,-81.73568791,10.69035596,32.99674985,-0.02082448,1293000,1,-0.1027
BSESN,8/25/2004,5088.560059,5093.370117,5054.560059,5073.22998,19000,21.169922,0.0,21.169922,48.15491648,5022.290039,5269.220215,26.83755427,-73.16244573,9.208890399,28.23917796,-0.009963473,1312000,1,0.0
BSESN,8/26/2004,5135.450195,5145.600098,5105.379883,5105.379883,22400,46.890136,0.0,46.890136,56.25114306,5022.290039,5269.220215,45.82678303,-54.17321697,11.68377706,24.92809778,0.006374835,1334400,1,0.0
BSESN,8/27/2004,5117.009765999999,5148.75,5094.560059,5147.859863000001,18800,-18.440429,18.440429,0.0,52.52885128,5022.290039,5269.220215,38.35891123,-61.64108877,12.01861099,22.34620042,0.0028691859999999997,1315600,-1,0.0
BSESN,8/30/2004,5186.450195,5192.799805,5130.540039,5130.540039,14800,69.44042900000001,0.0,69.44042900000001,63.129782999999996,5022.290039,5269.220215,66.48039485,-33.51960515,17.68338848,21.41363803,0.016365126,1330400,1,0.0
BSESN,8/31/2004,5192.080078,5202.509765999999,5155.959961,5192.180176,16200,5.629883,0.0,5.629883,63.88425947,5022.290039,5202.509765999999,94.21279336,-5.7872066360000005,22.36919184,21.604748800000003,0.03052635,1346600,1,0.5423
BSESN,9/1/2004,5210.850098,5222.810059,5202.02002,5202.160156,16200,18.770020000000002,0.0,18.770020000000002,66.51980914,5022.290039,5222.810059,94.03552772,-5.964472276,27.28280927,22.74036089,0.017019156,1362800,1,0.6369
BSESN,9/2/2004,5198.720215,5233.319824,5189.290039,5218.950195,19200,-12.129883,12.129883,0.0,63.0869649,5022.290039,5233.319824,83.60439546,-16.39560454,29.85396833,24.16308238,0.026469705,1343600,-1,0.0
BSESN,9/3/2004,5218.459961,5223.939941,5178.569824,5190.689941,17600,19.739746,0.0,19.739746,66.3479409,5022.290039,5233.319824,92.9584049,-7.0415951,33.10287362,25.95104063,0.036706675,1361200,1,0.0
BSESN,9/6/2004,5246.22998,5264.870117,5226.089844,5226.089844,17000,27.770019,0.0,27.770019,70.56843864,5022.290039,5264.870117,92.31588301,-7.684116995,37.48634369,28.25810124,0.035292298,1378200,1,0.0
BSESN,9/7/2004,5264.669922,5270.890136999999,5240.149902,5245.160156,19200,18.439942000000002,0.0,18.439942000000002,73.1486183,5022.290039,5270.890136999999,97.49790324,-2.502096761,41.96448405,30.999377799999998,0.034608978,1397400,1,-0.29600000000000004
BSESN,9/8/2004,5298.160156,5305.669922,5270.660156,5281.109863000001,20200,33.490234,0.0,33.490234,77.31599629,5022.290039,5305.669922,97.34992974,-2.650070259,47.66635647,34.33277354,0.03168368,1417600,1,0.5106
BSESN,9/9/2004,5298.22998,5328.330078,5269.509765999999,5307.830078,21600,0.069824,0.0,0.069824,77.32446249,5022.290039,5328.330078,90.16465359,-9.835346414,51.59599908,37.78541865,0.035415257,1439200,1,0.0
BSESN,9/10/2004,5370.049805,5376.120117,5281.060059,5305.419922,21200,71.819825,0.0,71.819825,84.28530787,5040.709961,5376.120117,98.19018241,-1.8098175890000001,59.81600713,42.19153634,0.03539986,1460400,1,0.0
BSESN,9/13/2004,5397.459961,5421.52002,5379.600098,5380.709961,21400,27.410156,0.0,27.410156,86.15667836,5054.560059,5421.52002,93.4434103,-6.556589698,67.76108562,47.305446200000006,0.039556377999999996,1481800,1,0.1779
BSESN,9/14/2004,5428.77002,5434.330078,5376.040039,5409.52002,26400,31.310059000000003,0.0,31.310059000000003,88.03468948,5094.560059,5434.330078,98.36358193,-1.636418074,75.71132464,52.98662189,0.041820417,1508200,1,-0.4767
BSESN,9/15/2004,5420.089844,5456.850098,5399.339844,5441.959961,27600,-8.680176,8.680176,0.0,84.37322318,5094.560059,5456.850098,89.85336332,-10.14663668,80.38490158,58.46627782,0.042581562,1480600,-1,0.4019
BSESN,9/16/2004,5477.680176,5483.589844,5401.0,5415.459961,23400,57.590332,0.0,57.590332,88.14714655,5130.540039,5483.589844,98.32610926,-1.673890742,87.72456923,64.31793611,0.049673699999999994,1504000,1,0.0
BSESN,9/17/2004,5561.149902,5569.470215,5493.370117,5493.720215,26400,83.469726,0.0,83.469726,91.55706743,5155.959961,5569.470215,97.9878823,-2.012117697,99.13386454,71.28112179,0.060027853,1530400,1,0.0
BSESN,9/20/2004,5545.819824,5585.569824,5535.569824,5562.680176,25600,-15.330078,15.330078,0.0,86.29598324,5178.569824,5585.569824,90.23341523,-9.766584767000001,105.7201283,78.16892309,0.053403139,1504800,-1,0.0
BSESN,9/21/2004,5605.930176,5611.600098,5536.0,5547.490234000001,27600,60.110352,0.0,60.110352,89.12360421,5178.569824,5611.600098,98.69064074,-1.309359262,114.47064640000002,85.42926775,0.05808998,1532400,1,-0.743
BSESN,9/22/2004,5616.870117,5638.790039,5571.839844,5609.959961,28000,10.939941000000001,0.0,10.939941000000001,89.57530444,5178.569824,5638.790039,95.23707971,-4.76292029,120.89465849999999,92.52234591,0.060140865999999994,1560400,1,0.1511
BSESN,9/23/2004,5539.47998,5609.040039,5530.859863000001,5597.319824,27400,-77.390137,77.390137,0.0,66.89778347,5226.089844,5638.790039,75.9365127,-24.063487300000002,118.3764274,97.6931622,0.03155095,1533000,-1,0.0
BSESN,9/24/2004,5527.75,5575.399902,5513.680176,5527.220215,22600,-11.72998,11.72998,0.0,64.06141046,5240.149902,5638.790039,72.14529379,-27.85470621,114.1187102,100.9782718,0.02413914,1510400,-1,-0.4767
BSESN,9/27/2004,5511.810059,5545.72998,5486.410156,5530.0,15800,-15.939941000000001,15.939941000000001,0.0,60.068101899999995,5269.509765999999,5638.790039,65.61419895,-34.38580105,108.21083159999999,102.4247838,0.01529629,1494600,-1,0.0
BSESN,9/28/2004,5462.609863000001,5518.209961,5454.850098,5506.830078,20400,-49.200196000000005,49.200196000000005,0.0,49.15533122,5269.509765999999,5638.790039,52.29093215,-47.70906785,98.42417789,101.6246626,0.007844892,1474200,-1,0.6369
BSESN,9/29/2004,5527.560059,5533.330078,5428.200195,5477.609863000001,23400,64.95019599999999,0.0,64.95019599999999,60.17579308,5281.060059,5638.790039,68.90672121,-31.09327879,94.81614089,100.2629582,0.009106023000000001,1497600,1,-0.1779
BSESN,9/30/2004,5583.609863000001,5598.549805,5545.259765999999,5545.259765999999,24400,56.049804,0.0,56.049804,67.24503779,5376.040039,5638.790039,78.99898154,-21.00101846,95.38001489,99.28636957,0.004038725999999999,1522000,1,0.4019
BSESN,10/1/2004,5675.540039,5685.680176,5573.560059,5587.459961,24400,91.930176,0.0,91.930176,75.48165568,5376.040039,5685.680176,96.72518649999999,-3.274813497,102.0683061,99.84275688,0.023390629,1546400,1,0.0
BSESN,10/4/2004,5766.299805,5785.040039,5706.319824,5706.319824,20600,90.759766,0.0,90.759766,80.94114289,5399.339844,5785.040039,95.14124332,-4.858756683,113.38534399999999,102.5512743,0.02860714,1567000,1,0.0
BSESN,10/5/2004,5758.669922,5786.540039,5741.700195,5761.660156,22800,-7.629883,7.629883,0.0,79.22985919,5401.0,5786.540039,92.77114847,-7.228851528,120.35117690000001,106.1112548,0.025245342,1544200,-1,0.4574
BSESN,10/6/2004,5713.75,5799.919922,5699.319824,5761.439941,26800,-44.919922,44.919922,0.0,69.2797466,5428.200195,5799.919922,76.81857708,-23.18142292,120.85385919999999,109.0597757,0.031459635,1517400,-1,-0.5859
BSESN,10/7/2004,5773.660156,5793.080078,5718.640136999999,5718.640136999999,24600,59.91015600000001,0.0,59.91015600000001,74.25525121,5428.200195,5799.919922,92.93560064,-7.064399356,124.6496045,112.17774150000001,0.044486483,1542000,1,0.0
BSESN,10/8/2004,5776.850098,5803.819824,5755.419922,5782.629883,19600,3.189942,0.0,3.189942,74.50889905,5428.200195,5803.819824,92.819937,-7.180062999,126.4574389,115.033681,0.048085844,1561600,1,0.0
BSESN,10/11/2004,5717.540039,5792.080078,5706.970215,5764.859863000001,13000,-59.310058999999995,59.310058999999995,0.0,61.50814303,5428.200195,5803.819824,77.03001166,-22.96998834,121.70143629999998,116.367232,0.046668201,1548600,-1,0.0
BSESN,10/12/2004,5676.72998,5762.600098,5663.790039,5750.359863000001,18200,-40.810059,40.810059,0.0,54.02412270000001,5428.200195,5803.819824,66.16528153,-33.83471847,113.3328092,115.76034750000001,0.026986576,1530400,-1,0.0258
BSESN,10/14/2004,5713.100098,5738.609863000001,5645.660156,5677.870117,17600,36.370118,0.0,36.370118,59.13692272,5428.200195,5803.819824,75.84798051,-24.15201949,108.38597040000002,114.285472,0.023191132000000003,1548000,1,0.0
BSESN,10/15/2004,5686.72998,5758.109863000001,5673.75,5735.490234000001,16200,-26.370117999999998,26.370117999999998,0.0,54.1034363,5428.200195,5803.819824,68.82754921,-31.17245079,101.1714752,111.6626727,0.0019716079999999997,1531800,-1,-0.1531
BSESN,10/18/2004,5679.830078,5727.959961,5670.370117,5706.830078,12400,-6.899902,6.899902,0.0,52.74795187,5428.200195,5803.819824,66.9906106,-33.009389399999996,93.81572203,108.0932825,-0.014995703999999999,1519400,-1,-0.4767
BSESN,10/19/2004,5738.109863000001,5751.600098,5686.970215,5691.470215,14800,58.279785,0.0,58.279785,62.0212338,5428.200195,5803.819824,82.50624943,-17.49375057,91.63264219,104.80115450000001,-0.0035702790000000004,1534200,1,0.6115
BSESN,10/20/2004,5673.02002,5750.140136999999,5662.759765999999,5738.439941,18400,-65.089843,65.089843,0.0,49.50197672,5545.259765999999,5803.819824,49.41221587,-50.58778413,83.68565322,100.5780542,-0.007128415,1515800,-1,0.0
BSESN,10/21/2004,5641.060059,5685.180176,5617.370117,5680.439941,19000,-31.959961,31.959961,0.0,44.42183767,5573.560059,5803.819824,29.31471766,-70.68528234,73.95618459999999,95.2536803,-0.022966384,1496800,-1,0.0
BSESN,10/25/2004,5581.490234000001,5645.879883,5573.189941,5633.47998,18200,-59.569825,59.569825,0.0,36.39017904,5573.189941,5803.819824,3.598966835,-96.40103317,60.73856719,88.35065767,-0.033817714,1478600,-1,-0.5106
BSESN,10/26/2004,5651.089844,5654.819824,5558.140136999999,5591.009765999999,22000,69.59961,0.0,69.59961,48.85625191,5558.140136999999,5803.819824,37.83369644,-62.16630356,55.24281227,81.72908859,-0.011622165,1500600,1,0.0
BSESN,10/27/2004,5662.870117,5699.180176,5623.040039,5656.709961,19800,11.780273,0.0,11.780273,50.74156112,5558.140136999999,5803.819824,42.62866877,-57.37133123,51.24721054,75.63271298,-0.0024415220000000002,1520400,1,0.0
BSESN,10/28/2004,5715.620117,5733.75,5700.990234000001,5700.990234000001,23400,52.75,0.0,52.75,58.62236798,5558.140136999999,5803.819824,64.09971533,-35.90028467,51.74071676,70.85431374,0.000441095,1543800,1,-0.5574
BSESN,10/29/2004,5672.27002,5731.350098,5664.040039,5724.459961,22600,-43.350097,43.350097,0.0,50.90041921,5558.140136999999,5803.819824,46.45474943,-53.54525057,48.07960173,66.29937134,-0.002542755,1521200,-1,0.0
BSESN,11/1/2004,5704.100098,5714.359863000001,5649.029785,5678.649902,15600,31.830078000000004,0.0,31.830078000000004,55.8297601,5558.140136999999,5792.080078,62.39206541,-37.60793459,47.202442600000005,62.47998559,0.004273019,1536800,1,-0.7269
BSESN,11/2/2004,5754.759765999999,5765.140136999999,5713.240234000001,5713.240234000001,14400,50.659667999999996,0.0,50.659667999999996,62.70561979,5558.140136999999,5765.140136999999,94.98532802,-5.014671981,50.01851717,59.98769191,0.002901635,1551200,1,-0.1027
BSESN,11/3/2004,5842.540039,5845.5,5771.72998,5772.319824,17000,87.780273,0.0,87.780273,71.55768624,5558.140136999999,5845.5,98.96994627,-1.030053734,58.65724675,59.72160287,0.029881795,1568200,1,0.0
BSESN,11/4/2004,5832.879883,5883.390136999999,5814.370117,5871.620117,15000,-9.660156,9.660156,0.0,69.46407216,5558.140136999999,5883.390136999999,84.47032929,-15.52967071,63.98641278,60.57456486,0.034004216000000004,1553200,-1,0.34
BSESN,11/5/2004,5891.359863000001,5900.509765999999,5823.439941,5833.330078,14000,58.479980000000005,0.0,58.479980000000005,74.64566761,5558.140136999999,5900.509765999999,97.32747819,-2.672521808,72.09756506,62.8791649,0.055517365,1567200,1,0.2263
BSESN,11/8/2004,5930.470215,5955.939941,5912.52002,5912.52002,14400,39.110352,0.0,39.110352,77.58126146,5558.140136999999,5955.939941,93.59735079,-6.402649208,80.75074589,66.45348109,0.049438317,1581600,1,0.0
BSESN,11/9/2004,5929.600098,5957.939941,5910.410156,5937.339844,14800,-0.870117,0.870117,0.0,77.35135797,5558.140136999999,5957.939941,92.91149152,-7.088508478,86.54065605,70.47091609,0.047101554000000004,1566800,-1,0.0
BSESN,11/10/2004,5973.75,5979.779785,5918.950195,5918.950195,14400,44.149902000000004,0.0,44.149902000000004,80.69985094,5558.140136999999,5979.779785,98.56991983,-1.430080171,93.61262166,75.09925720000001,0.045162183,1581200,1,-0.29600000000000004
BSESN,11/11/2004,5954.310059,5995.330078,5943.330078,5980.029785,13800,-19.439941,19.439941,0.0,75.06167552,5558.140136999999,5995.330078,90.61734611,-9.382653889,96.53576043,79.38655785,0.049722605,1567400,-1,0.0
BSESN,11/12/2004,5964.009765999999,6001.990234000001,5945.97998,5985.049805,3800,9.699707,0.0,9.699707,76.02598877,5558.140136999999,6001.990234000001,91.44295152,-8.557048485,98.49961204,83.20916868,0.04556541099999999,1571200,1,0.0
BSESN,11/16/2004,5996.700195,6002.029785,5949.240234000001,5970.040039,13800,32.690428999999995,0.0,32.690428999999995,79.15973618,5623.040039,6002.029785,98.59373768,-1.406262321,101.523523,86.87203955,0.042041795,1585000,1,0.0
BSESN,11/17/2004,6016.580078,6036.700195,5997.740234000001,6000.109863000001,14800,19.879883,0.0,19.879883,80.91061589,5649.029785,6036.700195,94.80999414,-5.190005861,104.3215804,90.36194773,0.02978842,1599800,1,0.0
BSESN,11/18/2004,6025.470215,6035.220215,5985.569824,6019.850098,14800,8.890137,0.0,8.890137,81.70376942,5649.029785,6036.700195,97.10321456,-2.896785442,106.03412549999999,93.49638328,0.033018052,1614600,1,0.0
BSESN,11/19/2004,5961.709961,6044.549805,5953.419922,6030.810059,15000,-63.760254,63.760254,0.0,60.79878906,5649.029785,6044.549805,79.05546121,-20.94453879,101.08120890000001,95.01334839,0.011941233,1599600,-1,0.3612
BSESN,11/22/2004,5963.799805,5979.100098,5877.970215,5921.009765999999,14000,2.089844,0.0,2.089844,61.17448511,5713.240234000001,6044.549805,75.62702467,-24.37297533,96.21550722,95.25378016,0.005620059,1613600,1,0.0
BSESN,11/23/2004,6009.859863000001,6031.589844,5977.759765999999,5988.279785,14600,46.060058000000005,0.0,46.060058000000005,68.78281599,5771.72998,6044.549805,87.28466965,-12.71533035,94.98118143,95.19926041,0.013535443000000001,1628200,1,-0.4767
BSESN,11/24/2004,6035.950195,6053.189941,6001.459961,6001.459961,12800,26.090332,0.0,26.090332,72.32710983,5814.370117,6053.189941,92.78127514,-7.218724858,95.01299048,95.16200643,0.010412253,1641000,1,0.0
BSESN,11/25/2004,6035.029785,6081.740234000001,6014.97998,6033.799805,20000,-0.9204100000000001,0.9204100000000001,0.0,71.99438573,5823.439941,6081.740234000001,81.91622299,-18.08377701,93.88171996,94.90594913,0.01355652,1621000,-1,0.0
BSESN,11/29/2004,6157.77002,6166.720215,6029.819824,6033.419922,23000,122.74023500000001,0.0,122.74023500000001,83.60175879,5877.970215,6166.720215,96.90036537,-3.099634632,101.7167636,96.26811202,0.032488252,1644000,1,0.25
BSESN,11/30/2004,6234.290039,6248.430176,6194.609863000001,6195.02002,18800,76.52001899999999,0.0,76.52001899999999,87.36792552,5877.970215,6248.430176,96.1830863,-3.8169136989999997,112.80032620000001,99.57455485,0.039620097,1662800,1,0.0
BSESN,12/1/2004,6227.830078,6272.680176,6176.089844,6259.279785,26600,-6.459961,6.459961,0.0,85.45610078,5877.970215,6272.680176,88.63720138,-11.36279862,119.68323070000001,103.59629,0.035111309,1636200,-1,0.0
BSESN,12/2/2004,6328.430176,6335.140136999999,6275.410156,6275.410156,26200,100.600098,0.0,100.600098,89.5607888,5877.970215,6335.140136999999,98.53228293,-1.4677170730000002,131.73698729999998,109.2244295,0.050279887,1662400,1,-0.8176
BSESN,12/3/2004,6322.759765999999,6361.529785,6304.220215,6348.319824,20600,-5.6704099999999995,5.6704099999999995,0.0,87.94649785,5877.970215,6361.529785,91.98236962,-8.017630382,139.22719719999998,115.22498300000001,0.060561450999999995,1641800,-1,0.0
BSESN,12/6/2004,6322.5,6386.290039,6312.129883,6351.040039,18800,-0.259766,0.259766,0.0,87.86278644,5877.970215,6386.290039,87.45080636,-12.54919364,143.4882384,120.8776341,0.06014625,1623000,-1,0.0
BSESN,12/7/2004,6316.279785,6354.259765999999,6287.459961,6324.069824,17800,-6.2202150000000005,6.2202150000000005,0.0,85.61130592,5877.970215,6386.290039,86.22712499,-13.77287501,144.6952679,125.6411608,0.050986200999999995,1605200,-1,0.0
BSESN,12/8/2004,6261.52002,6359.200195,6250.240234000001,6333.040039,26000,-54.759765,54.759765,0.0,67.92952886,5877.970215,6386.290039,75.45442591,-24.54557409,139.623697,128.4376681,0.037371055,1579200,-1,0.5423
BSESN,12/9/2004,6304.27002,6319.009765999999,6241.27002,6259.5,19400,42.75,0.0,42.75,72.96014908,5877.970215,6386.290039,83.86448548,-16.13551452,137.4693472,130.24400390000002,0.044612909000000006,1598600,1,0.3612
BSESN,12/10/2004,6233.540039,6336.899902,6221.399902,6328.100098,17600,-70.72998100000001,70.72998100000001,0.0,56.14673147,5877.970215,6386.290039,69.95002107,-30.04997893,128.5725864,129.90972040000003,0.012304782,1581000,-1,0.0
BSESN,12/13/2004,6268.720215,6274.240234000001,6220.580078,6231.470215,14600,35.180176,0.0,35.180176,61.26909405,5977.759765999999,6386.290039,71.22127006,-28.77872994,122.94337079999998,128.5164505,0.00552271,1595600,1,0.0
BSESN,12/14/2004,6325.529785,6331.569824,6280.490234000001,6280.560059,14000,56.809569999999994,0.0,56.809569999999994,68.19183871,6001.459961,6386.290039,84.21114734,-15.78885266,121.6637703,127.14591440000001,0.0156876,1609600,1,0.0
BSESN,12/15/2004,6402.290039,6423.27002,6334.27002,6334.27002,22400,76.760254,0.0,76.760254,75.12394202,6014.97998,6423.27002,94.86150066,-5.138499337,125.3980777,126.79634709999999,0.011671118999999999,1632000,1,-0.2263
BSESN,12/16/2004,6420.379883,6437.0,6373.549805,6401.189941,18600,18.089844,0.0,18.089844,76.51565972,6029.819824,6437.0,95.91824014,-4.0817598639999995,128.33784359999999,127.10464640000002,0.015439478999999999,1650600,1,-0.5574
BSESN,12/17/2004,6346.47998,6436.080078,6329.709961,6420.899902,16800,-73.89990300000001,73.89990300000001,0.0,60.54843416,6176.089844,6437.0,65.30605731,-34.69394269,123.2833905,126.3403952,0.0037928000000000003,1633800,-1,0.0
BSESN,12/20/2004,6403.0,6409.52002,6345.870117,6360.109863000001,16800,56.520019999999995,0.0,56.520019999999995,66.68380567,6176.089844,6437.0,86.96869431,-13.03130569,122.42712959999999,125.55774209999998,0.013729635,1650600,1,-0.29600000000000004
BSESN,12/21/2004,6451.299805,6461.640136999999,6400.560059,6429.25,14600,48.299805,0.0,48.299805,71.11340062,6220.580078,6461.640136999999,95.71047479,-4.289525209,124.2140648,125.2890066,0.0303089,1665200,1,-0.3818
BSESN,12/22/2004,6413.660156,6480.200195,6396.430176,6465.509765999999,16200,-37.639649,37.639649,0.0,63.51951742,6220.580078,6480.200195,74.37022995,-25.62977005,121.1959473,124.47039479999998,0.017351753,1649000,-1,-0.2263
BSESN,12/23/2004,6441.850098,6455.689941,6409.290039,6410.299805,12000,28.189942,0.0,28.189942,66.6015375,6220.580078,6480.200195,85.22838005,-14.77161995,119.69894520000001,123.5161048,0.033417617999999996,1661000,1,0.0
BSESN,12/24/2004,6498.060059,6507.939941,6463.850098,6485.259765999999,14600,56.209961,0.0,56.209961,72.03688639,6220.580078,6507.939941,96.56184343,-3.438156567,121.6459753,123.14207890000002,0.036584795,1675600,1,-0.3612
BSESN,12/27/2004,6513.029785,6566.640136999999,6469.959961,6484.839844,16200,14.969726000000001,0.0,14.969726000000001,73.36869516,6220.580078,6566.640136999999,84.50836766,-15.49163234,122.97931340000001,123.10952579999999,0.029641786,1691800,1,0.4767
BSESN,12/28/2004,6563.47998,6568.569824,6517.899902,6517.899902,14600,50.450195,0.0,50.450195,77.53021659,6220.580078,6568.569824,98.53735805,-1.4626419480000001,126.6469949,123.8170196,0.02517692,1706400,1,0.3612
BSESN,12/29/2004,6567.939941,6617.149902,6552.060059,6594.390136999999,12400,4.459961,0.0,4.459961,77.88275531,6220.580078,6617.149902,87.59109796,-12.40890204,128.4330443,124.7402246,0.022983073,1718800,1,0.0
BSESN,12/30/2004,6522.540039,6608.299805,6507.299805,6583.740234000001,13200,-45.399902000000004,45.399902000000004,0.0,65.76376652,6220.580078,6617.149902,76.14294955,-23.85705045,124.7471017,124.7416,0.027741372,1705600,-1,0.0
BSESN,12/31/2004,6602.689941,6609.779785,6541.379883,6541.379883,12200,80.149902,0.0,80.149902,74.00382819,6280.490234000001,6617.149902,95.70487279,-4.295127208,126.83135990000001,125.159552,0.031186934,1717800,1,-0.3182
BSESN,1/3/2005,6679.200195,6684.220215,6626.490234000001,6626.490234000001,12000,76.510254,0.0,76.510254,79.45128411,6329.709961,6684.220215,98.58395633,-1.4160436669999998,133.1223363,126.7521088,0.035326275,1729800,1,0.0
BSESN,1/4/2005,6651.009765999999,6696.310059,6640.899902,6683.560059,16600,-28.190428999999998,28.190428999999998,0.0,72.95219299,6329.709961,6696.310059,87.64313124,-12.35686876,134.285291,128.2587453,0.037006889,1713200,-1,0.6249
BSESN,1/5/2005,6458.839844,6629.97998,6337.609863000001,6628.890136999999,24000,-192.16992199999999,192.16992199999999,0.0,44.39092295,6329.709961,6696.310059,35.2236357,-64.7763643,118.3363269,126.27426159999999,0.002637402,1689200,-1,0.0
BSESN,1/6/2005,6367.390136999999,6481.22998,6325.359863000001,6447.27002,22200,-91.44970699999999,91.44970699999999,0.0,36.53655011,6325.359863000001,6696.310059,11.33043585,-88.66956415,97.19700425,120.45881010000001,-0.020109066999999998,1667000,-1,0.2023
BSESN,1/7/2005,6420.459961,6440.169922,6348.75,6374.189941,17800,53.069824,0.0,53.069824,43.2589998,6325.359863000001,6696.310059,25.63689116,-74.36310884,83.76068896,113.11918590000002,-0.01421302,1684800,1,0.34
BSESN,1/10/2005,6308.540039,6469.089844,6286.850098,6440.330078,13200,-111.919922,111.919922,0.0,34.39374846,6286.850098,6696.310059,5.297206825,-94.70279317,63.35103859,103.1655564,-0.038842191,1671600,-1,-0.5106
BSESN,1/11/2005,6222.870117,6329.890136999999,6208.819824,6317.390136999999,16200,-85.669922,85.669922,0.0,29.12251413,6208.819824,6696.310059,2.8821691169999997,-97.11783088,39.80455477,90.4933561,-0.052538517,1655400,-1,-0.128
BSESN,1/12/2005,6102.740234000001,6263.709961,6070.330078,6250.350098,20800,-120.129883,120.129883,0.0,23.33586334,6070.330078,6696.310059,5.1775067869999996,-94.82249321,11.31983114,74.65865111,-0.064361399,1634600,-1,-0.4404
BSESN,1/13/2005,6221.060059,6242.950195,6138.049805,6138.049805,20200,118.319825,0.0,118.319825,37.45864029,6070.330078,6696.310059,24.07904175,-75.92095825,-1.687642427,59.3893924,-0.057799152,1654800,1,0.0
BSESN,1/14/2005,6173.819824,6249.390136999999,6144.080078,6232.419922,18200,-47.240235,47.240235,0.0,34.52837819,6070.330078,6696.310059,16.532436999999998,-83.467563,-15.62790237,44.38593345,-0.075664804,1636600,-1,0.0
BSESN,1/17/2005,6194.069824,6232.970215,6087.549805,6202.740234000001,19000,20.25,0.0,20.25,36.96721013,6070.330078,6696.310059,19.76736473,-80.23263527,-24.75627809,30.55749114,-0.068702341,1655600,1,-0.6597
BSESN,1/18/2005,6192.350098,6267.609863000001,6173.089844,6221.279785,21800,-1.7197259999999999,1.7197259999999999,0.0,36.83276495,6070.330078,6696.310059,19.49263933,-80.50736067,-31.7632027,18.09335237,-0.041259693,1633800,-1,0.0
BSESN,1/19/2005,6173.319824,6230.620117,6160.660156,6211.279785,16600,-19.030274,19.030274,0.0,35.19827006,6070.330078,6696.310059,16.45256224,-83.54743776,-38.40906916,6.7928680660000005,-0.030478785,1617200,-1,-0.7783
BSESN,1/20/2005,6183.240234000001,6197.209961,6091.080078,6170.330078,26600,9.92041,0.0,9.92041,36.88299164,6070.330078,6696.310059,18.03734295,-81.96265705,-42.38686267,-3.04307808,-0.036947466,1643800,1,0.0
BSESN,1/24/2005,6106.430176,6215.779785,6089.52002,6201.600098,18000,-76.810058,76.810058,0.0,29.93113117,6070.330078,6696.310059,5.7669732410000005,-94.23302676,-51.14762445,-12.66398736,-0.032037502,1625800,-1,0.0
BSESN,1/25/2005,6162.97998,6174.0,6069.330078,6093.660156,21400,56.549804,0.0,56.549804,39.60186351,6069.330078,6629.97998,16.70381136,-83.29618864,-52.91749477,-20.71468884,-0.009624198,1647200,1,0.5267
BSESN,1/27/2005,6239.430176,6252.240234000001,6188.379883,6188.379883,22200,76.45019599999999,0.0,76.45019599999999,50.30157949,6069.330078,6481.22998,41.29646479,-58.70353521,-47.602505799999996,-26.09225223,0.022398126,1669400,1,0.5574
BSESN,1/28/2005,6419.089844,6430.720215,6245.259765999999,6245.259765999999,23600,179.65966799999998,0.0,179.65966799999998,66.42819667,6069.330078,6469.089844,87.49248818,-12.50751182,-28.56403658,-26.5866091,0.031832161,1693000,1,0.4588
BSESN,1/31/2005,6555.939941,6565.0,6455.549805,6463.52002,22000,136.850097,0.0,136.850097,73.87806315,6069.330078,6565.0,98.17215881,-1.82784119,-2.405524057,-21.75039209,0.06189363,1715000,1,0.0
BSESN,2/1/2005,6552.470215,6586.25,6508.990234000001,6565.209961,28400,-3.469726,3.469726,0.0,73.40154767,6069.330078,6586.25,93.46518028,-6.53481972,17.83966316,-13.83238104,0.057861857999999995,1686600,-1,-0.5859
BSESN,2/2/2005,6530.060059,6600.02002,6510.419922,6560.620117,88400,-22.410156,22.410156,0.0,70.03507778,6069.330078,6600.02002,86.81716847,-13.18283153,31.71027132,-4.72385057,0.054536639000000005,1598200,-1,0.3612
BSESN,2/3/2005,6619.970215,6630.680176,6550.75,6550.75,14400,89.910156,0.0,89.910156,75.28289697,6069.330078,6630.680176,98.09210668,-1.907893316,49.38850644,6.098620831,0.072351734,1612600,1,0.0
BSESN,2/4/2005,6618.22998,6684.160156,6571.509765999999,6635.850098,16800,-1.7402349999999998,1.7402349999999998,0.0,74.98959581,6069.330078,6684.160156,89.27668337,-10.72331663,62.5373214,17.38636094,0.070349805,1595800,-1,0.0
BSESN,2/7/2005,6535.169922,6658.330078,6514.859863000001,6652.330078,12400,-83.060058,83.060058,0.0,61.7421679,6069.330078,6684.160156,75.76725028,-24.23274972,65.5005499,27.00919874,0.070211193,1583400,-1,-0.6705
BSESN,2/8/2005,6544.77002,6573.930176,6508.330078,6528.810059,12600,9.600098,0.0,9.600098,62.62274879,6069.330078,6684.160156,77.32867324,-22.67132676,67.84154245,35.17566748,0.061948934000000004,1596000,1,-0.29600000000000004
BSESN,2/9/2005,6593.529785,6613.540039,6553.399902,6556.529785,13000,48.759765,0.0,48.759765,67.06533615,6069.330078,6684.160156,85.25928151,-14.74071849,72.79219829,42.69897364,0.056751915,1609000,1,-0.2732
BSESN,2/10/2005,6577.830078,6608.959961,6533.970215,6600.850098,12600,-15.699707,15.699707,0.0,64.22912554,6069.330078,6684.160156,82.70577809999999,-17.294221899999997,74.58897825,49.07697456,0.024729399,1596400,-1,0.0
BSESN,2/11/2005,6633.759765999999,6640.109863000001,6594.319824,6594.319824,15200,55.929688,0.0,55.929688,69.52650823,6069.330078,6684.160156,91.80254971,-8.197450287999999,79.60832253,55.18324416,0.011870125,1611600,1,-0.8225
BSESN,2/14/2005,6679.330078,6719.169922,6659.640136999999,6673.390136999999,13600,45.570312,0.0,45.570312,73.25069765,6069.330078,6719.169922,93.86928266,-6.13071734,86.26887843,61.40037101,0.019360617,1625200,1,-0.5267
BSESN,2/15/2005,6670.060059,6694.790039,6640.430176,6694.790039,20800,-9.270019,9.270019,0.0,71.20808793,6188.379883,6719.169922,90.74777984,-9.252220161,89.76465287,67.07322738,0.021439312999999998,1604400,-1,0.0
BSESN,2/16/2005,6607.779785,6714.129883,6581.529785,6673.709961,14800,-62.280274,62.280274,0.0,58.55119298,6245.259765999999,6719.169922,76.49551596,-23.50448404,86.51232149,70.96104620000001,-0.0018414629999999998,1589600,-1,0.0
BSESN,2/17/2005,6589.290039,6599.47998,6533.129883,6598.77002,14400,-18.489746,18.489746,0.0,55.19077951,6455.549805,6719.169922,50.73218066,-49.26781934,81.50333772,73.06950451,-0.004372761,1575200,-1,0.0
BSESN,2/18/2005,6584.319824,6642.77002,6564.549805,6595.189941,14400,-4.9702150000000005,4.9702150000000005,0.0,54.22550091,6508.330078,6719.169922,36.04145429,-63.95854571,76.25362289,73.70632818,0.00752083,1560800,-1,0.0
BSESN,2/21/2005,6534.680176,6602.529785,6521.069824,6585.879883,11800,-49.639648,49.639648,0.0,45.12954182,6508.330078,6719.169922,12.49768426,-87.50231574,67.31175333,72.42741321,-0.001541665,1549000,-1,0.1531
BSESN,2/22/2005,6589.410156,6603.140136999999,6515.72998,6531.580078,11000,54.729980000000005,0.0,54.729980000000005,54.77948824,6508.330078,6719.169922,38.45576645,-61.54423355,63.90485389,70.72290135,-0.000624799,1560000,1,-0.29600000000000004
BSESN,2/23/2005,6582.5,6607.779785,6565.419922,6593.850098,12200,-6.910156,6.910156,0.0,53.41104171,6508.330078,6719.169922,35.17832332,-64.82167668,59.95613273,68.56954762,0.000709949,1547800,-1,0.0
BSESN,2/24/2005,6574.209961,6621.680176,6565.810059,6616.370117,26800,-8.290039,8.290039,0.0,51.62581486,6508.330078,6719.169922,31.24641043,-68.75358957,55.5178309,65.95920428,-0.00897678,1521000,-1,0.0
BSESN,2/25/2005,6569.720215,6622.620117,6543.910156,6588.290039,14400,-4.489746,4.489746,0.0,50.56956971,6508.330078,6719.169922,29.11695239,-70.88304761,51.04969068,62.97730156,-0.016410308000000002,1506600,-1,0.0
BSESN,2/28/2005,6713.859863,6720.939941,6545.939941,6584.339844,23200,144.139648,0.0,144.139648,71.88085126,6515.72998,6720.939941,96.54983707,-3.450162928,58.46556767,62.07495478,0.006566628000000001,1529800,1,0.0
BSESN,3/1/2005,6651.080078,6725.919922,6628.220215,6725.919922,16800,-62.779785,62.779785,0.0,59.07997372,6515.72998,6725.919922,64.394184,-35.605816,58.60137941,61.38023971,0.006552926,1513000,-1,0.0
BSESN,3/2/2005,6686.890136999999,6708.779785,6647.109863000001,6658.939941,26000,35.810059,0.0,35.810059,63.37297746,6515.72998,6725.919922,81.43118332,-18.56881668,60.89660551,61.28351287,0.014811929,1539000,1,-0.1779
BSESN,3/3/2005,6784.720215,6793.240234000001,6691.180176,6700.790039,18200,97.830078,0.0,97.830078,72.47547334,6515.72998,6793.240234000001,96.92983633,-3.07016367,69.80498996,62.98780829,0.030436005,1557200,1,-0.6124
BSESN,3/4/2005,6849.47998,6864.620117,6798.620117,6798.620117,18200,64.759765,0.0,64.759765,76.86662677,6515.72998,6864.620117,95.66048581,-4.339514189,81.15501612,66.62124985,0.048173712,1575400,1,0.0
BSESN,3/7/2005,6878.97998,6902.490234000001,6854.959961,6863.580078,14600,29.5,0.0,29.5,78.65637367,6515.72998,6902.490234000001,93.92123318,-6.078766822,91.47591963,71.59218381,0.043944725999999996,1590000,1,-0.5423
BSESN,3/8/2005,6915.089844,6929.589844,6872.720215,6885.72998,15200,36.109864,0.0,36.109864,80.75886881,6515.72998,6929.589844,96.49639859999999,-3.5036014030000002,101.4001959,77.55378623,0.050526372,1605200,1,0.0
BSESN,3/9/2005,6892.819823999999,6954.859863,6843.439941,6895.620117,17400,-22.270020000000002,22.270020000000002,0.0,75.46862271,6515.72998,6954.859863,85.87205257,-14.12794743,106.2435425,83.29173747,0.048463597000000004,1587800,-1,0.0
BSESN,3/10/2005,6907.649901999999,6917.600098000001,6849.97998,6888.72998,27200,14.830078,0.0,14.830078,76.64419985,6515.72998,6954.859863,89.24920329,-10.75079671,110.01046070000001,88.63548212,0.051437455,1615000,1,-0.5574
BSESN,3/11/2005,6853.72998,6948.540039,6839.350098000001,6921.02002,14200,-53.919922,53.919922,0.0,63.81484918,6515.72998,6954.859863,76.97039375,-23.02960625,107.4067652,92.38973874,0.020833041,1600800,-1,0.0
BSESN,3/14/2005,6810.040039,6882.22998,6794.919922,6854.919922,124800,-43.689941,43.689941,0.0,55.17944243,6543.910156,6954.859863,64.75972083,-35.24027917,100.65758659999999,94.04330831,0.023899872000000003,1476000,-1,0.0
BSESN,3/15/2005,6752.450195,6823.459961,6730.22998,6815.589844,12800,-57.58984399999999,57.58984399999999,0.0,45.76118307,6543.910156,6954.859863,50.745878499999996,-49.254121500000004,89.62861199,93.16036905,0.009804267,1463200,-1,0.4939
BSESN,3/16/2005,6746.879883,6806.720215,6732.330078,6757.490234000001,13000,-5.570312,5.570312,0.0,44.90576781,6543.910156,6954.859863,49.39040558,-50.60959442,79.52191341,90.43267792,-0.005577286999999999,1450200,-1,-0.4767
BSESN,3/17/2005,6669.52002,6737.290039,6642.600098,6719.109863,13000,-77.359863,77.359863,0.0,34.55496048,6545.939941,6954.859863,30.22109522,-69.77890478,64.52617003,85.25137634,-0.026273522,1437200,-1,0.0
BSESN,3/18/2005,6700.339844,6710.97998,6595.529785,6664.649902,15600,30.819824,0.0,30.819824,40.82503206,6595.529785,6954.859863,29.16818419,-70.83181581,54.50058872,79.10121882,-0.025968986,1452800,1,0.0
BSESN,3/21/2005,6656.689941,6734.720215,6633.52002,6716.410156,10000,-43.649903,43.649903,0.0,35.29849607,6595.529785,6954.859863,17.02060577,-82.97939423,42.54265568,71.78950619,-0.037367541000000004,1442800,-1,0.0
BSESN,3/22/2005,6535.450195,6656.310059,6520.149902,6655.779785,13600,-121.239746,121.239746,0.0,24.6180437,6520.149902,6954.859863,3.519655488,-96.48034451,23.01754144,62.03511324,-0.051846652,1429200,-1,0.0
BSESN,3/23/2005,6454.459961,6568.200195,6435.819824,6533.649902,23400,-80.990234,80.990234,0.0,19.96238257,6435.819824,6954.859863,3.591271501,-96.40872850000001,0.9970196929999999,49.82749453,-0.065606964,1405800,-1,-0.6908
BSESN,3/24/2005,6442.870117,6514.72998,6412.890136999999,6456.02002,17200,-11.589844,11.589844,0.0,19.35790657,6412.890136999999,6954.859863,5.531670601,-94.46832940000002,-17.19143384,36.42370886,-0.059946900000000004,1388600,-1,0.0
BSESN,3/28/2005,6510.740234000001,6555.100098,6471.470215,6471.470215,11600,67.87011700000001,0.0,67.87011700000001,33.05513941,6412.890136999999,6954.859863,18.05453189,-81.94546811,-25.83159256,23.97264857,-0.043949786,1400200,1,-0.1531
BSESN,3/29/2005,6367.859863000001,6512.97998,6326.72998,6512.97998,14400,-142.880371,142.880371,0.0,23.40046849,6326.72998,6954.859863,6.547990171,-93.45200983,-43.70443492,10.43723187,-0.056955671,1385800,-1,0.0
BSESN,3/30/2005,6381.399902,6400.069824,6321.310059,6371.399902,14600,13.540039000000002,0.0,13.540039000000002,25.77111432,6321.310059,6948.540039,9.580193057999999,-90.41980694,-56.12920077,-2.8760546560000004,-0.054170222000000004,1400400,1,-0.29600000000000004
BSESN,3/31/2005,6492.819824,6509.02002,6404.779785,6404.779785,13400,111.419922,0.0,111.419922,42.62962163,6321.310059,6948.540039,27.34399988,-72.65600012,-56.33585602,-13.56801493,-0.02649369,1413800,1,-0.5994
BSESN,4/1/2005,6605.040039,6618.080078,6468.52002,6506.600098,11400,112.220215,0.0,112.220215,54.60982494,6321.310059,6882.22998,50.58297439,-49.41702561,-46.903721399999995,-20.23515622,-0.01422313,1425200,1,0.0
BSESN,4/4/2005,6604.419922,6649.419922,6586.25,6616.830078,11200,-0.620117,0.620117,0.0,54.53721102,6321.310059,6823.459961,56.37955158,-43.62044842,-39.02882502,-23.99388998,-0.007852254,1414000,-1,0.0
BSESN,4/5/2005,6550.290039,6621.910156,6532.939941,6611.529785,12200,-54.12988299999999,54.12988299999999,0.0,48.09597578,6321.310059,6806.720215,47.17247408,-52.82752592,-36.73231482,-26.54157495,0.002270669,1401800,-1,0.0
BSESN,4/6/2005,6606.410156,6617.069824,6551.680176,6555.919922,12200,56.12011700000001,0.0,56.12011700000001,54.52154134,6321.310059,6737.290039,68.53697551,-31.46302449,-30.03763436,-27.24078683,0.023541891000000002,1414000,1,0.3818
BSESN,4/7/2005,6545.640136999999,6644.689941,6530.970215,6629.120117,11000,-60.770019,60.770019,0.0,47.21795434,6321.310059,6734.720215,54.26332052,-45.73667948,-29.29795592,-27.65222065,0.015950969,1403000,-1,0.5423
BSESN,4/8/2005,6479.540039,6560.879883,6456.839844,6544.810059,11400,-66.100098,66.100098,0.0,40.4220527,6321.310059,6734.720215,38.27433306,-61.72566694,-33.65749823,-28.85327616,-0.004792112,1391600,-1,0.6249
BSESN,4/11/2005,6397.52002,6444.330078,6382.129883,6426.209961,9000,-82.02001899999999,82.02001899999999,0.0,33.51563242,6321.310059,6656.310059,22.74924209,-77.25075791,-43.23244032,-31.729109,0.00465779,1382600,-1,0.0
BSESN,4/12/2005,6464.609863000001,6472.040039,6404.350098,6407.390136999999,8800,67.089843,0.0,67.089843,42.74794566,6321.310059,6649.419922,43.674336,-56.325664,-44.88960188,-34.36120757,0.013039453000000001,1391400,1,0.0
BSESN,4/13/2005,6467.919922,6515.819824,6449.330078,6466.919922,13600,3.310059,0.0,3.310059,43.19698998,6321.310059,6649.419922,44.68316242,-55.31683758,-45.41233514,-36.57143309,-0.00383499,1405000,1,0.1779
BSESN,4/15/2005,6248.339844,6339.72998,6232.370117,6339.72998,14000,-219.580078,219.580078,0.0,26.99224398,6232.370117,6649.419922,3.829213396,-96.17078659999999,-62.82072399,-41.82129127,-0.05400424400000001,1391000,-1,0.0
BSESN,4/18/2005,6156.779785,6220.97998,6118.419922,6220.97998,12800,-91.560059,91.560059,0.0,22.86531523,6118.419922,6649.419922,7.224079661,-92.77592034,-83.04780573,-50.06659416,-0.067778873,1378200,-1,0.4019
BSESN,4/19/2005,6134.859863000001,6269.75,6121.419922,6181.390136999999,13800,-21.919922,21.919922,0.0,21.93874036,6118.419922,6649.419922,3.096034087,-96.90396591,-99.69741847,-59.99275902,-0.063421646,1364400,-1,0.0
BSESN,4/20/2005,6243.740234000001,6259.279785,6151.259765999999,6169.830078,16200,108.880371,0.0,108.880371,36.65161033,6118.419922,6649.419922,23.60081205,-76.39918795,-102.9202203,-68.57825128,-0.054896670999999994,1380600,1,0.5574
BSESN,4/21/2005,6299.200195,6305.879883,6174.299805,6249.290039,14600,55.459961,0.0,55.459961,42.96917073,6118.419922,6649.419922,34.04524915,-65.95475085,-99.84817105,-74.83223523,-0.037649479,1395200,1,0.0
BSESN,4/22/2005,6346.569824,6374.029785,6302.859863000001,6329.850098,12800,47.369628999999996,0.0,47.369628999999996,48.07277796,6118.419922,6649.419922,42.96608324,-57.03391676,-92.52465013,-78.37071821,-0.020521552,1408000,1,0.0
BSESN,4/25/2005,6377.850098,6391.72998,6308.47998,6338.669922,11000,31.280274,0.0,31.280274,51.38740617,6118.419922,6644.689941,49.29602041,-50.70397959,-83.23714437,-79.34400344,-0.003074617,1419000,1,-0.29600000000000004
BSESN,4/26/2005,6339.97998,6377.540039,6323.529785,6374.279785,8800,-37.870118,37.870118,0.0,47.18038026,6118.419922,6644.689941,42.10007221,-57.89992779,-78.03301514,-79.08180578,-0.019278794,1410200,-1,-0.4023
BSESN,4/27/2005,6278.5,6357.560059,6258.069824,6323.899902,14000,-61.479980000000005,61.479980000000005,0.0,40.90700659,6118.419922,6644.689941,30.41786008,-69.58213992,-77.97082666,-78.85960996,-0.029286065,1396200,-1,0.0
BSESN,4/28/2005,6284.200195,6292.910156,6233.290039,6271.609863000001,14800,5.700195,0.0,5.700195,41.73579835,6118.419922,6560.879883,37.46785870000001,-62.53214129999999,-76.57883065,-78.40345409999999,0.0057391809999999994,1411000,1,-0.0516
BSESN,4/29/2005,6154.439941,6288.439941,6138.470215,6283.069824,14000,-129.760254,129.760254,0.0,30.49990139,6118.419922,6515.819824,9.063922467000001,-90.93607753,-84.96678759,-79.7161208,-0.00038004300000000005,1397000,-1,0.3818
BSESN,5/2/2005,6195.149902,6223.779785,6141.370117,6183.069824,12200,40.709961,0.0,40.709961,36.67159656,6118.419922,6515.819824,19.30800174,-80.69199826,-87.32274799,-81.23744623,0.009827451999999999,1409200,1,0.0
BSESN,5/3/2005,6216.77002,6246.240234000001,6189.160156,6200.390136999999,12600,21.620117999999998,0.0,21.620117999999998,39.93981441,6118.419922,6515.819824,24.74839513,-75.25160487,-86.4487731,-82.27971161,-0.0043195609999999995,1421800,1,0.0
BSESN,5/4/2005,6289.549805,6294.850098,6218.950195,6218.950195,9600,72.779785,0.0,72.779785,49.96874201,6118.419922,6391.72998,62.61382558,-37.38617442,-78.97306892,-81.61838307,-0.0015320020000000002,1431400,1,0.0
BSESN,5/5/2005,6359.649902,6391.319824,6322.02002,6322.02002,9800,70.10009699999999,0.0,70.10009699999999,57.80006849,6118.419922,6391.72998,88.2623866,-11.7376134,-66.62402721,-78.6195119,0.002060968,1441200,1,0.0
BSESN,5/6/2005,6388.47998,6402.350098,6334.009765999999,6367.25,13800,28.830078000000004,0.0,28.830078000000004,60.71792188,6121.419922,6402.350098,95.06278813,-4.937211871000001,-53.88976863,-73.67356324,0.001666687,1455000,1,0.0
BSESN,5/9/2005,6481.350098,6486.069824,6391.799805,6391.799805,11600,92.870118,0.0,92.870118,68.74929241,6138.470215,6486.069824,98.64219468,-1.357805325,-35.89021452,-66.1168935,0.022298196,1466600,1,-0.4404
BSESN,5/10/2005,6454.709961,6494.910156,6439.689941,6486.080078,12600,-26.640137,26.640137,0.0,64.39182352,6138.470215,6494.910156,88.72174794,-11.27825206,-23.50413361,-57.59434152,0.028065615,1454000,-1,0.0
BSESN,5/11/2005,6445.129883,6454.410156,6380.759765999999,6420.25,10600,-9.580078,9.580078,0.0,62.741750399999994,6138.470215,6494.910156,86.03403624,-13.96596376,-14.29630854,-48.93473493,0.025608619,1443400,-1,0.0
BSESN,5/12/2005,6456.819824,6482.390136999999,6432.169922,6442.859863000001,10000,11.689941000000001,0.0,11.689941000000001,64.0392072,6138.470215,6494.910156,89.31367459,-10.68632541,-5.9867487729999995,-40.3451377,0.04913199,1453400,1,-0.34
BSESN,5/13/2005,6451.540039,6462.850098,6418.779785,6447.720215,29000,-5.2797849999999995,5.2797849999999995,0.0,62.89775577,6138.470215,6494.910156,87.83241943,-12.16758057,0.17063570100000003,-32.24198302,0.041385622999999996,1424400,-1,0.0
BSESN,5/16/2005,6528.029785,6532.149902,6456.970215,6456.970215,8400,76.489746,0.0,76.489746,71.41478046,6138.470215,6532.149902,98.95343419,-1.046565809,11.09459888,-23.57466664,0.050067763,1432800,1,-0.5423
BSESN,5/17/2005,6466.0,6568.609863000001,6450.859863000001,6545.220215,11800,-62.029785,62.029785,0.0,58.78731199,6138.470215,6568.609863000001,76.14498838,-23.85501162,14.57858036,-15.94401724,0.028054502999999998,1421000,-1,0.0
BSESN,5/18/2005,6447.0,6457.370117,6380.529785,6457.370117,14800,-19.0,19.0,0.0,55.32961398,6138.470215,6568.609863000001,71.72781826,-28.27218174,15.62638829,-9.629936132000001,0.013735048,1406200,-1,0.0
BSESN,5/19/2005,6478.939941,6537.740234000001,6460.240234000001,6461.069824,11400,31.939940999999997,0.0,31.939940999999997,59.90400105,6141.370117,6568.609863000001,79.01180243,-20.98819757,18.81715746,-3.940517415,0.014159857,1417600,1,-0.8658
BSESN,5/20/2005,6499.5,6512.959961,6438.600098,6462.160156,11400,20.560059,0.0,20.560059,62.73810816,6189.160156,6568.609863000001,81.78681872,-18.21318128,22.74272595,1.3961312590000001,0.002800327,1429000,1,0.1531
BSESN,5/23/2005,6539.830078,6549.569824,6499.209961,6504.490234000001,8200,40.330078,0.0,40.330078,67.87714744,6218.950195,6568.609863000001,91.76920084,-8.230799155,28.77635164,6.872175335,0.013187288,1437200,1,0.6369
BSESN,5/24/2005,6565.370117,6579.049805,6522.799805,6563.02002,10400,25.540039,0.0,25.540039,70.81799532,6322.02002,6579.049805,94.67778102,-5.322218979,35.21299765,12.5403398,0.018655983,1447600,1,0.0
BSESN,5/25/2005,6597.600098,6612.25,6537.609863000001,6566.839844,10800,32.229981,0.0,32.229981,74.25051757,6334.009765999999,6612.25,94.73480101,-5.265198993,42.42571882,18.517415600000003,0.021803346,1458400,1,0.0
BSESN,5/26/2005,6670.779785,6685.330078,6587.569824,6599.27002,13800,73.179687,0.0,73.179687,80.31626317,6380.529785,6685.330078,95.22628641,-4.773713587,53.43092305,25.50011709,0.033982543999999996,1472200,1,-0.3612
BSESN,5/27/2005,6707.720215,6772.740234000001,6689.140136999999,6689.560059,15400,36.94043,0.0,36.94043,82.69115139,6380.529785,6772.740234000001,83.42216043,-16.57783957,64.39114957,33.27832359,0.027525982,1487600,1,-0.7003
BSESN,5/30/2005,6663.549805,6724.990234000001,6642.609863000001,6697.149902,9600,-44.17041,44.17041,0.0,70.89061478,6380.529785,6772.740234000001,72.16024477,-27.83975523,68.72085388,40.36682965,0.030552088999999998,1478000,-1,0.0
BSESN,5/31/2005,6715.109863,6721.609863,6647.700195,6666.169922,8600,51.560058000000005,0.0,51.560058000000005,75.58364564,6380.529785,6772.740234000001,85.30626322,-14.69373678,75.44298179,47.38206008,0.041586763,1486600,1,0.0
BSESN,6/1/2005,6729.899901999999,6763.279785,6710.370117,6729.390137,9800,14.790039000000002,0.0,14.790039000000002,76.82052624,6380.529785,6772.740234000001,89.07720788,-10.92279212,81.02968931,54.11158592,0.038734726000000004,1496400,1,0.0
BSESN,6/2/2005,6655.560059,6756.620117,6647.359863000001,6733.459961,9400,-74.339843,74.339843,0.0,59.37603281,6380.529785,6772.740234000001,70.1231379,-29.876862100000004,78.55308021,58.99988478,0.024011087,1487000,-1,-0.128
BSESN,6/3/2005,6748.850098000001,6761.129883,6647.689941,6664.97998,12200,93.29003900000001,0.0,93.29003900000001,69.42826851,6380.529785,6772.740234000001,93.90884765,-6.091152355,83.15946559999999,63.83180094,0.031961078,1499200,1,-0.5994
BSESN,6/6/2005,6758.189941,6813.910156,6740.629883,6747.200195,9800,9.339843,0.0,9.339843,70.27786468,6380.529785,6813.910156,87.14288447,-12.85711553,86.56582948,68.37860665,0.029369224,1509000,1,0.0
BSESN,6/7/2005,6781.25,6795.029785,6737.089844,6756.600098000001,8400,23.060059,0.0,23.060059,72.45834089,6438.600098,6813.910156,91.29782021,-8.702179785,90.08767677,72.72042067,0.027835864,1517400,1,-0.2263
BSESN,6/8/2005,6858.240234000001,6862.830078,6768.200195,6768.200195,10000,76.990234,0.0,76.990234,78.52693963,6438.600098,6862.830078,98.91807646,-1.081923536,97.96198974,77.76873449,0.028101729,1527400,1,-0.6908
BSESN,6/9/2005,6832.529785,6862.790039,6813.200195,6858.700195,14600,-25.710449,25.710449,0.0,72.38156685,6499.209961,6862.830078,91.66704712,-8.332952877,100.9639713,82.40778185,0.018606854,1512800,-1,0.0
BSESN,6/10/2005,6781.990234000001,6883.669922,6774.140137,6833.580078,10200,-50.539551,50.539551,0.0,61.47052744,6522.799805,6883.669922,71.82374399999999,-28.176256,98.13371953,85.55296939,0.017774374,1502600,-1,0.0
BSESN,6/13/2005,6832.680176000001,6843.620117,6757.040039,6790.330078,8400,50.689941999999995,0.0,50.689941999999995,67.19366496,6537.609863000001,6883.669922,85.2656368,-14.734363199999999,98.8415949,88.21069449,0.017508323,1511000,1,0.0
BSESN,6/14/2005,6860.180176000001,6865.180176000001,6819.310059,6847.620117,9200,27.5,0.0,27.5,69.98456667,6587.569824,6883.669922,92.06695771,-7.9330422920000006,100.4635304,90.66126167,0.019358427,1520200,1,-0.8271
BSESN,6/15/2005,6906.97998,6916.330078,6858.080078,6876.790039,9800,46.799803999999995,0.0,46.799803999999995,74.28093282,6642.609863000001,6916.330078,96.58406742,-3.4159325789999997,104.32271170000001,93.39355167,0.037775922999999996,1530000,1,-0.34
BSESN,6/16/2005,6900.410156,6933.259765999999,6869.470215,6906.120117,12600,-6.5698240000000006,6.5698240000000006,0.0,72.59772672,6642.609863000001,6933.259765999999,88.69787684,-11.30212316,105.6333355,95.84150843,0.022457168,1517400,-1,0.0
BSESN,6/17/2005,6906.52002,6921.600098000001,6855.549805,6913.069823999999,11000,6.109864,0.0,6.109864,73.24821347,6647.359863000001,6933.259765999999,90.64716507,-9.352834932999999,105.9437753,97.8619618,0.021948196,1528400,1,-0.4767
BSESN,6/20/2005,6984.549805,7001.549805,6940.060059,6940.060059,24400,78.029785,0.0,78.029785,80.18103009,6647.359863000001,7001.549805,95.20031543,-4.799684572,111.2042592,100.5304213,0.029979695,1552800,1,-0.4588
BSESN,6/21/2005,7076.52002,7083.580078,6967.950195,6985.910156,19000,91.970215,0.0,91.970215,85.34582424,6647.359863000001,7083.580078,98.3815381,-1.618461905,121.3950912,104.7033553,0.031827375,1571800,1,0.0
BSESN,6/22/2005,7145.339844,7167.319823999999,7079.870117,7079.870117,37200,68.819824,0.0,68.819824,88.03742618,6647.689941,7167.319823999999,95.77007006,-4.22992994,133.485842,110.45985259999999,0.045782465,1609000,1,-0.6486
BSESN,6/23/2005,7119.759765999999,7156.549805,7090.47998,7142.910156,20800,-25.580078,25.580078,0.0,81.60873868,6737.089844,7167.319823999999,88.94543379,-11.05456621,139.3968702,116.2472561,0.049803895,1588200,-1,0.0
BSESN,6/24/2005,7148.620117,7178.040039,7058.009765999999,7104.430176000001,15400,28.860351,0.0,28.860351,83.205264,6737.089844,7178.040039,93.32806237,-6.671937632000001,144.7416996,121.94614479999998,0.046239533,1603600,1,0.0
BSESN,6/27/2005,7151.080078,7228.209961,7133.939941,7136.390137,18400,2.459961,0.0,2.459961,83.3474379,6757.040039,7228.209961,83.6301344,-16.369865599999997,147.4760021,127.0521163,0.04240412,1622000,1,0.0
BSESN,6/28/2005,7049.0,7175.149901999999,7036.060059,7158.660156,17400,-102.080078,102.080078,0.0,59.30814399999999,6757.040039,7228.209961,61.96489788,-38.03510212,139.79448359999998,129.6005897,0.020561811,1604600,-1,0.0
BSESN,6/29/2005,7119.879883,7125.209961,7034.47998,7059.370117,14200,70.87988299999999,0.0,70.87988299999999,66.94617022,6757.040039,7228.209961,77.00827813,-22.99172187,137.83733600000002,131.247939,0.031805316,1618800,1,-0.0772
BSESN,6/30/2005,7193.850098000001,7218.279785,7154.27002,7154.27002,28600,73.970215,0.0,73.970215,73.03982845,6757.040039,7228.209961,92.7075432,-7.292456797000001,140.63392030000003,133.12513529999998,0.041602729,1647400,1,0.0
BSESN,7/1/2005,7210.77002,7228.569823999999,7154.930176000001,7165.450195,12600,16.919922,0.0,16.919922,74.29076379,6819.310059,7228.569823999999,95.65073199999999,-4.349268001,142.572048,135.01451780000002,0.032388661,1660000,1,-0.29600000000000004
BSESN,7/4/2005,7277.310059,7284.410156,7186.740234000001,7186.740234000001,9600,66.54003900000001,0.0,66.54003900000001,78.76226209,6855.549805,7284.410156,98.34442681,-1.655573191,147.7738087,137.566376,0.028374122,1669600,1,0.0
BSESN,7/5/2005,7220.25,7308.720215,7209.859863,7275.0,12600,-57.060058999999995,57.060058999999995,0.0,67.19801388,6855.549805,7308.720215,80.47749521,-19.52250479,145.61343069999998,139.1757869,0.010483778000000001,1657000,-1,0.1027
BSESN,7/6/2005,7287.600098000001,7296.180176000001,7227.220215,7227.220215,13400,67.350098,0.0,67.350098,72.66420545,6855.549805,7308.720215,95.33947572,-4.660524283,147.6340719,140.8674439,0.023573876,1670400,1,0.5106
BSESN,7/7/2005,7145.129883,7306.540039,7123.109863,7281.069823999999,16800,-142.470215,142.470215,0.0,51.65427096,6940.060059,7308.720215,55.62570857,-44.37429143,136.1696105,139.92787719999998,-0.000488239,1653600,-1,-0.3818
BSESN,7/8/2005,7212.080078,7240.390137,7158.140137,7171.52002,14600,66.950195,0.0,66.950195,58.20649367,6967.950195,7308.720215,71.64065753,-28.35934247,130.9764484,138.1375915,0.00853018,1668200,1,0.0
BSESN,7/11/2005,7306.740234000001,7320.25,7227.509765999999,7227.509765999999,13400,94.660156,0.0,94.660156,65.77395957,7034.47998,7320.25,95.27250409,-4.727495907,132.9663601,137.10334519999998,0.036564085,1681600,1,0.0
BSESN,7/12/2005,7303.950195,7352.459961,7217.600098000001,7297.950195,17000,-2.790039,2.790039,0.0,65.37140897,7034.47998,7352.459961,84.74439622,-15.25560378,132.7875543,136.24018700000002,0.025853007999999997,1664600,-1,0.4215
BSESN,7/13/2005,7247.910156,7338.009765999999,7236.779785,7303.189941,11600,-56.040039,56.040039,0.0,57.25087352,7034.47998,7352.459961,67.12063298,-32.87936702,126.66378540000001,134.32490669999999,0.00751476,1653000,-1,-0.1779
BSESN,7/14/2005,7187.700195,7263.029785,7163.850098000001,7262.859863,13600,-60.209961,60.209961,0.0,49.61090157,7034.47998,7352.459961,48.18549096,-51.81450904,115.619425,130.5838104,-0.0031993570000000003,1639400,-1,-0.6808
BSESN,7/15/2005,7271.540039,7283.040039,7178.089844,7192.450195,10400,83.839844,0.0,83.839844,58.50725177,7034.47998,7352.459961,74.55188162,-25.44811838,112.3369145,126.93443119999999,-0.000792878,1649800,1,0.5994
BSESN,7/18/2005,7347.100098000001,7359.810059,7308.870117,7325.649901999999,17400,75.560059,0.0,75.560059,64.94350982,7034.47998,7359.810059,96.09321061,-3.906789387,114.51253740000001,124.4500524,0.017568656999999998,1667200,1,0.0
BSESN,7/19/2005,7346.629883,7385.689941,7317.850098000001,7348.600098000001,11000,-0.47021499999999994,0.47021499999999994,0.0,64.87125520000001,7123.109863,7385.689941,85.12451581,-14.87548419,114.87458899999999,122.5349597,0.008100031,1656200,-1,-0.29600000000000004
BSESN,7/20/2005,7342.890137,7392.669922,7334.47998,7373.939941,9800,-3.739746,3.739746,0.0,64.21561725,7123.109863,7392.669922,81.53295218,-18.46704782,113.55080819999999,120.7381294,0.027677629,1646400,-1,0.0
BSESN,7/21/2005,7304.319823999999,7380.689941,7275.589844,7345.97998,12600,-38.570313,38.570313,0.0,57.32136355,7123.109863,7392.669922,67.22433645,-32.77566355,108.14279760000001,118.2190631,0.012789618,1633800,-1,0.0
BSESN,7/22/2005,7423.25,7429.950195,7273.189941,7306.640137,12200,118.930176,0.0,118.930176,69.11761924,7123.109863,7429.950195,97.81639038,-2.183609618,112.1606632,117.0073831,0.015945519,1646000,1,0.0
BSESN,7/25/2005,7505.600098000001,7526.879883,7427.649901999999,7427.649901999999,17200,82.350098,0.0,82.350098,74.70373583,7123.109863,7526.879883,94.72972634,-5.270273657,120.59961799999999,117.7258301,0.027608335,1663200,1,-0.1531
BSESN,7/26/2005,7552.77002,7564.790039,7473.240234000001,7524.100098000001,20200,47.169922,0.0,47.169922,77.40496364,7123.109863,7564.790039,97.27856951,-2.721430495,129.5998229,120.10062859999998,0.042061760999999996,1683400,1,0.4215
BSESN,7/27/2005,7605.029785,7620.370117,7504.959961,7559.759765999999,13200,52.259765,0.0,52.259765,80.11887677,7158.140137,7620.370117,96.68123387,-3.3187661260000003,139.3432145,123.94914579999998,0.05806163,1696600,1,0.0
BSESN,7/29/2005,7635.419922,7708.589844,7545.790039,7556.169922,21800,30.390137,0.0,30.390137,81.60165047,7163.850098000001,7708.589844,86.56791201,-13.43208799,147.8132535,128.7219673,0.050041653,1718400,1,0.0
BSESN,8/1/2005,7669.450195,7681.109863,7596.740234000001,7632.009765999999,13800,34.030273,0.0,34.030273,83.21875746,7163.850098000001,7708.589844,92.81498196,-7.185018036000001,155.4795081,134.0734755,0.043874465999999994,1732200,1,-0.5994
BSESN,8/2/2005,7756.040039,7762.799805,7683.129883,7683.129883,19400,86.589844,0.0,86.589844,86.66094408,7163.850098000001,7762.799805,98.87139673,-1.128603274,166.6214386,140.5830681,0.055727614,1751600,1,0.0
BSESN,8/3/2005,7756.470215,7843.77002,7740.830078,7774.290039,28600,0.430176,0.0,0.430176,86.67660987,7163.850098000001,7843.77002,87.16028135,-12.83971865,173.4863675,147.163728,0.056323882,1780200,1,0.0
BSESN,8/4/2005,7797.080078,7826.359863,7756.970215,7810.049805,23400,40.609863,0.0,40.609863,88.18771366,7178.089844,7843.77002,92.98613002,-7.0138699760000005,180.1273537,153.7564531,0.067461484,1803600,1,0.0
BSESN,8/5/2005,7754.0,7817.609863,7738.640137,7806.109863,17400,-43.080078,43.080078,0.0,77.43735561,7273.189941,7843.77002,84.266885,-15.733115,179.84108480000003,158.9733795,0.044555955999999994,1786200,-1,-0.4404
BSESN,8/8/2005,7606.169922,7781.040039,7594.939941,7760.669922,16800,-147.83007800000001,147.83007800000001,0.0,52.22836298,7273.189941,7843.77002,58.35815046,-41.64184954,165.77461619999997,160.33362680000002,0.013399305,1769400,-1,0.0
BSESN,8/9/2005,7595.569823999999,7686.850098000001,7559.799805,7617.459961,23200,-10.600098,10.600098,0.0,50.85854185,7273.189941,7843.77002,56.50037477,-43.49962523,152.0191174,158.6707249,0.005666769,1746200,-1,0.4215
BSESN,8/10/2005,7729.819823999999,7741.350098000001,7615.899901999999,7615.899901999999,14000,134.25,0.0,134.25,64.47453991,7273.189941,7843.77002,80.02906162,-19.97093838,150.21900730000002,156.9803814,0.016408882,1760200,1,0.5719
BSESN,8/11/2005,7816.509765999999,7842.549805,7727.5,7749.009765999999,27000,86.689942,0.0,86.689942,70.55359464,7273.189941,7843.77002,95.22236142,-4.777638583,154.0122041,156.3867459,0.023717077000000003,1787200,1,-0.8979
BSESN,8/12/2005,7767.490234000001,7861.259765999999,7755.580078,7835.700195,16800,-49.019532,49.019532,0.0,63.46765939,7427.649901999999,7861.259765999999,78.37467738,-21.62532262,151.3185671,155.37311019999999,0.01278319,1770400,-1,0.0
BSESN,8/16/2005,7768.240234000001,7828.009765999999,7737.759765999999,7774.27002,11000,0.75,0.0,0.75,63.53231798,7473.240234000001,7861.259765999999,76.02710062,-23.97289938,147.54356869999998,153.8072019,0.001572993,1781400,1,-0.6597
BSESN,8/17/2005,7859.529785,7870.620117,7735.370117,7771.779785,11200,91.289551,0.0,91.289551,70.79254412,7504.959961,7870.620117,96.96703843,-3.032961568,150.18689799999999,153.08314109999998,0.013286916000000001,1792600,1,0.0
BSESN,8/18/2005,7811.330078,7921.390137,7791.910156,7902.839844,13200,-48.199707000000004,48.199707000000004,0.0,63.13509592,7545.790039,7921.390137,70.69754252,-29.30245748,146.70136000000002,151.80678490000003,0.0018276070000000002,1779400,-1,-0.5574
BSESN,8/19/2005,7780.759765999999,7867.890137,7760.689941,7817.740234000001,10600,-30.570312,30.570312,0.0,58.50398309,7559.799805,7921.390137,61.10781773,-38.89218227,139.86005759999998,149.4174394,0.0034510920000000002,1768800,-1,0.0
BSESN,8/22/2005,7750.600098000001,7845.959961,7711.180176000001,7814.930176000001,16000,-30.159668,30.159668,0.0,53.99534448,7559.799805,7921.390137,52.76697857,-47.23302143,130.5003167,145.6340149,0.018988555,1752800,-1,-0.128
BSESN,8/23/2005,7615.990234000001,7770.830078,7601.339844,7764.859863,11000,-134.609864,134.609864,0.0,38.65427193,7559.799805,7921.390137,15.53980403,-84.46019597,110.94189440000001,138.69559080000002,0.002688463,1741800,-1,0.0
BSESN,8/24/2005,7612.0,7639.680176000001,7537.5,7615.680176000001,15000,-3.9902339999999996,3.9902339999999996,0.0,38.28225194,7537.5,7921.390137,19.40659392,-80.59340608,94.03573983,129.7636206,-0.015242246999999999,1726800,-1,0.0
BSESN,8/25/2005,7660.419922,7672.180176000001,7595.839844,7651.109863,10600,48.419922,0.0,48.419922,45.611352200000006,7537.5,7921.390137,32.0195572,-67.98044279999999,83.58110264,120.52711699999999,-0.019969251,1737400,1,0.0
BSESN,8/26/2005,7680.220215,7732.310059,7644.410156,7701.069823999999,11800,19.800293,0.0,19.800293,48.49715876,7537.5,7921.390137,37.17735916,-62.82264084,76.01716693,111.625127,-0.011235292,1749200,1,0.0
BSESN,8/29/2005,7634.430176000001,7699.560059,7566.209961,7693.0,7600,-45.790039,45.790039,0.0,42.48243531,7537.5,7921.390137,25.24945724,-74.75054276,65.57194733,102.41449109999999,-0.017225273,1741600,-1,-0.7717
BSESN,8/30/2005,7745.0,7758.359863,7679.439941,7681.669922,9800,110.569824,0.0,110.569824,57.25354148,7537.5,7921.390137,54.05192267,-45.94807733,65.46149688,95.02389222,-0.014572091,1751400,1,0.0
BSESN,8/31/2005,7805.430176000001,7807.669922,7726.97998,7746.799805,9600,60.430176,0.0,60.430176,63.21140888,7537.5,7921.390137,69.79345135,-30.20654865,69.44960249,89.90903427,-0.0007553010000000001,1761000,1,0.0
BSESN,9/1/2005,7876.149901999999,7902.189941,7818.899901999999,7818.899901999999,11200,70.719726,0.0,70.719726,69.03844912,7537.5,7921.390137,88.21531719,-11.78468281,77.42419781,87.41206698,0.012259746,1772200,1,0.0
BSESN,9/2/2005,7899.77002,7928.069823999999,7836.339844,7888.109863,12600,23.620117999999998,0.0,23.620117999999998,70.81965718,7537.5,7928.069823999999,92.75422671,-7.245773294,84.67399903,86.86445339,0.019246242,1784800,1,0.0
BSESN,9/5/2005,7925.240234000001,7983.330078,7901.350098000001,7901.350098000001,10200,25.470214000000002,0.0,25.470214000000002,72.76885654,7537.5,7983.330078,86.97040714,-13.02959286,91.42090879999999,87.77574447,0.040605357,1795000,1,-0.2732
BSESN,9/6/2005,7946.779785,7976.399901999999,7914.410156,7931.419922,10000,21.539551,0.0,21.539551,74.43518454,7537.5,7983.330078,91.80174358,-8.198256422,97.38337029,89.69726964,0.043980529000000004,1805000,1,0.0
BSESN,9/8/2005,8052.560059,8060.259765999999,7957.350098000001,7957.350098000001,10400,105.780274,0.0,105.780274,81.01733433,7537.5,8060.259765999999,98.52710413,-1.472895869,109.3833449,93.63448469,0.051190423,1815400,1,-0.2263
BSESN,9/9/2005,8060.009765999999,8077.740234000001,8015.75,8060.890137,8800,7.449707000000001,0.0,7.449707000000001,81.40635444,7537.5,8077.740234000001,96.71804007,-3.2819599289999997,118.13277920000002,98.5341436,0.049450347,1824200,1,0.0
BSESN,9/12/2005,8138.419922,8142.810059,8072.990234000001,8072.990234000001,8200,78.410156,0.0,78.410156,85.11178394,7537.5,8142.810059,99.27472922,-0.7252707820000001,129.8964479,104.8066045,0.066015372,1832400,1,0.0
BSESN,9/13/2005,8193.959961,8202.040039,8121.080078,8137.390137,9400,55.540039,0.0,55.540039,87.19706796,7537.5,8202.040039,98.78410968,-1.215890319,142.0632404,112.25793159999999,0.057967715999999996,1841800,1,0.0
BSESN,9/14/2005,8189.47998,8260.009766,8144.319823999999,8207.530273,17400,-4.4799809999999995,4.4799809999999995,0.0,86.07500428,7566.209961,8260.009766,89.83427417,-10.16572583,149.619296,119.7302045,0.0492029,1824400,-1,0.0
BSESN,9/15/2005,8283.759766,8294.240234,8203.769531,8208.209961,11800,94.279786,0.0,94.279786,89.39022309,7566.209961,8294.240234,98.56043514,-1.4395648630000002,161.3551139,128.0551864,0.051752426,1836200,1,0.4019
BSESN,9/16/2005,8380.959961,8388.799805,8268.599609,8296.879883,12800,97.200195,0.0,97.200195,91.73186777,7566.209961,8388.799805,99.04693158,-0.9530684159999999,176.4649001,137.7371291,0.060911892,1849000,1,0.0
BSESN,9/19/2005,8444.839844,8461.099609,8382.959961,8399.509766,10600,63.87988299999999,0.0,63.87988299999999,92.91725731,7679.439941,8461.099609,97.91984086,-2.080159136,191.3878868,148.46728069999998,0.065562632,1859600,1,-0.5719
BSESN,9/20/2005,8500.280273,8515.5,8376.120117,8412.709961,15600,55.440429,0.0,55.440429,93.806464,7726.97998,8515.5,98.06983632,-1.930163675,205.3212252,159.8380696,0.069650916,1875200,1,-0.1027
BSESN,9/21/2005,8487.139648,8521.75,8261.580078,8499.330078,26800,-13.140625,13.140625,0.0,90.69252503,7818.899901999999,8521.75,95.07571357,-4.92428643,212.8495605,170.44036780000002,0.053967879,1848400,-1,0.3612
BSESN,9/22/2005,8221.639648,8519.599609,8186.129883,8480.620117,27200,-265.5,265.5,0.0,51.12663445,7836.339844,8521.75,56.21448714,-43.78551286,195.1427057,175.3808353,0.020053311,1821200,-1,0.0
BSESN,9/23/2005,8222.589844,8327.349609,8121.810059,8255.049805,20000,0.9501959999999999,0.0,0.9501959999999999,51.21452387,7901.350098000001,8521.75,51.77946434,-48.22053566,179.12176430000002,176.1290211,0.010342293,1841200,1,0.0
BSESN,9/26/2005,8478.910156,8487.360352,8280.05957,8280.05957,18600,256.320312,0.0,256.320312,68.7219353,7914.410156,8521.75,92.94631425,-7.053685745,184.9756755,177.898352,0.034775639,1859800,1,0.0
BSESN,9/27/2005,8525.519531,8585.759766,8444.980469,8497.25,20000,46.609375,0.0,46.609375,70.91212414,7957.350098000001,8585.759766,90.41385929,-9.586140708,191.1722149,180.55312460000002,0.041033076,1879800,1,-0.128
BSESN,9/28/2005,8606.030273,8613.830078,8475.679688,8535.80957,18000,80.51074200000001,0.0,80.51074200000001,74.47453356,8015.75,8613.830078,98.69585942,-1.30414058,200.27096219999999,184.4966921,0.038903892999999995,1897800,1,0.0
BSESN,9/29/2005,8650.169922,8722.169922,8588.469727,8588.469727,19800,44.139649,0.0,44.139649,76.30989563,8072.990234000001,8722.169922,88.90907998,-11.09092002,208.63843169999998,189.32504,0.032121614,1917600,1,-0.3612
BSESN,9/30/2005,8634.480469,8683.570313,8527.379883,8672.660156,23400,-15.689453,15.689453,0.0,74.12397886,8121.080078,8722.169922,85.41158965,-14.58841035,211.56491519999997,193.77301509999998,0.022456391000000003,1894200,-1,-0.4939
BSESN,10/3/2005,8697.650391,8725.75,8662.990234,8662.990234,16600,63.169922,0.0,63.169922,77.16305272,8121.810059,8725.75,95.34728421,-4.65271579,216.4859441,198.31560090000002,0.023219247999999998,1910800,1,0.0
BSESN,10/4/2005,8799.959961,8808.830078,8706.700195,8706.700195,27400,102.30957,0.0,102.30957,81.27322927,8121.810059,8808.830078,98.70889978,-1.291100223,226.0358219,203.8596451,0.036858156,1938200,1,-0.29600000000000004
BSESN,10/5/2005,8724.469727,8821.839844,8695.69043,8815.669922,23600,-75.490234,75.490234,0.0,70.47440952,8121.810059,8821.839844,86.09057513,-13.90942487,224.9200001,208.07171609999997,0.061159343,1914600,-1,-0.2732
BSESN,10/6/2005,8528.700195,8693.200195,8508.429688,8693.200195,29400,-195.769532,195.769532,0.0,50.42581474,8121.810059,8821.839844,58.12468908,-41.87531092,205.86564719999998,207.63050230000002,0.037227973,1885200,-1,0.128
BSESN,10/7/2005,8491.55957,8586.429688,8410.69043,8528.700195,25000,-37.140625,37.140625,0.0,47.4697019,8121.810059,8821.839844,52.81911126,-47.18088874,185.6281909,203.23004,0.001491868,1860200,-1,-0.4767
BSESN,10/10/2005,8483.860352,8564.849609,8465.900391,8516.44043,16200,-7.699217999999999,7.699217999999999,0.0,46.81328088,8121.810059,8821.839844,51.71926977,-48.28073023,167.0430304,195.9926381,-0.004886409,1844000,-1,0.2003
BSESN,10/11/2005,8540.55957,8563.849609,8381.959961,8547.950195,21200,56.699218,0.0,56.699218,52.405695,8121.810059,8821.839844,59.81881342,-40.18118658,155.10139750000002,187.81439,-0.0076075380000000005,1865200,1,0.0
BSESN,10/13/2005,8376.900391,8547.799805,8346.320313,8520.480469,24200,-163.659179,163.659179,0.0,38.81348751,8121.810059,8821.839844,36.43992548,-63.56007452,130.9224469,176.4360014,-0.031591232999999996,1841000,-1,0.3182
BSESN,10/14/2005,8201.730469,8396.419922,8180.100098000001,8389.450195,25200,-175.16992199999999,175.16992199999999,0.0,29.39712048,8180.100098000001,8821.839844,3.3705830339999996,-96.62941697,96.51316194,160.4514335,-0.050118823,1815800,-1,-0.4767
BSESN,10/17/2005,8202.620117,8254.799805,8131.77002,8230.469727,21800,0.889648,0.0,0.889648,29.49735393,8131.77002,8821.839844,10.26709103,-89.73290897,68.52542443,142.06623169999997,-0.056915402999999996,1837600,1,0.4215
BSESN,10/18/2005,8122.25,8317.379883,8067.910156,8232.259766,19200,-80.37011700000001,80.37011700000001,0.0,25.6949186,8067.910156,8821.839844,7.20754798,-92.79245202,39.40550196,121.5340857,-0.077012846,1818400,-1,-0.0772
BSESN,10/19/2005,7971.060059,8084.790039,7922.890137,8066.060059,26400,-151.189941,151.189941,0.0,20.07721873,7922.890137,8821.839844,5.358466845,-94.64153316,4.080946307,98.04345784,-0.086355927,1792000,-1,-0.29600000000000004
BSESN,10/20/2005,7935.120117,8134.830078,7838.02002,8075.819823999999,27200,-35.939941999999995,35.939941999999995,0.0,18.94135876,7838.02002,8821.839844,9.869703235,-90.13029676,-26.50849804,73.13306666,-0.069597953,1764800,-1,0.0772
BSESN,10/21/2005,8068.950195,8080.77002,7901.140137,7930.5,25600,133.83007800000001,0.0,133.83007800000001,34.79198697,7838.02002,8821.839844,23.47281172,-76.52718828,-39.49659212,50.60713491,-0.049768169,1790400,1,0.0
BSESN,10/24/2005,7920.799805,8126.27002,7898.410156,8096.490234000001,21400,-148.15039,148.15039,0.0,27.83866244,7838.02002,8821.839844,8.41412045,-91.58587955,-61.04061041,28.27758584,-0.066368436,1769000,-1,0.0
BSESN,10/25/2005,7991.740234000001,8074.080078,7921.439941,7974.169922,22200,70.94042900000001,0.0,70.94042900000001,35.01444125,7838.02002,8821.839844,15.62483396,-84.37516604,-71.56514197,8.30904028,-0.06426034900000001,1791200,1,0.0
BSESN,10/26/2005,7974.689941,8047.859863,7951.049805,7996.919922,15800,-17.050293,17.050293,0.0,34.07475441,7838.02002,8693.200195,15.981418300000001,-84.0185817,-80.35543774,-9.423855325,-0.048014232999999996,1775400,-1,0.0
BSESN,10/27/2005,7798.490234000001,7994.819823999999,7766.990234000001,7989.350098000001,26800,-176.19970700000002,176.19970700000002,0.0,25.814104,7766.990234000001,8586.429688,3.844091207,-96.15590879,-100.3825072,-27.6155857,-0.049165263,1748600,-1,0.0
BSESN,10/28/2005,7685.640137,7795.029785,7656.149901999999,7795.029785,21800,-112.85009699999999,112.85009699999999,0.0,21.89205741,7656.149901999999,8564.849609,3.245322385,-96.75467762,-123.93155790000002,-46.87878014,-0.06302619999999999,1726800,-1,0.0
BSESN,10/31/2005,7892.319823999999,7905.700195,7717.069823999999,7717.069823999999,15600,206.679687,0.0,206.679687,40.87523418,7656.149901999999,8563.849609,26.01850812,-73.98149188,-124.4820749,-62.39943909,-0.02830868,1742400,1,0.0
BSESN,11/2/2005,8072.75,8086.839844,7891.22998,7953.279785,16600,180.430176,0.0,180.430176,52.50306196,7656.149901999999,8547.799805,46.72238472,-53.27761528,-109.10150209999999,-71.73985169,0.012757392,1759000,1,-0.34
BSESN,11/7/2005,8206.830078,8216.419922,8049.649901999999,8083.589844,27200,134.08007800000001,0.0,134.08007800000001,59.35669925,7656.149901999999,8396.419922,74.38909602,-25.61090398,-85.11202715,-74.41428679,0.034241442999999996,1786200,1,0.0
BSESN,11/8/2005,8317.799805,8353.099609,8213.75,8218.820313,24000,110.969727,0.0,110.969727,64.2789914,7656.149901999999,8353.099609,94.93510025,-5.064899755,-56.49463092,-70.83035561,0.030840395,1810200,1,0.0
BSESN,11/9/2005,8308.780273,8405.459961,8269.089844,8332.009766,19400,-9.019532,9.019532,0.0,63.55710326,7656.149901999999,8405.459961,87.09750565,-12.90249435,-34.14928735,-63.49414196,0.048982486,1790800,-1,0.0
BSESN,11/10/2005,8308.929688,8342.530273,8190.990234000001,8314.389648,1200,0.14941500000000002,0.0,0.14941500000000002,63.56492455,7656.149901999999,8405.459961,87.117446,-12.882553999999999,-16.24116698,-54.04354696,0.03968966,1792000,1,0.3875
BSESN,11/11/2005,8471.040039,8483.679688,8332.94043,8332.94043,20200,162.110351,0.0,162.110351,71.28104253,7656.149901999999,8483.679688,98.47260495,-1.5273950509999998,10.90637604,-41.05356236,0.062240677,1812200,1,0.0
BSESN,11/14/2005,8494.290039,8569.910156,8416.889648,8503.700195,16200,23.25,0.0,23.25,72.25345002,7656.149901999999,8569.910156,91.72429347,-8.275706528999999,33.90623024,-26.06160384,0.08922237300000001,1828400,1,-0.5267
BSESN,11/16/2005,8595.919922,8606.950195,8503.0,8511.099609,15000,101.62988299999999,0.0,101.62988299999999,76.30071184,7656.149901999999,8606.950195,98.83989592,-1.1601040809999998,59.64689038,-8.919904998,0.11843903300000001,1843400,1,-0.5423
BSESN,11/17/2005,8649.519531,8662.570313,8547.339844,8611.790039,17000,53.599608999999994,0.0,53.599608999999994,78.23286555,7656.149901999999,8662.570313,98.70324748,-1.296752516,83.41008989,9.546093979,0.095941336,1860400,1,0.0
BSESN,11/18/2005,8686.650391,8739.570313,8661.599609,8669.839844,22400,37.13086,0.0,37.13086,79.56458034,7656.149901999999,8739.570313,95.11547674,-4.884523262,104.0394448,28.44476415,0.076046006,1882800,1,0.0
BSESN,11/21/2005,8610.740234,8713.099609,8586.919922,8699.269531,21400,-75.910157,75.910157,0.0,69.53008545,7656.149901999999,8739.570313,88.1089485,-11.8910515,112.96089909999999,45.34799113,0.049216342,1861400,-1,-0.8402
BSESN,11/22/2005,8534.969727,8664.459961,8518.179688,8602.820313,19600,-75.770507,75.770507,0.0,60.71157116,7656.149901999999,8739.570313,81.11531,-18.88469,112.61896780000001,58.80218646,0.026109059,1841800,-1,0.0
BSESN,11/23/2005,8638.339844,8649.679688,8537.480469,8542.610352,19600,103.37011700000001,0.0,103.37011700000001,67.25004121,7717.069823999999,8739.570313,90.09971437,-9.900285632000001,119.31371509999998,70.90449219,0.039664013,1861400,1,0.0
BSESN,11/24/2005,8744.040039,8765.709961,8655.139648,8655.139648,19800,105.700195,0.0,105.700195,72.62519815,7891.22998,8765.709961,97.52196477,-2.478035229,131.6311114,83.04981603,0.052366594,1881200,1,0.0
BSESN,11/25/2005,8853.209961,8863.929688,8760.700195,8760.700195,19000,109.169922,0.0,109.169922,77.103597,8049.649901999999,8863.929688,98.68353271,-1.316467286,148.4901352,96.13787987,0.045114876,1900200,1,0.29600000000000004
BSESN,11/28/2005,8994.94043,9005.629883,8905.679688,8905.679688,18800,141.730469,0.0,141.730469,81.61026352,8190.990234000001,9005.629883,98.6878305,-1.3121694990000001,171.3127111,111.17284609999999,0.058939639,1919000,1,-0.7624
BSESN,11/29/2005,8931.160156,9000.650391,8875.820313,9000.650391,19400,-63.780274,63.780274,0.0,74.04293085,8190.990234000001,9005.629883,90.85856831,-9.141431686,182.1534799,125.3689729,0.038999925,1899600,-1,-0.6908
BSESN,11/30/2005,8788.80957,9033.990234,8768.799805,8962.919922,18200,-142.35058600000002,142.35058600000002,0.0,59.7702938,8190.990234000001,9033.990234,70.91569822,-29.08430178,177.2155343,135.7382852,0.016103789,1881400,-1,-0.5719
BSESN,12/1/2005,8944.780273,8960.110352,8769.55957,8813.820313,18200,155.97070300000001,0.0,155.97070300000001,67.65316005,8332.94043,9033.990234,87.27480409,-12.72519591,183.76933069999998,145.3444943,0.029715698,1899600,1,0.0
BSESN,12/2/2005,8961.610352,9057.969727,8943.700195,9010.580078,18400,16.830079,0.0,16.830079,68.42351713,8416.889648,9057.969727,84.96921396,-15.03078604,188.1524044,153.9060763,0.040747962,1918000,1,0.0
BSESN,12/5/2005,8823.30957,9010.730469,8803.370117,8965.830078,14400,-138.300782,138.300782,0.0,55.81894199,8503.0,9057.969727,57.71658424,-42.28341576,178.4097085,158.80680269999996,0.033783347000000005,1903600,-1,0.0258
BSESN,12/6/2005,8815.530273,8915.120117,8783.929688,8827.0,14000,-7.779297,7.779297,0.0,55.15945473,8518.179688,9057.969727,55.08634164,-44.91365836,168.1228125,160.6700047,0.020512093000000002,1889600,-1,0.0
BSESN,12/7/2005,8895.80957,8915.879883,8825.929688,8825.929688,13600,80.279297,0.0,80.279297,60.689676399999996,8518.179688,9057.969727,69.95866072,-30.04133928,164.5513956,161.44628290000003,0.017356912,1903200,1,0.0
BSESN,12/8/2005,8906.30957,8931.580078,8826.389648,8918.629883,15400,10.5,0.0,10.5,61.407971499999995,8518.179688,9057.969727,71.90386149,-28.09613851,160.7156542,161.3001571,0.00599778,1918600,1,0.0
BSESN,12/9/2005,9067.280273,9080.759766,8907.719727,8907.719727,20200,160.97070300000001,0.0,160.97070300000001,70.83481785,8518.179688,9080.759766,97.60398679,-2.3960132130000003,168.71989399999998,162.78410449999998,0.008042281,1938800,1,0.4019
BSESN,12/12/2005,9133.669922,9175.599609,9092.650391,9092.650391,18600,66.389649,0.0,66.389649,73.87203501,8537.480469,9175.599609,93.42917578,-6.5708242189999995,178.3643286,165.9001493,0.02267452,1957400,1,0.0
BSESN,12/13/2005,9263.900391,9274.19043,9111.030273,9160.759766,25200,130.230469,0.0,130.230469,78.85584638,8655.139648,9274.19043,98.33777142,-1.662228576,194.276623,171.5754441,0.054056333,1982600,1,-0.25
BSESN,12/14/2005,9241.759766,9309.009766,9199.849609,9264.990234,24400,-22.140625,22.140625,0.0,76.01163883,8760.700195,9309.009766,87.73503079999999,-12.2649692,202.76333799999998,177.8130229,0.03320143,1958200,-1,-0.5719
BSESN,12/15/2005,9170.400391,9298.280273,9117.259766,9259.780273,18600,-71.359375,71.359375,0.0,67.02178835,8768.799805,9309.009766,74.34157365,-25.65842635,201.4092946,182.53227719999998,0.023298272000000002,1939600,-1,0.0
BSESN,12/16/2005,9284.459961,9290.30957,9137.160156,9191.629883,20000,114.05957,0.0,114.05957,72.92702106,8768.799805,9309.009766,95.45550679,-4.54449321,207.1519409,187.45621,0.052265013,1959600,1,0.0
BSESN,12/19/2005,9394.269531,9402.679688,9263.320313,9263.320313,101000,109.80957,0.0,109.80957,77.41875623,8768.799805,9402.679688,98.67322544,-1.326774555,218.0501972,193.5750074,0.065649965,2060600,1,0.0
BSESN,12/20/2005,9346.240234,9427.570313,9310.629883,9400.25,22000,-48.029297,48.029297,0.0,71.43717106,8769.55957,9427.570313,87.64000742,-12.35999258,220.2724175,198.9144894,0.050634027000000005,2038600,-1,0.0
BSESN,12/21/2005,9339.169922,9423.25,9272.759766,9349.240234,18800,-7.0703119999999995,7.0703119999999995,0.0,70.51180790000001,8783.929688,9427.570313,86.26556691,-13.73443309,218.93923289999998,202.9194381,0.048601539000000006,2019800,-1,-0.25
BSESN,12/22/2005,9372.299805,9413.700195,9328.759766,9398.620117,36200,33.129883,0.0,33.129883,72.44185194,8783.929688,9427.570313,91.41283103,-8.587168966,218.04252069999998,205.9440546,0.033639584,2056000,1,-0.5106
BSESN,12/23/2005,9256.910156,9442.980469,9237.94043,9417.290039,15800,-115.389649,115.389649,0.0,57.355368999999996,8783.929688,9442.980469,71.76692322,-28.23307678,205.6502811,205.8852999,0.013492958999999999,2040200,-1,0.0
BSESN,12/26/2005,9085.889648,9262.480469,9050.509766,9254.089844,15400,-171.020508,171.020508,0.0,42.29292538,8825.929688,9442.980469,42.12942727,-57.87057273,179.9550069,200.6992413,-0.019215529,2024800,-1,0.0
BSESN,12/27/2005,9283.160156,9297.070313,9020.799805,9071.25,14600,197.270508,0.0,197.270508,57.23910049,8826.389648,9442.980469,74.08000451,-25.91999549,173.50929119999998,195.2612513,0.004479709,2039400,1,-0.1027
BSESN,12/28/2005,9257.509766,9350.820313,9207.269531,9292.179688,19600,-25.650389999999998,25.650389999999998,0.0,55.09809725,8907.719727,9442.980469,65.34946645,-34.65053355,164.4357302,189.0961471,0.009498972,2019800,-1,0.4019
BSESN,12/29/2005,9323.25,9338.110352,9271.629883,9272.629883,14200,65.740234,0.0,65.740234,59.57019558,9020.799805,9442.980469,71.63999226,-28.36000774,160.69713869999998,183.4163454,0.004177953,2034000,1,-0.0572
BSESN,12/30/2005,9397.929688,9427.230469,9311.530273,9339.320313,15200,74.679688,0.0,74.679688,64.23871217,9020.799805,9442.980469,89.32902787,-10.67097213,161.89409030000002,179.1118944,0.00038961599999999996,2049200,1,0.0
BSESN,1/2/2006,9390.139648,9457.089844,9366.089844,9422.490234,14000,-7.790039999999999,7.790039999999999,0.0,63.35814034,9020.799805,9457.089844,84.65465859999999,-15.345341399999999,160.3654984,175.36261519999996,0.004697013,2035200,-1,-0.6705
BSESN,1/3/2006,9539.370117,9546.780273,9390.790039,9401.830078,13200,149.230469,0.0,149.230469,71.87871439,9020.799805,9546.780273,98.59117278,-1.408827219,169.2447814,174.1390484,0.021436616000000002,2048400,1,-0.5994
BSESN,1/4/2006,9648.080078,9664.94043,9523.290039,9523.290039,21400,108.709961,0.0,108.709961,76.4765382,9020.799805,9664.94043,97.38250448,-2.61749552,182.9447889,175.90019650000002,0.029425037,2069800,1,0.0
BSESN,1/5/2006,9617.740234,9679.719727,9571.30957,9638.269531,19200,-30.339844,30.339844,0.0,72.65135046,9020.799805,9679.719727,90.59377461,-9.40622539,189.1732996,178.55481719999997,0.038979538,2050600,-1,0.0
BSESN,1/6/2006,9640.290039,9680.919922,9535.660156,9635.089844,16000,22.549805,0.0,22.549805,73.77620764,9020.799805,9680.919922,93.84507729,-6.154922711,193.6962107,181.5830959,0.061017733,2066600,1,0.4939
BSESN,1/9/2006,9583.450195,9689.679688,9539.629883,9643.919922,15600,-56.83984399999999,56.83984399999999,0.0,65.89371641,9020.799805,9689.679688,84.11830051,-15.88169949,190.4982052,183.3661178,0.032347825,2051000,-1,0.0
BSESN,1/10/2006,9445.299805,9600.080078,9418.629883,9584.469727,24600,-138.15039,138.15039,0.0,50.70166194,9020.799805,9689.679688,63.46430963,-36.53569037,174.80118169999997,181.6531305,0.020285156999999998,2026400,-1,0.29600000000000004
BSESN,1/12/2006,9380.879883,9435.259766,9303.709961,9334.129883,25400,-64.419922,64.419922,0.0,45.10632852,9020.799805,9689.679688,53.83329461,-46.16670539,155.3719965,176.39690369999997,0.006181308000000001,2001000,-1,0.0
BSESN,1/13/2006,9374.19043,9471.889648,9362.25,9425.070313,15600,-6.689453,6.689453,0.0,44.51768192,9020.799805,9689.679688,52.83319681,-47.16680319,137.84544780000002,168.6866126,-0.002526009,1985400,-1,0.0
BSESN,1/16/2006,9311.19043,9397.620117,9287.089844,9382.860352,17200,-63.0,63.0,0.0,38.98860419,9020.799805,9689.679688,43.41446534,-56.58553466,117.517292,158.4527485,-0.008407672,1968200,-1,-0.5574
BSESN,1/17/2006,9314.129883,9421.519531,9289.230469,9317.990234,27200,2.939453,0.0,2.939453,39.39384277,9207.269531,9689.679688,22.15134786,-77.84865214,100.4859321,146.8593852,-0.023611646,1995400,1,-0.6486
BSESN,1/18/2006,9237.530273,9302.780273,9158.44043,9293.799805,45800,-76.59961,76.59961,0.0,32.83603763,9158.44043,9689.679688,14.88780089,-85.11219911,79.886625,133.4648331,-0.042552487,1949600,-1,0.0
BSESN,1/19/2006,9449.839844,9473.860352,9271.629883,9271.629883,19200,212.309571,0.0,212.309571,56.17014232,9158.44043,9689.679688,54.85276354,-45.14723646,79.77355389,122.7265773,-0.017457364,1968800,1,0.0
BSESN,1/20/2006,9520.959961,9556.19043,9466.099609,9493.389648,17800,71.12011700000001,0.0,71.12011700000001,61.35902346,9158.44043,9689.679688,68.24035038,-31.75964962,84.44926473,115.0711148,-0.012378266,1986600,1,0.2263
BSESN,1/23/2006,9464.900391,9503.400391,9432.929688,9467.55957,16200,-56.059569999999994,56.059569999999994,0.0,55.39450292,9158.44043,9689.679688,57.68774735,-42.31225265,82.67819767,108.5925314,-0.012370263000000001,1970400,-1,0.0
BSESN,1/24/2006,9549.919922,9574.139648,9503.419922,9503.419922,16800,85.019531,0.0,85.019531,61.87902468,9158.44043,9689.679688,73.69174738,-26.30825262,87.13059265,104.3001436,0.011076421000000001,1987200,1,0.2023
BSESN,1/25/2006,9685.740234,9714.480469,9580.299805,9580.299805,21600,135.820312,0.0,135.820312,69.93538879,9158.44043,9714.480469,94.8312652,-5.1687348,100.46066379999999,103.53224770000001,0.032498055,2008800,1,0.0
BSESN,1/27/2006,9870.790039,9883.950195,9764.259766,9764.259766,18200,185.049805,0.0,185.049805,77.43297162,9158.44043,9883.950195,98.18608148,-1.813918521,124.52140870000001,107.7300799,0.05297519999999999,2027000,1,0.0
BSESN,1/30/2006,9849.030273,9945.19043,9803.679688,9896.459961,29400,-21.759766,21.759766,0.0,74.89869833,9158.44043,9945.19043,87.77754598,-12.22245402,140.2175505,114.227574,0.057762737,1997600,-1,0.0516
BSESN,1/31/2006,9919.889648,9939.549805,9873.370117,9892.230469,18400,70.859375,0.0,70.859375,77.64750688,9158.44043,9945.19043,96.78413956,-3.2158604389999996,156.5697764,122.6960145,0.06503664599999999,2016000,1,0.0258
BSESN,2/1/2006,9859.259766,9993.919922,9819.320313,9959.240234,19000,-60.629881999999995,60.629881999999995,0.0,70.07171069,9158.44043,9993.919922,83.88229067,-16.11770933,162.76050659999999,130.7089129,0.06730473099999999,1997000,-1,0.0
BSESN,2/2/2006,9843.870117,9956.099609,9816.009766,9890.900391,19400,-15.389648999999999,15.389648999999999,0.0,68.12501845,9158.44043,9993.919922,82.04027669999999,-17.9597233,164.528309,137.4727921,0.041697032,1977600,-1,0.0
BSESN,2/3/2006,9742.580078,9837.740234,9713.509766,9834.969727,16000,-101.29003900000001,101.29003900000001,0.0,56.25612294,9158.44043,9993.919922,69.91669497,-30.08330503,155.95825569999997,141.16988480000003,0.023277077,1961600,-1,0.0
BSESN,2/6/2006,9980.419922,10002.83008,9739.709961,9746.089844,21400,237.839844,0.0,237.839844,70.28329461,9158.44043,10002.83008,97.34599352,-2.6540064830000003,166.4395035,146.22380859999998,0.054466451,1983000,1,-0.1027
BSESN,2/7/2006,10082.280270000001,10099.58008,9972.429688,9993.389648,19000,101.860351,0.0,101.860351,74.34810875,9158.44043,10099.58008,98.16182380000001,-1.8381761980000002,180.8801729,153.1550814,0.055745007,2002000,1,0.0
BSESN,2/8/2006,10044.82031,10083.530270000001,9958.549805,10083.530270000001,17600,-37.459959999999995,37.459959999999995,0.0,70.26945652,9271.629883,10099.58008,93.38610398,-6.613896021,187.14451619999997,159.9529684,0.037073065,1984400,-1,0.5106
BSESN,2/10/2006,10110.969729999999,10122.25,10057.07031,10066.36035,18600,66.14941400000001,0.0,66.14941400000001,73.2585426,9432.929688,10122.25,98.36356585,-1.6364341519999999,195.1966528,167.0017053,0.024332367,2003000,1,0.0
BSESN,2/13/2006,10173.25,10182.76953,10096.280270000001,10132.66992,15400,62.280273,0.0,62.280273,75.89168773,9432.929688,10182.76953,98.73045809999999,-1.269541901,204.24907050000002,174.4511783,0.032918948999999996,2018400,1,0.0
BSESN,2/14/2006,10086.62988,10185.05957,10064.45996,10180.50977,21400,-86.62011700000001,86.62011700000001,0.0,65.53585847,9503.419922,10185.05957,85.55986476,-14.44013524,202.1039288,179.9817284,0.016808678,1997000,-1,0.0
BSESN,2/15/2006,10113.17969,10191.969729999999,10036.00977,10144.90039,24000,26.549805,0.0,26.549805,67.12250389,9580.299805,10191.969729999999,87.11886327,-12.88113673,200.2380168,184.03298610000002,0.025754461,2021000,1,0.0
BSESN,2/16/2006,10124.299809999999,10195.41992,10110.45996,10133.41992,15600,11.120117,0.0,11.120117,67.8380711,9713.509766,10195.41992,85.24203814,-14.75796186,197.3812801,186.7026449,0.028487747999999997,2036600,1,0.0
BSESN,2/17/2006,9981.110352,10184.04004,9970.0,10168.549809999999,18800,-143.18945300000001,143.18945300000001,0.0,51.26156097,9713.509766,10195.41992,55.52914432,-44.47085568,181.4712162,185.6563592,0.024483276,2017800,-1,0.0
BSESN,2/20/2006,10079.299809999999,10092.84961,9896.639648,10002.36035,14800,98.189453,0.0,98.189453,59.15795497,9713.509766,10195.41992,75.904198,-24.095802,174.77079530000003,183.47924640000002,0.009907387,2032600,1,0.0
BSESN,2/21/2006,10168.11035,10195.50977,10108.16016,10108.16016,15000,88.810547,0.0,88.810547,65.06494498,9713.509766,10195.50977,94.31547427,-5.684525726,174.6140899,181.70621509999998,0.008512963,2047600,1,0.0
BSESN,2/22/2006,10224.32031,10237.61035,10157.25977,10179.25977,16000,56.209961,0.0,56.209961,68.40235885,9713.509766,10237.61035,97.46421978,-2.535780221,176.98539630000002,180.7620513,0.017869907,2063600,1,0.5994
BSESN,2/23/2006,10244.049809999999,10304.87988,10228.219729999999,10268.50977,18800,19.729492,0.0,19.729492,69.57933552,9713.509766,10304.87988,89.71370445,-10.28629555,178.4001925,180.2896796,0.01316195,2082400,1,-0.3818
BSESN,2/24/2006,10200.75977,10271.66992,10177.12012,10256.74023,12800,-43.290039,43.290039,0.0,63.58314808,9739.709961,10304.87988,81.57720131,-18.42279869,174.02226389999998,179.03619640000002,0.002704128,2069600,-1,0.0
BSESN,2/27/2006,10282.08984,10296.219729999999,10109.33984,10214.58008,13000,81.330078,0.0,81.330078,69.31541379,9896.639648,10304.87988,94.41749317,-5.58250683,175.0969727,178.2483517,0.019378124,2082600,1,0.0
BSESN,2/28/2006,10370.24023,10422.65039,10206.05957,10308.70996,31800,88.15039,0.0,88.15039,74.36230405,9896.639648,10422.65039,90.03629532,-9.963704677,180.97551380000002,178.7937841,0.02541837,2114400,1,0.0
BSESN,3/1/2006,10565.469729999999,10573.29004,10344.25977,10368.75,27600,195.229493,0.0,195.229493,81.94926165,9896.639648,10573.29004,98.84426107,-1.155738932,199.0926721,182.85356169999997,0.043575351,2142000,1,0.0
BSESN,3/2/2006,10626.780270000001,10706.219729999999,10593.799809999999,10597.19043,26800,61.310545999999995,0.0,61.310545999999995,83.69742690000001,9896.639648,10706.219729999999,90.18757303,-9.812426967999999,215.90903430000003,189.46465619999998,0.064689188,2168800,1,0.0
BSESN,3/3/2006,10595.42969,10690.0,10556.030270000001,10649.280270000001,17800,-31.350585,31.350585,0.0,79.17339998,9896.639648,10706.219729999999,86.31512288,-13.68487712,224.1228437,196.3962937,0.051206918,2151000,-1,0.0
BSESN,3/6/2006,10735.36035,10741.58984,10616.99023,10616.99023,21600,139.93066399999998,0.0,139.93066399999998,83.70851985,9896.639648,10741.58984,99.26273856,-0.737261442,239.1666181,204.9503586,0.05578716,2172600,1,-0.128
BSESN,3/7/2006,10725.66992,10753.12988,10661.62012,10747.87012,24400,-9.690430000000001,9.690430000000001,0.0,82.27690433,9896.639648,10753.12988,96.79389678,-3.20610322,247.45447969999998,213.45118280000003,0.049035006,2148200,-1,-0.5719
BSESN,3/8/2006,10508.84961,10740.59961,10493.91016,10728.38965,27200,-216.820313,216.820313,0.0,57.07604172,9896.639648,10753.12988,71.47891896,-28.52108104,233.83161719999998,217.52726969999998,0.025849133,2121000,-1,0.0
BSESN,3/9/2006,10573.54004,10593.08008,10376.54004,10533.88965,24800,64.69043,0.0,64.69043,61.17042145,9896.639648,10753.12988,79.03188657,-20.96811343,225.6541767,219.15265109999999,0.036544363999999996,2145800,1,0.3556
BSESN,3/10/2006,10765.16016,10782.33984,10581.63965,10581.63965,18400,191.620117,0.0,191.620117,70.71708522,10108.16016,10782.33984,97.45176422,-2.548235775,231.9617278,221.7144664,0.046981724,2164200,1,0.0
BSESN,3/13/2006,10803.70996,10884.48047,10782.530270000001,10818.94043,15800,38.549805,0.0,38.549805,72.29807097,10109.33984,10884.48047,89.57988971,-10.42011029,237.33530090000002,224.8386333,0.041799391,2180000,1,0.0
BSESN,3/14/2006,10801.719729999999,10896.38965,10761.219729999999,10796.82031,22600,-1.990234,1.990234,0.0,72.06629112,10109.33984,10896.38965,87.97154633,-12.02845367,238.6819245,227.60729159999997,0.022360577000000003,2157400,-1,0.0
BSESN,3/16/2006,10878.74023,10889.25,10830.19043,10859.38965,18400,77.020507,0.0,77.020507,75.56432107,10109.33984,10896.38965,97.75752259999999,-2.242477402,243.1610355,230.71804029999998,0.023709906,2175800,1,0.0
BSESN,3/17/2006,10860.04004,10951.37988,10844.030270000001,10902.25977,26400,-18.700195,18.700195,0.0,73.00323203,10109.33984,10951.37988,89.15255335,-10.84744665,242.4074912,233.05593050000002,0.024974008,2149400,-1,0.128
BSESN,3/20/2006,10941.11035,10946.94043,10889.41016,10903.25,14000,81.070313,0.0,81.070313,76.91675876,10206.05957,10951.37988,98.62213188,-1.377868122,245.52177630000003,235.5490997,0.019165635,2163400,1,0.0
BSESN,3/21/2006,10905.2002,11017.25,10863.61035,10945.62012,16200,-35.910157,35.910157,0.0,71.61108951,10344.25977,11017.25,83.35045602,-16.64954398,242.29914649999998,236.89910899999998,0.016738374,2147200,-1,0.0
BSESN,3/22/2006,10841.34961,10935.08984,10784.41992,10900.01953,19000,-63.850586,63.850586,0.0,62.73315713,10376.54004,11017.25,72.54601899,-27.45398101,231.9195562,235.90319849999997,0.031639999999999995,2128200,-1,-0.4215
BSESN,3/23/2006,10840.58984,10924.29004,10792.98047,10861.9502,14400,-0.7597649999999999,0.7597649999999999,0.0,62.62655831,10376.54004,11017.25,72.42743726,-27.57256274,221.0838326,232.9393253,0.025256422999999997,2113800,-1,0.1531
BSESN,3/24/2006,10950.299809999999,10966.05957,10851.799809999999,10851.799809999999,21800,109.709961,0.0,109.709961,70.87298672,10376.54004,11017.25,89.55062367,-10.44937633,218.82662340000002,230.1167849,0.017198039,2135600,1,-0.3182
BSESN,3/27/2006,11079.01953,11101.41992,10996.36035,10996.36035,22400,128.719726,0.0,128.719726,77.57234992,10376.54004,11101.41992,96.90977891,-3.0902210869999998,224.8326443,229.0599568,0.025482873,2158000,1,0.128
BSESN,3/28/2006,11086.030270000001,11146.84961,11051.12988,11114.42969,19000,7.010742,0.0,7.010742,77.89191222,10376.54004,11146.84961,92.10455921,-7.89544079,227.53528230000003,228.7550219,0.026320859,2177000,1,-0.4019
BSESN,3/29/2006,11183.48047,11197.63965,11103.87012,11103.87012,17800,97.45019599999999,0.0,97.45019599999999,82.00440087,10376.54004,11197.63965,98.27558327,-1.724416727,234.8335438,229.97072630000002,0.028012456,2194800,1,-0.3818
BSESN,3/30/2006,11307.04004,11338.66016,11227.82031,11241.780270000001,23400,123.55957,0.0,123.55957,85.85409237,10581.63965,11338.66016,95.82308317,-4.176916829,247.7319932,233.52297969999998,0.041160069,2218200,1,-0.7783
BSESN,3/31/2006,11279.95996,11356.9502,11231.16016,11325.95996,17200,-27.080078000000004,27.080078000000004,0.0,81.44792421,10761.219729999999,11356.9502,87.07633097,-12.92366903,252.8542251,237.3892287,0.030970313,2201000,-1,0.0
BSESN,4/3/2006,11564.36035,11579.09961,11342.95996,11342.95996,16600,284.400391,0.0,284.400391,88.56159458,10761.219729999999,11579.09961,98.19787021,-1.80212979,276.6730508,245.24599320000002,0.060444572,2217600,1,0.0
BSESN,4/4/2006,11638.00977,11710.69043,11570.11035,11599.799809999999,18000,73.64941400000001,0.0,73.64941400000001,89.73742474,10784.41992,11710.69043,92.15340839,-7.846591613999999,298.0567216,255.8081389,0.073483486,2235600,1,0.3182
BSESN,4/5/2006,11746.90039,11755.2002,11653.38965,11671.13965,16200,108.890625,0.0,108.890625,91.26862157,10784.41992,11755.2002,99.14503784,-0.8549621609999999,320.10008369999997,268.6665278,0.083603435,2251800,1,0.0
BSESN,4/7/2006,11589.44043,11930.66016,11564.87012,11845.12988,30400,-157.45996100000002,157.45996100000002,0.0,73.07661361,10784.41992,11930.66016,70.23139514,-29.76860486,321.16175130000005,279.1655725,0.058367409,2221400,-1,0.0
BSESN,4/10/2006,11662.549809999999,11691.91992,11535.280270000001,11620.37988,22000,73.109375,0.0,73.109375,75.67423846,10784.41992,11930.66016,76.60958471,-23.39041529,324.1656661,288.1655912,0.052669848,2243400,1,0.0
BSESN,4/12/2006,11355.73047,11702.76953,11302.780270000001,11693.15039,27000,-306.81933599999996,306.81933599999996,0.0,51.57726059,10784.41992,11930.66016,49.84212995,-50.15787005,298.3493484,290.2023427,0.024327932000000003,2216400,-1,0.6124
BSESN,4/13/2006,11237.23047,11380.83008,11008.42969,11366.91016,32800,-118.5,118.5,0.0,45.16772883,10792.98047,11930.66016,39.04877665,-60.95122335,265.2699047,285.21585510000006,0.0048061959999999996,2183600,-1,0.0
BSESN,4/17/2006,11539.67969,11560.90039,11323.74023,11323.74023,22800,302.44921899999997,0.0,302.44921899999997,59.8584767,10851.799809999999,11930.66016,63.75986312,-36.24013688,260.45694590000005,280.2640732,0.020574761,2206400,1,0.0
BSESN,4/18/2006,11821.57031,11834.76953,11624.969729999999,11624.969729999999,24200,281.890625,0.0,281.890625,68.83729031,10996.36035,11930.66016,88.32389319,-11.67610681,276.20494039999994,279.4522467,0.048015273,2230600,1,-0.4939
BSESN,4/19/2006,11895.98047,11986.08984,11799.62012,11880.049809999999,26200,74.410156,0.0,74.410156,70.82492504,11008.42969,11986.08984,90.78315973,-9.216840273999999,291.331331,281.8280635,0.028676045,2256800,1,-0.2382
BSESN,4/20/2006,12039.549809999999,12053.74023,11866.20996,11941.49023,26400,143.56933600000002,0.0,143.56933600000002,74.4525787,11008.42969,12053.74023,98.64246763,-1.357532367,311.315301,287.725511,0.034502466,2283200,1,-0.4588
BSESN,4/21/2006,12030.299809999999,12102.0,11860.34961,12053.90039,32800,-9.25,9.25,0.0,73.77067112,11008.42969,12102.0,93.44347645,-6.556523546,322.68661319999995,294.7177315,0.024125463,2250400,-1,-0.743
BSESN,4/24/2006,11915.24023,12071.07031,11882.48047,12063.73047,16600,-115.05957099999999,115.05957099999999,0.0,65.19986982,11008.42969,12102.0,82.92201572,-17.07798428,318.73987919999996,299.522161,0.02811178,2233800,-1,0.2023
BSESN,4/25/2006,11646.780270000001,11953.0,11621.61035,11943.08008,18800,-268.45996099999996,268.45996099999996,0.0,49.66540345,11008.42969,12102.0,58.37307195,-41.62692805,290.59973610000003,297.73767599999996,-0.001352151,2215000,-1,0.0
BSESN,4/26/2006,11938.530270000001,11965.08984,11635.40039,11677.049809999999,18600,291.75,0.0,291.75,61.24424398,11008.42969,12102.0,85.0517406,-14.948259400000001,288.51444169999996,295.8930292,0.051322087999999995,2233600,1,0.0
BSESN,4/27/2006,11835.01953,12086.91016,11803.49023,11968.799809999999,31200,-103.51074200000001,103.51074200000001,0.0,55.97315074,11008.42969,12102.0,75.58634629,-24.41365371,275.33548310000003,291.78152,0.053197188,2202400,-1,0.0
BSESN,4/28/2006,11851.92969,11877.32031,11344.61035,11698.67969,22800,16.910157,0.0,16.910157,56.67601895,11008.42969,12102.0,77.13267183,-22.86732817,263.2213202,286.06948,0.02705881,2225200,1,0.0
BSESN,5/2/2006,12218.780270000001,12288.50977,12103.780270000001,12103.780270000001,19800,366.850585,0.0,366.850585,69.04586818,11008.42969,12288.50977,94.55272415,-5.447275854,279.99492789999994,284.85456960000005,0.03360044,2245000,1,-0.6705
BSESN,5/3/2006,12310.719729999999,12337.00977,12134.19043,12231.12012,19200,91.939454,0.0,91.939454,71.40667937,11008.42969,12337.00977,98.02119274,-1.978807257,297.2800195,287.33965960000006,0.034863815,2264200,1,0.4404
BSESN,5/4/2006,12347.62988,12482.91016,12264.13965,12358.30957,20200,36.910156,0.0,36.910156,72.38238903,11008.42969,12482.91016,90.82522448,-9.174775517999999,310.3790635,291.9475404,0.025589003,2284400,1,0.0
BSESN,5/5/2006,12359.7002,12443.54004,12304.58984,12373.469729999999,20000,12.070312,0.0,12.070312,72.73346929,11323.74023,12482.91016,89.37084558,-10.62915442,318.06763789999997,297.1715599,0.027380896000000002,2304400,1,-0.7003
BSESN,5/8/2006,12462.469729999999,12511.07031,12393.219729999999,12393.219729999999,17600,102.769532,0.0,102.769532,75.76062966,11344.61035,12511.07031,95.83349728,-4.16650272,328.6648865,303.47022519999996,0.045926854,2322000,1,0.1496
BSESN,5/9/2006,12513.86035,12546.469729999999,12356.04004,12488.37988,22400,51.390625,0.0,51.390625,77.21987740000002,11344.61035,12546.469729999999,97.2867562,-2.713243802,337.3216425,310.24050869999996,0.07444805,2344400,1,0.5267
BSESN,5/10/2006,12612.37988,12624.37012,12530.98047,12546.92969,19000,98.519531,0.0,98.519531,79.89692738,11344.61035,12624.37012,99.06308713,-0.936912874,348.1189878,317.81620449999997,0.056443263,2363400,1,-0.7351
BSESN,5/11/2006,12435.41016,12671.11035,12397.01953,12631.54004,19000,-176.969727,176.969727,0.0,64.24799963,11344.61035,12671.11035,82.23142133,-17.76857867,338.4940352,321.95177060000003,0.050730007,2344400,-1,-0.2732
BSESN,5/12/2006,12285.11035,12421.75977,12224.44043,12400.70996,21000,-150.299804,150.299804,0.0,53.90211454,11344.61035,12671.11035,70.90086694,-29.09913306,315.1059081,320.58259810000004,0.036549378,2323400,-1,0.0
BSESN,5/15/2006,11822.2002,12272.63965,11770.75977,12272.63965,30200,-462.910157,462.910157,0.0,34.28318221,11344.61035,12671.11035,36.00375748,-63.99624252,256.2636204,307.7188026,-0.032456601,2293200,-1,-0.5423
BSESN,5/16/2006,11873.73047,11954.50977,11378.95996,11861.17969,38200,51.530274,0.0,51.530274,37.21824029,11344.61035,12671.11035,39.88843701,-60.11156299,211.3524069,288.44552339999996,-0.035496646,2331400,1,0.0
BSESN,5/17/2006,12217.80957,12238.80957,11962.87012,11962.87012,18800,344.079101,0.0,344.079101,53.29083594,11344.61035,12671.11035,65.82730629,-34.17269371,201.20488980000002,270.99739669999997,-0.010513783999999998,2350200,1,0.2263
BSESN,5/18/2006,11391.42969,12163.98047,11330.4502,12163.98047,30600,-826.3798820000001,826.3798820000001,0.0,31.17425569,11330.4502,12671.11035,4.54846761,-95.45153239,125.0395808,241.8058335,-0.078340938,2319600,-1,0.4939
BSESN,5/19/2006,10938.61035,11697.11035,10799.00977,11549.66992,35000,-452.819336,452.819336,0.0,24.69449784,10799.00977,12671.11035,7.456895587999999,-92.54310441,27.81861296,199.0083894,-0.122275874,2284600,-1,0.5994
BSESN,5/22/2006,10481.76953,11142.90039,9826.910156,11071.62988,31400,-456.840821,456.840821,0.0,19.88342685,9826.910156,12671.11035,23.02437697,-76.97562303,-85.11182462,142.1843466,-0.162387206,2253200,-1,0.4939
BSESN,5/23/2006,10822.780270000001,10859.2002,10185.48047,10590.66992,30400,341.010742,0.0,341.010742,31.39531143,9826.910156,12671.11035,35.01406541,-64.98593459,-145.41701619999998,84.66407403,-0.141892302,2283600,1,0.0
BSESN,5/24/2006,10573.15039,11000.95996,10504.58984,10830.98047,25600,-249.62988199999998,249.62988199999998,0.0,27.99735724,9826.910156,12671.11035,26.23726122,-73.76273878,-210.9209944,25.54706034,-0.149754591,2258000,-1,0.0
BSESN,5/25/2006,10666.32031,10720.66992,10274.92969,10520.90039,21200,93.169922,0.0,93.169922,31.20394638,9826.910156,12671.11035,29.51304758,-70.48695242,-252.4057585,-30.04350342,-0.131768457,2279200,1,0.34
BSESN,5/26/2006,10809.34961,11050.76953,10735.13965,10735.13965,24800,143.029296,0.0,143.029296,36.234092499999996,9826.910156,12671.11035,34.54185308,-65.45814692,-270.62190319999996,-78.15918338,-0.085673611,2304000,1,-0.4939
BSESN,5/29/2006,10853.13965,10992.37988,10781.61035,10855.030270000001,15400,43.790039,0.0,43.790039,37.83966045,9826.910156,12671.11035,36.08147884,-63.91852116,-278.3165787,-118.19066240000001,-0.085953679,2319400,1,0.0
BSESN,5/30/2006,10786.62988,10988.23047,10722.91992,10886.61035,16200,-66.509765,66.509765,0.0,36.24049903,9826.910156,12671.11035,33.74304412,-66.25695588,-286.479094,-151.84834880000002,-0.117138811,2303200,-1,0.3818
BSESN,5/31/2006,10398.61035,10679.49023,10111.95996,10679.49023,35800,-388.01953100000003,388.01953100000003,0.0,28.21400494,9826.910156,12421.75977,22.03211291,-77.96788709,-320.562633,-185.5912056,-0.08715493699999999,2267400,-1,0.0
BSESN,6/1/2006,10071.41992,10597.23047,10017.82031,10472.45996,24200,-327.19043,327.19043,0.0,23.21204663,9826.910156,12272.63965,9.997416591,-90.00258341,-369.7137861,-222.41572169999998,-0.07927793400000001,2243200,-1,0.4404
BSESN,6/2/2006,10451.33008,10477.34961,10011.4502,10104.57031,28400,379.91015600000003,0.0,379.91015600000003,37.95022364,9826.910156,12238.80957,25.8891361,-74.11086390000001,-373.7030385,-252.67318509999998,-0.002904038,2271600,1,-0.7003
BSESN,6/5/2006,10213.48047,10552.37988,10186.33008,10537.08008,19200,-237.849609,237.849609,0.0,33.32913627,9826.910156,12238.80957,16.02762996,-83.97237004,-391.54355510000005,-280.4472591,-0.056297900000000005,2252400,-1,-0.4939
BSESN,6/6/2006,9957.320313,10192.73047,9884.889648,10087.95996,26200,-256.16015600000003,256.16015600000003,0.0,28.94871241,9826.910156,12163.98047,5.5800698970000004,-94.4199301,-421.4935613,-308.6565195,-0.05824471,2226200,-1,-0.34
BSESN,6/7/2006,9756.759766,10051.80957,9609.209961,9919.280273,27000,-200.56054699999999,200.56054699999999,0.0,25.87632164,9609.209961,11697.11035,7.066898672000001,-92.93310133,-456.15445250000005,-338.15610610000004,-0.08527407,2199200,-1,0.0
BSESN,6/8/2006,9295.80957,9664.900391,9200.799805,9664.900391,36800,-460.950196,460.950196,0.0,20.19297738,9200.799805,11142.90039,4.892113503,-95.10788649999999,-514.8830358,-373.501492,-0.140021379,2162400,-1,-0.5574
BSESN,6/9/2006,9810.459961,9849.200195,9262.200195,9270.780273,29400,514.650391,0.0,514.650391,37.79406342,9200.799805,11050.76953,32.95514232,-67.04485768,-513.9731136,-401.5958163,-0.09607171,2191800,1,-0.5267
BSESN,6/12/2006,9476.150391,9859.379883,9428.030273,9858.469727,20400,-334.30957,334.30957,0.0,32.43279933,9200.799805,11050.76953,14.88405903,-85.11594097,-534.0715379,-428.0909606000001,-0.12149109599999999,2171400,-1,-0.5574
BSESN,6/13/2006,9062.650391,9360.05957,8993.580078,9360.05957,28000,-413.5,413.5,0.0,26.97225976,8993.580078,11050.76953,3.35750861,-96.64249139,-576.7176362,-457.81629580000003,-0.128474855,2143400,-1,-0.5267
BSESN,6/14/2006,8929.44043,9387.05957,8799.009766,9156.969727,27400,-133.20996100000002,133.20996100000002,0.0,25.38366011,8799.009766,11050.76953,5.79238807,-94.20761193,-614.1839764,-489.08983190000004,-0.11338813199999999,2116000,-1,0.0
BSESN,6/15/2006,9545.05957,9582.969727,9092.160156,9133.360352,26200,615.61914,0.0,615.61914,43.21719044,8799.009766,10992.37988,34.01385832,-65.98614168,-587.4294798999999,-508.7577615,-0.086713414,2142200,1,-0.1027
BSESN,6/16/2006,9884.509766,10118.280270000001,9703.05957,9703.05957,33400,339.450196,0.0,339.450196,50.71193758,8799.009766,10988.23047,49.58385413,-50.41614587,-532.6949786,-513.5452048999999,-0.032209461,2175600,1,-0.5994
BSESN,6/19/2006,9997.839844,10049.94043,9755.209961,9903.110352,20800,113.330078,0.0,113.330078,53.09678057,8799.009766,10679.49023,63.75126455,-36.24873545,-474.7006483,-505.7762936000001,0.004069321,2196400,1,0.0
BSESN,6/20/2006,9822.519531,9958.330078,9745.169922,9958.330078,22400,-175.320313,175.320313,0.0,48.87550002,8799.009766,10597.23047,56.91791688,-43.08208312,-437.8394669,-492.18892819999996,0.006739918,2174000,-1,0.3058
BSESN,6/21/2006,10040.13965,10054.049809999999,9757.540039,9797.870117,24800,217.620117,0.0,217.620117,54.10171418,8799.009766,10552.37988,70.78539037,-29.21460963,-386.60999100000004,-471.0731408,0.080071571,2198800,1,0.4019
BSESN,6/22/2006,10275.87988,10362.74023,10093.37988,10093.37988,22400,235.740235,0.0,235.740235,59.30185732,8799.009766,10552.37988,84.23036886,-15.76963114,-323.26163660000003,-441.5108399,0.047441193,2221200,1,0.0
BSESN,6/23/2006,10401.299809999999,10453.61035,10025.19043,10201.30957,22600,125.419922,0.0,125.419922,61.94836338,8799.009766,10453.61035,96.83847888,-3.1615211210000003,-259.9408336,-405.1968387,0.097629246,2243800,1,0.0
BSESN,6/26/2006,10042.05957,10451.469729999999,9991.120117,10427.84961,21800,-359.240235,359.240235,0.0,50.98991754,8799.009766,10453.61035,75.12688044,-24.87311956,-236.0255699,-371.3625849,0.108070944,2222000,-1,0.4019
BSESN,6/27/2006,10151.00977,10224.25977,9902.330078,10058.29004,31400,108.95019599999999,0.0,108.95019599999999,53.84692095,8799.009766,10453.61035,81.71156299,-18.28843701,-205.9076061,-338.2715892,0.136802451,2253400,1,-0.5423
BSESN,6/28/2006,10129.7002,10204.66016,9909.759766,10067.549809999999,26000,-21.309571,21.309571,0.0,53.14771595,8799.009766,10453.61035,80.4236648,-19.5763352,-181.66429419999997,-306.9501302,0.061250599999999995,2227400,-1,0.0
BSESN,6/29/2006,10162.16016,10326.049809999999,10109.55957,10193.94043,20200,32.459961,0.0,32.459961,54.19314678,8799.009766,10453.61035,82.3854652,-17.6145348,-158.0105995,-277.16222400000004,0.028089445,2247600,1,0.3182
BSESN,6/30/2006,10609.25,10626.83984,10316.12012,10316.12012,30600,447.089844,0.0,447.089844,66.18464010000001,8799.009766,10626.83984,99.03766525,-0.962334749,-102.01252509999999,-242.13228430000004,0.061154226,2278200,1,-0.5423
BSESN,7/3/2006,10695.25977,10729.91992,10589.45996,10646.55957,22600,86.009766,0.0,86.009766,68.04170581,8799.009766,10729.91992,98.20498349,-1.795016505,-50.11567618,-203.7289626,0.08885095400000001,2300800,1,-0.5904
BSESN,7/4/2006,10662.219729999999,10800.11035,10644.719729999999,10755.4502,17400,-33.040039,33.040039,0.0,66.42480188,9092.160156,10800.11035,91.92654298,-8.07345702,-11.52030559,-165.28723119999998,0.061959305,2283400,-1,-0.6908
BSESN,7/5/2006,10919.63965,10940.4502,10611.34961,10641.33008,25600,257.419921,0.0,257.419921,72.33485609,9703.05957,10940.4502,98.31819099,-1.681809008,39.38444063,-124.3528969,0.062647654,2309000,1,0.2235
BSESN,7/6/2006,10767.969729999999,10839.530270000001,10703.0,10836.49023,22000,-151.669921,151.669921,0.0,64.60384237,9745.169922,10940.4502,85.56987245,-14.43012755,66.71922599,-86.13847229,0.035252317000000005,2287000,-1,-0.6908
BSESN,7/7/2006,10509.530270000001,10887.66992,10440.01953,10813.75,28000,-258.439454,258.439454,0.0,53.38569834,9745.169922,10940.4502,63.948211,-36.051789,66.75878256,-55.55902132,0.046551278,2259000,-1,0.0
BSESN,7/10/2006,10684.299809999999,10704.780270000001,10461.73047,10484.25,16600,174.769532,0.0,174.769532,58.9479691,9757.540039,10940.4502,78.34574429,-21.65425571,79.97071938,-28.45307318,0.052535664,2275600,1,0.0
BSESN,7/11/2006,10614.34961,10699.62012,10566.70996,10699.62012,18400,-69.95019599999999,69.95019599999999,0.0,55.86920406,9902.330078,10940.4502,68.58739363,-31.41260637,83.83053209,-5.9963521239999995,0.047844399,2257200,-1,0.0
BSESN,7/12/2006,10930.08984,10939.67969,10549.84961,10604.63965,25600,315.740235,0.0,315.740235,65.30645112,9902.330078,10940.4502,99.00200845,-0.997991546,111.08652340000002,17.42022298,0.075567564,2282800,1,0.4939
BSESN,7/13/2006,10858.5,10922.61035,10797.49023,10922.61035,22200,-71.589844,71.589844,0.0,61.84636327,9902.330078,10940.4502,92.10590435,-7.89409565,125.46411850000001,39.02900208,0.023493649,2260600,-1,-0.4019
BSESN,7/14/2006,10678.219729999999,10782.98047,10563.75977,10782.98047,20800,-180.280273,180.280273,0.0,53.595423,9902.330078,10940.4502,74.73987223,-25.26012777,120.91749320000001,55.40670031,-0.0015932329999999999,2239800,-1,0.0
BSESN,7/17/2006,10293.219729999999,10647.25977,10262.57031,10647.25977,17800,-385.0,385.0,0.0,40.33558851,9909.759766,10940.4502,37.20418374,-62.79581626,85.26509461,61.37837917,-0.034608177999999996,2222000,-1,-0.5267
BSESN,7/18/2006,10226.780270000001,10406.42969,10149.84961,10336.62012,20200,-66.439454,66.439454,0.0,38.44181717,10109.55957,10940.4502,14.10783796,-85.89216204,51.06060825,59.31482499,-0.063450755,2201800,-1,0.4404
BSESN,7/19/2006,10007.33984,10406.20996,9972.730469,10320.58984,24400,-219.440429,219.440429,0.0,32.607441800000004,9972.730469,10940.4502,3.5763841610000005,-96.42361584,6.175114814,48.68688295,-0.070638189,2177400,-1,-0.4927
BSESN,7/20/2006,10352.94043,10409.58008,10225.17969,10247.87012,23600,345.60058599999996,0.0,345.60058599999996,47.17628666,9972.730469,10940.4502,39.28926432,-60.71073568,-1.492676481,38.65097106,-0.014899795,2201000,1,-0.6597
BSESN,7/21/2006,10085.91016,10336.37988,10035.24023,10336.37988,23000,-267.030274,267.030274,0.0,39.55323116,9972.730469,10940.4502,11.69550273,-88.30449727,-28.78475504,25.16382584,-0.056006445,2178000,-1,0.0
BSESN,7/24/2006,10215.37012,10252.75,9875.349609,9881.030273,20600,129.45996100000002,0.0,129.45996100000002,44.56416638,9875.349609,10940.4502,31.92379316,-68.07620684,-39.51211593,12.22863749,-0.03758869,2198600,1,0.4215
BSESN,7/25/2006,10415.61035,10443.049809999999,10323.76953,10351.75,18400,200.240235,0.0,200.240235,51.70876435,9875.349609,10939.67969,50.76063842,-49.23936158,-31.49288289,3.484333414,-0.047070015,2217000,1,0.0
BSESN,7/26/2006,10617.26953,10648.76953,10362.61035,10465.33984,19600,201.659179,0.0,201.659179,57.99893051,9875.349609,10939.67969,69.70769094,-30.29230906,-8.764342632,1.034598205,-0.022215818999999998,2236600,1,-0.5994
BSESN,7/27/2006,10741.58984,10762.66992,10589.67969,10671.76953,20800,124.32031299999998,0.0,124.32031299999998,61.56051587,9875.349609,10939.67969,81.38830726,-18.61169274,19.06008673,4.639695908999999,0.005934521,2257400,1,0.4404
BSESN,7/28/2006,10680.23047,10787.65039,10603.83008,10787.65039,21000,-61.359375,61.359375,0.0,58.72462198,9875.349609,10939.67969,75.62323718,-24.37676282,35.7478794,10.86133261,0.037598609,2236400,-1,0.0
BSESN,7/31/2006,10743.87988,10853.91016,10710.29004,10759.19043,17800,63.649414,0.0,63.649414,60.88152694,9875.349609,10939.67969,81.60346974,-18.39653026,53.49242372,19.38755083,0.050563285,2254200,1,-0.5719
BSESN,8/1/2006,10751.66016,10777.469729999999,10646.65039,10737.5,15800,7.780272999999999,0.0,7.780272999999999,61.16773445,9875.349609,10922.61035,83.67644379,-16.32355621,67.40589278,28.99121922,0.074377439,2270000,1,0.0
BSESN,8/2/2006,10876.19043,10891.37988,10730.12988,10747.12988,18600,124.530274,0.0,124.530274,65.79023736,9875.349609,10891.37988,98.50501964,-1.494980355,87.47263948,40.68750327,0.050541197,2288600,1,0.5106
BSESN,8/3/2006,10923.16016,11081.90039,10875.87012,10955.26953,20600,46.969726,0.0,46.969726,67.47519931,9875.349609,11081.90039,86.84346839,-13.15653161,105.9444831,53.73889924,0.083011844,2309200,1,0.0
BSESN,8/4/2006,10866.50977,11039.33984,10810.04004,10951.80957,18800,-56.65039,56.65039,0.0,63.14682938,9875.349609,11081.90039,82.14823377,-17.85176623,114.69026129999999,65.92917165,0.063741171,2290400,-1,0.0
BSESN,8/7/2006,10812.63965,10869.66016,10780.00977,10863.280270000001,13600,-53.870118000000005,53.870118000000005,0.0,58.99456384,9875.349609,11081.90039,77.68343057,-22.31656943,115.9380238,75.93094209,0.038118677999999996,2276800,-1,0.0
BSESN,8/8/2006,11014.969729999999,11028.01953,10839.530270000001,10839.530270000001,15200,202.330079,0.0,202.330079,68.08832594,9875.349609,11081.90039,94.45272715,-5.547272854,131.7346757,87.09168881,0.03745786,2292000,1,0.0
BSESN,8/9/2006,11145.17969,11187.65039,10943.83008,10990.73047,18400,130.20996100000002,0.0,130.20996100000002,72.60041624,9875.349609,11187.65039,96.76364568,-3.2363543160000003,152.9968395,100.2727189,0.037572636,2310400,1,-0.4019
BSESN,8/10/2006,11149.16992,11213.030270000001,11051.75,11175.0,16600,3.9902339999999996,0.0,3.9902339999999996,72.73672016,9875.349609,11213.030270000001,95.22603916,-4.773960835,168.2299854,113.86417220000001,0.043907241,2327000,1,0.5423
BSESN,8/11/2006,11192.45996,11241.11035,11069.25,11181.33984,18600,43.290039,0.0,43.290039,74.33496661,10323.76953,11241.11035,94.69658497,-5.303415032,181.700972,127.43153219999999,0.041752149,2345600,1,-0.3818
BSESN,8/14/2006,11312.99023,11330.299809999999,11221.86035,11221.86035,13200,120.530273,0.0,120.530273,78.40245327,10362.61035,11330.299809999999,98.21124732,-1.788752677,199.79944799999998,141.9051153,0.052208689,2358800,1,-0.5267
BSESN,8/16/2006,11448.30957,11507.91992,11384.049809999999,11384.049809999999,15200,135.31933600000002,0.0,135.31933600000002,82.08123486,10589.67969,11507.91992,93.50819646,-6.491803537999999,222.4969537,158.023483,0.052602897999999995,2374000,1,-0.5994
BSESN,8/17/2006,11477.48047,11551.58984,11379.44043,11498.469729999999,19800,29.170899,0.0,29.170899,82.80955862,10603.83008,11551.58984,92.18057385,-7.819426152,240.0713452,174.4330554,0.050747247999999995,2393800,1,-0.8074
BSESN,8/18/2006,11465.719729999999,11508.16992,11409.11035,11507.13965,14600,-11.760742,11.760742,0.0,81.27283897,10646.65039,11551.58984,90.51095444,-9.489045562000001,250.1664207,189.5797285,0.055142817000000004,2379200,-1,0.4404
BSESN,8/21/2006,11511.67969,11531.59961,11375.90039,11488.030270000001,11000,45.959961,0.0,45.959961,82.71887471,10646.65039,11551.58984,95.58974295,-4.410257047,258.8910903,203.4420009,0.064650267,2390200,1,0.4588
BSESN,8/22/2006,11502.62012,11619.86035,11460.92969,11547.41992,12200,-9.059571,9.059571,0.0,81.29120893,10730.12988,11619.86035,86.8229493,-13.177050699999999,262.0536309,215.1643269,0.044271605,2378000,-1,-0.4404
BSESN,8/23/2006,11406.65039,11579.91992,11374.86035,11579.91992,13200,-95.969726,95.969726,0.0,67.12965586,10780.00977,11619.86035,74.61334616,-25.38665384,253.8893341,222.90932830000003,0.02346043,2364800,-1,0.0
BSESN,8/24/2006,11531.9502,11566.88965,11297.23047,11367.74023,15600,125.29980400000001,0.0,125.29980400000001,73.96286284,10780.00977,11619.86035,89.53264325,-10.46735675,254.5949055,229.2464437,0.034332625,2380400,1,0.0
BSESN,8/25/2006,11572.2002,11635.25,11542.09961,11589.34961,17000,40.25,0.0,40.25,75.82555162,10780.00977,11635.25,92.6278252,-7.372174799,255.4571634,234.48858769999998,0.033928219,2397400,1,0.0
BSESN,8/28/2006,11619.51953,11633.34961,11552.44043,11583.73047,9200,47.319336,0.0,47.319336,77.96400774,10839.530270000001,11635.25,98.02311436,-1.9768856380000002,256.9962906,238.99012830000004,0.027095337999999997,2406600,1,-0.2263
BSESN,8/29/2006,11706.84961,11739.76953,11651.95996,11651.95996,16000,87.330078,0.0,87.330078,81.45699497,10943.83008,11739.76953,95.86401681,-4.135983193,262.23992880000003,243.6400884,0.02258325,2422600,1,-0.6908
BSESN,8/30/2006,11723.91992,11756.08008,11643.37988,11735.049809999999,12800,17.070313,0.0,17.070313,82.09704604,11051.75,11756.08008,95.43393687,-4.566063129,264.7214376,247.8563582,0.021471564,2435400,1,0.0
BSESN,8/31/2006,11699.049809999999,11794.42969,11675.08008,11754.07031,16600,-24.870117,24.870117,0.0,77.59458293,11069.25,11794.42969,86.84741388,-13.15258612,261.6649301,250.61807259999998,0.020350234,2418800,-1,0.0
BSESN,9/1/2006,11778.01953,11795.01953,11666.00977,11699.57031,11600,78.969726,0.0,78.969726,81.34333957,11221.86035,11795.01953,97.03398277,-2.9660172289999998,262.5878732,253.0120327,0.023136487999999997,2430400,1,-0.8481
BSESN,9/4/2006,11914.20996,11939.95996,11824.49023,11824.49023,10000,136.19043,0.0,136.19043,86.00339264,11297.23047,11939.95996,95.99364891,-4.006351089,271.18271630000004,256.6461694,0.035782269,2440400,1,-0.29600000000000004
BSESN,9/5/2006,11904.59961,11945.530270000001,11847.92969,11927.41992,12000,-9.610352,9.610352,0.0,84.28916181,11297.23047,11945.530270000001,93.68646053,-6.313539469,274.0595286,260.12884130000003,0.043654289000000006,2428400,-1,0.0
BSESN,9/6/2006,11933.20996,11983.48047,11904.91992,11908.530270000001,12400,28.610352000000002,0.0,28.610352000000002,85.29591613,11297.23047,11983.48047,92.67460721,-7.325392787,275.47256319999997,263.1975856,0.034795482,2440800,1,-0.3182
BSESN,9/7/2006,11853.84961,11921.299809999999,11815.42969,11893.33008,11800,-79.360352,79.360352,0.0,70.77948563,11297.23047,11983.48047,81.11025719,-18.88974281,267.1096127,263.9799911,0.02433845,2429000,-1,-0.4215
BSESN,9/8/2006,11918.65039,11940.58008,11825.219729999999,11859.44043,16400,64.800782,0.0,64.800782,74.81739705,11297.23047,11983.48047,90.55299409999999,-9.447005902,262.6827525,263.72054330000003,0.025743824,2445400,1,-0.4019
BSESN,9/11/2006,11550.69043,11971.59961,11505.59961,11959.55957,18600,-367.95996099999996,367.95996099999996,0.0,39.26612264,11297.23047,11983.48047,36.93405625,-63.06594375,226.86794780000002,256.3500242,-0.013339129,2426800,-1,0.29600000000000004
BSESN,9/12/2006,11660.79004,11671.63965,11445.19043,11564.9502,19400,110.09960900000002,0.0,110.09960900000002,47.82553082,11297.23047,11983.48047,52.97771512,-47.02228488,205.0054006,246.08109950000002,-0.005384708,2446200,1,0.0
BSESN,9/13/2006,11893.79004,11938.41016,11723.780270000001,11723.780270000001,15400,233.0,0.0,233.0,61.1836537,11445.19043,11983.48047,83.33789899,-16.66210101,204.1272751,237.6903346,0.016645816,2461600,1,0.0
BSESN,9/14/2006,11973.01953,12002.94043,11892.24023,11936.799809999999,14400,79.22949200000001,0.0,79.22949200000001,64.72696331,11445.19043,12002.94043,94.63542824,-5.364571762,207.4333496,231.63893760000002,0.016556263999999998,2476000,1,-0.3818
BSESN,9/15/2006,12009.58984,12041.7002,11847.61035,11977.69043,12800,36.570313,0.0,36.570313,66.36231175,11445.19043,12041.7002,94.61696138,-5.383038616,210.576956,227.42654130000003,0.008005557,2488800,1,0.0
BSESN,9/18/2006,12071.299809999999,12114.9502,12006.19043,12006.19043,12400,61.709961,0.0,61.709961,69.14736919,11445.19043,12114.9502,93.48267957,-6.517320431,215.56288999999998,225.053811,0.014003007,2501200,1,0.0
BSESN,9/19/2006,11970.469729999999,12152.59961,11915.20996,12103.44043,17200,-100.830078,100.830078,0.0,59.81111529999999,11445.19043,12152.59961,74.2539555,-25.7460445,208.9692664,221.83690209999997,0.0031223590000000003,2484000,-1,0.0
BSESN,9/20/2006,12109.13965,12128.99023,11833.61035,11946.32031,13800,138.669921,0.0,138.669921,66.90251625,11445.19043,12152.59961,93.85646069,-6.1435393110000005,212.48389390000003,219.9663005,0.021536467000000004,2497800,1,0.0
BSESN,9/21/2006,12274.26953,12285.90039,12167.91016,12167.91016,15000,165.129883,0.0,165.129883,73.3610568,11445.19043,12285.90039,98.6165431,-1.383456904,225.98880469999997,221.17080130000002,0.029837199,2512800,1,0.4767
BSESN,9/22/2006,12236.780270000001,12303.41992,12170.2002,12244.41016,13400,-37.489258,37.489258,0.0,69.79340174,11445.19043,12303.41992,92.23521801,-7.764781987,231.0036082,223.13736269999998,0.059398167,2499400,-1,0.3182
BSESN,9/25/2006,12173.91016,12273.4502,12145.08984,12257.26953,15200,-62.87011700000001,62.87011700000001,0.0,63.79053308,11445.19043,12303.41992,84.90965794,-15.09034206,227.28478560000002,223.9668473,0.04400389,2484200,-1,-0.6597
BSESN,9/26/2006,12321.19043,12331.4502,12160.58008,12206.79004,14200,147.280274,0.0,147.280274,70.62073602,11445.19043,12331.4502,98.84235239,-1.157647611,233.52989190000002,225.8794562,0.035934752,2498400,1,0.0
BSESN,9/27/2006,12366.91016,12442.82031,12339.98047,12359.00977,12600,45.719726,0.0,45.719726,72.48010344,11445.19043,12442.82031,92.39094996,-7.6090500389999995,239.40862969999998,228.5852909,0.032898186,2511000,1,0.0
BSESN,9/28/2006,12380.74023,12431.79004,12340.16992,12388.66016,13400,13.830078,0.0,13.830078,73.07487601,11445.19043,12442.82031,93.77724344,-6.222756561000001,242.38942909999997,231.34611850000002,0.030904502,2524400,1,0.0
BSESN,9/29/2006,12454.41992,12485.16992,12381.29004,12414.66016,12600,73.679688,0.0,73.679688,76.23248897,11445.19043,12485.16992,97.04321093,-2.956789075,247.84012239999998,234.6449193,0.0317381,2537000,1,0.0
BSESN,10/3/2006,12366.38965,12489.280270000001,12343.799809999999,12473.79004,11600,-88.030274,88.030274,0.0,65.62310554,11723.780270000001,12489.280270000001,83.94635859,-16.05364141,242.26386180000003,236.16870780000002,0.033074719,2525400,-1,-0.5574
BSESN,10/4/2006,12204.00977,12419.65039,12178.83008,12401.08984,14400,-162.379882,162.379882,0.0,50.62695138,11833.61035,12489.280270000001,56.49175021,-43.50824979,222.180774,233.371121,0.007834588,2511000,-1,0.0
BSESN,10/5/2006,12389.41016,12415.969729999999,12299.20996,12299.20996,12200,185.40039,0.0,185.40039,62.05160129,11833.61035,12489.280270000001,84.76823264,-15.23176736,218.70396110000001,230.43768909999997,0.00938065,2523200,1,0.0
BSESN,10/6/2006,12372.80957,12434.219729999999,12357.95996,12391.25977,12000,-16.600586,16.600586,0.0,60.60280813,11833.61035,12489.280270000001,82.23638156,-17.76361844,212.1633463,226.7828205,0.011116428999999999,2511200,-1,0.0
BSESN,10/9/2006,12365.83008,12429.74023,12261.49023,12335.82031,10600,-6.979492,6.979492,0.0,59.92406884,11833.61035,12489.280270000001,81.17189899,-18.82810101,204.06434850000002,222.2391261,0.015764854,2500600,-1,-0.6249
BSESN,10/10/2006,12363.76953,12481.92969,12341.33984,12416.42969,11400,-2.060547,2.060547,0.0,59.69631569,11833.61035,12489.280270000001,80.85763309,-19.14236691,195.2290861,216.8371181,0.0034557620000000002,2489200,-1,0.2023
BSESN,10/11/2006,12353.49023,12514.17969,12301.50977,12446.719729999999,13800,-10.279297,10.279297,0.0,58.41828670000001,12145.08984,12514.17969,56.46332279,-43.53667721,185.2620381,210.52210209999998,-0.001085148,2475400,-1,0.0
BSESN,10/12/2006,12537.98047,12558.70996,12315.01953,12387.88965,13600,184.490235,0.0,184.490235,71.19091999,12145.08984,12558.70996,94.98827761,-5.011722387,190.0590189,206.4294855,0.01270039,2489000,1,-0.3818
BSESN,10/13/2006,12736.41992,12756.23047,12632.62012,12632.62012,16600,198.43945300000001,0.0,198.43945300000001,79.14235984,12145.08984,12756.23047,96.75843068,-3.24156932,207.4813503,206.6398584,0.022642564,2505600,1,0.0
BSESN,10/16/2006,12928.17969,12953.75977,12785.030270000001,12785.030270000001,18800,191.75976599999998,0.0,191.75976599999998,84.05070639,12160.58008,12953.75977,96.77499583,-3.2250041680000003,234.06394049999997,212.12467489999997,0.04542878400000001,2524400,1,0.0
BSESN,10/17/2006,12883.83008,12994.4502,12819.34961,12981.530270000001,16000,-44.34961,44.34961,0.0,79.08431841,12178.83008,12994.4502,86.43729909,-13.56270091,248.6855003,219.43683990000002,0.055704668,2508400,-1,-0.29600000000000004
BSESN,10/18/2006,12858.48047,12920.58984,12830.83984,12886.33008,16400,-25.349609,25.349609,0.0,76.11801154,12178.83008,12994.4502,83.32928245,-16.67071755,255.28492450000002,226.6064569,0.037860585,2492000,-1,-0.6597
BSESN,10/19/2006,12723.58984,12925.59961,12654.98047,12881.799809999999,15400,-134.890625,134.890625,0.0,61.86973418,12178.83008,12994.4502,66.79086926,-33.20913074,246.7856779,230.6423011,0.028350899,2476600,-1,0.4019
BSESN,10/20/2006,12709.40039,12849.01953,12679.84961,12756.41016,15800,-14.189453,14.189453,0.0,60.49528637,12178.83008,12994.4502,65.05115579,-34.94884421,236.18242940000002,231.7503267,0.027783846,2460800,-1,-0.4404
BSESN,10/23/2006,12623.280270000001,12766.299809999999,12612.36035,12757.30957,7800,-86.120118,86.120118,0.0,52.35085684,12178.83008,12994.4502,54.49230417,-45.50769583,218.3135225,229.0629659,0.020989612999999997,2453000,-1,0.7269
BSESN,10/26/2006,12698.41016,12718.30957,12636.16016,12636.16016,13200,75.12988299999999,0.0,75.12988299999999,58.03750592,12261.49023,12994.4502,59.61033962,-40.38966038,207.8190302,224.8141787,0.027920847999999998,2466200,1,0.0
BSESN,10/27/2006,12906.80957,12921.23047,12741.84961,12741.84961,15200,208.39941399999998,0.0,208.39941399999998,69.63581446,12261.49023,12994.4502,88.0429178,-11.957082199999999,213.8529963,222.62194219999998,0.029416947000000002,2481400,1,0.0
BSESN,10/30/2006,13024.25977,13039.299809999999,12844.84961,12925.42969,13800,117.45019599999999,0.0,117.45019599999999,74.26191218,12261.49023,13039.299809999999,98.06635974,-1.9336402590000001,225.5126378,223.20008140000002,0.022599745,2495200,1,-0.5994
BSESN,10/31/2006,12961.90039,13075.84961,12907.94043,13048.75977,17200,-62.359375,62.359375,0.0,67.92231638,12301.50977,13075.84961,85.28434007,-14.71565993,227.10320299999998,223.98070570000002,0.00260831,2478000,-1,-0.6486
BSESN,11/1/2006,13033.04004,13050.73047,12937.299809999999,12992.62012,12800,71.139648,0.0,71.139648,71.16277696,12301.50977,13075.84961,94.47147523,-5.528524767,231.43625930000005,225.4718164,0.01158118,2490800,1,-0.34
BSESN,11/2/2006,13091.12012,13137.74023,13014.65039,13062.51953,12000,58.080078,0.0,58.080078,73.66855090000001,12315.01953,13137.74023,94.33342119,-5.6665788070000005,236.82682230000003,227.7428176,0.018092313,2502800,1,0.2023
BSESN,11/3/2006,13130.79004,13146.86035,13017.83984,13119.33984,12600,39.669922,0.0,39.669922,75.35618559,12612.36035,13146.86035,96.99339326,-3.006606735,241.51586890000002,230.4974278,0.032003562,2515400,1,0.0
BSESN,11/6/2006,13186.88965,13206.87012,13113.38965,13155.11035,14600,56.099608999999994,0.0,56.099608999999994,77.68943248,12612.36035,13206.87012,96.63916891,-3.3608310869999998,246.91248819999998,233.78043990000003,0.037569771,2530000,1,-0.5859
BSESN,11/7/2006,13156.66016,13300.69043,13135.20996,13208.79004,17200,-30.229491999999997,30.229491999999997,0.0,73.37034267,12612.36035,13300.69043,79.07540603,-20.92459397,245.91532180000004,236.2074163,0.042253667,2512800,-1,-0.4019
BSESN,11/8/2006,13072.50977,13202.67969,12950.57031,13176.08008,16400,-84.15039,84.15039,0.0,62.2538086,12612.36035,13300.69043,66.85010996,-33.14989004,235.6187607,236.0896852,0.02946035,2496400,-1,-0.2732
BSESN,11/9/2006,13137.49023,13192.88965,13069.84961,13107.780270000001,16800,64.980468,0.0,64.980468,66.74334985,12612.36035,13300.69043,76.29041629999999,-23.7095837,230.05016740000002,234.8817816,0.017872787,2513200,1,0.0
BSESN,11/10/2006,13282.91016,13303.84961,13104.98047,13187.50977,16400,145.41992199999999,0.0,145.41992199999999,74.55744272,12612.36035,13303.84961,96.97183249,-3.028167508,234.6661046,234.83864619999997,0.019859124,2529600,1,0.0
BSESN,11/13/2006,13399.0,13410.08008,13287.280270000001,13295.24023,12800,116.089844,0.0,116.089844,79.08424769,12612.36035,13410.08008,98.61103121,-1.3889687869999998,244.86905040000002,236.84472709999997,0.033721877000000004,2542400,1,0.0
BSESN,11/14/2006,13425.5,13486.740230000001,13380.76953,13439.70996,22000,26.5,0.0,26.5,80.0205459,12636.16016,13486.740230000001,92.80018007,-7.199819933,252.1862409,239.9130298,0.030112695,2564400,1,-0.25
BSESN,11/15/2006,13469.37012,13506.080080000002,13390.79004,13476.28027,14400,43.870117,0.0,43.870117,81.59439012,12741.84961,13506.080080000002,95.19648032,-4.803519683,258.5447757,243.639379,0.028893631,2578800,1,0.0
BSESN,11/16/2006,13505.88965,13588.009769999999,13459.28027,13500.7002,68200,36.519531,0.0,36.519531,82.88905239,12844.84961,13588.009769999999,88.94987612,-11.05012388,263.4933935,247.61018190000001,0.028566416,2647000,1,0.1779
BSESN,11/17/2006,13429.480469999999,13678.04004,13383.42969,13678.04004,20800,-76.40917900000001,76.40917900000001,0.0,70.85658378,12907.94043,13678.04004,67.72371170000001,-32.276288300000004,258.2724228,249.74263009999999,0.018396364,2626200,-1,0.128
BSESN,11/20/2006,13430.70996,13463.05957,13200.36035,13390.9502,15600,1.229492,0.0,1.229492,70.93491902,12937.299809999999,13678.04004,66.61041663,-33.38958337,251.33672239999999,250.0614486,0.02082974,2641800,1,-0.5267
BSESN,11/21/2006,13616.769530000001,13630.41016,13434.580080000002,13434.580080000002,14200,186.05957,0.0,186.05957,80.21900374,12950.57031,13678.04004,91.57758656,-8.422413443,257.88089180000003,251.6253372,0.041633915,2656000,1,0.0
BSESN,11/22/2006,13706.53027,13740.38965,13625.08984,13625.08984,15200,89.76074200000001,0.0,89.76074200000001,83.20523722,12950.57031,13740.38965,95.71302278,-4.286977224,267.2296775,254.74620530000004,0.043314212000000005,2671200,1,0.8007
BSESN,11/23/2006,13680.830080000002,13790.82031,13643.46973,13667.12988,12200,-25.700195,25.700195,0.0,79.25259954,12950.57031,13790.82031,86.90982029,-13.09017971,269.4587143,257.6887071,0.029957285,2659000,-1,0.1027
BSESN,11/24/2006,13703.330080000002,13767.84961,13665.519530000001,13669.80957,17800,22.5,0.0,22.5,80.20263067,12950.57031,13790.82031,89.58759476,-10.41240524,269.9292278,260.13681119999995,0.022712895,2676800,1,0.0
BSESN,11/27/2006,13773.58984,13799.019530000001,13716.45996,13716.45996,12000,70.259766,0.0,70.259766,83.00634094,12950.57031,13799.019530000001,97.00280388,-2.997196115,272.82651489999995,262.674752,0.025927514,2688800,1,0.0
BSESN,11/28/2006,13601.9502,13691.12012,13577.37988,13690.669919999998,16000,-171.639649,171.639649,0.0,59.32437917,13069.84961,13799.019530000001,72.97346886,-27.02653114,258.2952833,261.7988582,0.009843079,2672800,-1,0.3182
BSESN,11/29/2006,13616.730469999999,13711.759769999999,13586.04004,13649.2002,13600,14.780273999999999,0.0,14.780273999999999,60.4456573,13104.98047,13799.019530000001,73.73504288,-26.26495712,245.14593250000001,258.46827310000003,0.008206851,2686400,1,0.5267
BSESN,11/30/2006,13696.30957,13745.16016,13630.61035,13630.90039,10800,79.579101,0.0,79.579101,66.22909784,13200.36035,13799.019530000001,82.84333313,-17.15666687,238.39823909999998,254.45426630000003,0.019868906999999998,2697200,1,0.0
BSESN,12/1/2006,13844.78027,13857.80957,13725.78027,13729.669919999998,12200,148.47070300000001,0.0,148.47070300000001,74.31404892,13200.36035,13857.80957,98.01820481,-1.9817951930000002,242.2386124,252.0111355,0.030830113,2709400,1,-0.1779
BSESN,12/4/2006,13874.330080000002,13912.54004,13828.90039,13846.70996,10000,29.549805,0.0,29.549805,75.6526413,13200.36035,13912.54004,94.63478646,-5.365213541,244.84414730000003,250.57773790000002,0.018914952,2719400,1,-0.5267
BSESN,12/5/2006,13937.65039,14028.46973,13905.65039,14028.46973,12400,63.320313,0.0,63.320313,78.43174101,13200.36035,14028.46973,89.03292986,-10.96707014,249.1464672,250.2914837,0.016862044,2731800,1,-0.5994
BSESN,12/6/2006,13949.0,14035.299809999999,13847.669919999998,13951.08984,11000,11.349609,0.0,11.349609,78.92915722,13200.36035,14035.299809999999,89.66394453,-10.33605547,250.5833366,250.3498543,0.019601875,2742800,1,-0.5574
BSESN,12/7/2006,13972.03027,14002.71973,13915.740230000001,13962.94043,9600,23.030273,0.0,23.030273,80.00863424,13200.36035,14035.299809999999,92.42226107,-7.577738932999999,250.69061119999998,250.4180057,0.019608386999999998,2752400,1,-0.5994
BSESN,12/8/2006,13799.490230000001,14009.55957,13756.86035,14007.669919999998,14800,-172.54003899999998,172.54003899999998,0.0,55.4512718,13434.580080000002,14035.299809999999,60.74549238,-39.25450762,234.1539074,247.16518599999998,0.001880439,2737600,-1,0.0
BSESN,12/11/2006,13399.42969,13801.980469999999,13261.73047,13783.0,27200,-400.060546,400.060546,0.0,30.44829937,13261.73047,14035.299809999999,17.80050121,-82.19949879,186.615718,235.0552924,-0.014889079,2710400,-1,-0.29600000000000004
BSESN,12/12/2006,12995.01953,13492.20996,12801.65039,13413.61035,21200,-404.41015699999997,404.41015699999997,0.0,19.95398594,12801.65039,14035.299809999999,15.67456182,-84.32543818,114.9833837,211.04091069999998,-0.045657872,2689200,-1,0.0
BSESN,12/13/2006,13181.33984,13223.0,12830.37988,13039.01953,20800,186.320313,0.0,186.320313,32.34910237,12801.65039,14035.299809999999,30.77774355,-69.22225645,72.41399142,183.31552680000001,-0.037599159,2710000,1,0.0
BSESN,12/14/2006,13487.16016,13524.769530000001,13239.79004,13256.80957,14600,305.820312,0.0,305.820312,47.68996931,12801.65039,14035.299809999999,55.56763188,-44.43236812,62.63259508,159.1789405,-0.025830682,2724600,1,0.0
BSESN,12/15/2006,13614.519530000001,13669.65039,13545.59961,13545.59961,18800,127.359375,0.0,127.359375,52.82988264,12801.65039,14035.299809999999,65.89142189,-34.10857811,64.41506838,140.22616609999997,-0.018725989,2743400,1,0.0
BSESN,12/18/2006,13731.08984,13744.169919999998,13416.40039,13695.59961,14200,116.57031299999998,0.0,116.57031299999998,57.26457778,12801.65039,14035.299809999999,75.34064723,-24.65935277,74.37657449,127.0562477,-0.014820328,2757600,1,-0.2732
BSESN,12/19/2006,13382.00977,13748.62012,13237.38965,13737.36035,18600,-349.08007799999996,349.08007799999996,0.0,43.223468100000005,12801.65039,14035.299809999999,47.044109000000006,-52.955891,53.48673318,112.34234479999999,-0.040647375,2739000,-1,0.0
BSESN,12/20/2006,13340.20996,13568.08984,13232.55957,13452.69043,15400,-41.799805,41.799805,0.0,41.80714298,12801.65039,14035.299809999999,43.65580398,-56.34419602,33.17605559,96.50908699,-0.045220365,2723600,-1,0.7184
BSESN,12/21/2006,13384.86035,13441.36035,13182.34961,13313.91016,12000,44.650391,0.0,44.650391,44.06614698,12801.65039,14035.299809999999,47.27517838,-52.72482162,20.446911399999998,81.29665187,-0.030046754,2735600,1,0.0
BSESN,12/22/2006,13471.740230000001,13493.87988,13362.11035,13398.12988,10800,86.879882,0.0,86.879882,48.55022029,12801.65039,14035.299809999999,54.31768827,-45.68231173,17.17151083,68.47162366,0.0053965390000000005,2746400,1,0.0
BSESN,12/26/2006,13708.33984,13726.62012,13490.769530000001,13501.44043,8200,236.59961,0.0,236.59961,58.90288237,12801.65039,14035.299809999999,73.49652525,-26.50347475,33.28367002,61.43403293,0.054891823,2754600,1,0.0
BSESN,12/27/2006,13859.69043,13911.58984,13734.009769999999,13734.009769999999,11400,151.35058600000002,0.0,151.35058600000002,64.21734193,12801.65039,14009.55957,87.59268142,-12.40731858,57.60140651,60.66750765,0.051462945999999996,2766000,1,0.7003
BSESN,12/28/2006,13846.33984,13960.38965,13819.769530000001,13893.29004,11600,-13.350585999999998,13.350585999999998,0.0,63.38311264,12801.65039,14009.55957,86.48741736,-13.51258264,74.93233386,63.52047289,0.026631232,2754400,-1,0.0
BSESN,12/29/2006,13786.91016,13929.09961,13770.05957,13873.03027,8800,-59.429688,59.429688,0.0,59.41845669,12801.65039,13960.38965,85.02859975,-14.97140025,82.9159362,67.39956555,0.012662263,2745600,-1,0.0
BSESN,1/2/2007,13942.240230000001,13980.54004,13797.44043,13827.769530000001,9600,155.33007800000001,0.0,155.33007800000001,65.85882149,12801.65039,13980.54004,96.75119677,-3.2488032330000003,100.6169877,74.04304999,0.01537754,2755200,1,-0.4939
BSESN,1/3/2007,14014.919919999998,14035.669919999998,13897.419919999998,13969.4502,11600,72.679688,0.0,72.679688,68.5532295,12830.37988,14035.669919999998,98.27842268,-1.721577324,119.1365105,83.06174208,0.047295598,2766800,1,0.0
BSESN,1/4/2007,13871.70996,14060.34961,13850.37988,14029.04004,14600,-143.20996100000002,143.20996100000002,0.0,58.12407736,13182.34961,14060.34961,78.51484647,-21.48515353,120.8642706,90.62224778,0.039841952,2752200,-1,-0.8481
BSESN,1/5/2007,13860.519530000001,13971.82031,13763.38965,13768.79004,13200,-11.190430000000001,11.190430000000001,0.0,57.33760746,13182.34961,14060.34961,77.24031002,-22.75968998,119.9478743,96.48737309,0.035537104,2739000,-1,-0.4215
BSESN,1/8/2007,13652.15039,13855.88965,13599.87012,13855.88965,11600,-208.36914,208.36914,0.0,44.42329399,13182.34961,14060.34961,53.50806173,-46.49193827,101.240933,97.43808508,0.013391748,2727400,-1,-0.7184
BSESN,1/9/2007,13566.330080000002,13748.419919999998,13493.37988,13650.95996,36600,-85.820313,85.820313,0.0,40.128080600000004,13182.34961,14060.34961,43.73353861,-56.26646139,78.58468988,93.66740604,-0.01035937,2690800,-1,0.0
BSESN,1/10/2007,13362.16016,13569.57031,13336.51953,13569.57031,12600,-204.16992199999999,204.16992199999999,0.0,31.71142861,13182.34961,14060.34961,20.47956116,-79.52043884,43.65146069,83.66421697,-0.035897647000000005,2678200,-1,0.4588
BSESN,1/11/2007,13630.70996,13667.799809999999,13303.219729999999,13331.37988,15600,268.549805,0.0,268.549805,48.20053853,13182.34961,14060.34961,51.06609932,-48.93390068,37.20744551,74.37286268,-0.01557306,2693800,1,-0.2732
BSESN,1/12/2007,14056.53027,14070.87988,13729.07031,13729.07031,14400,425.820312,0.0,425.820312,64.07237382,13303.219729999999,14070.87988,98.13073404,-1.8692659619999998,65.70327109,72.63894436,0.01955624,2708200,1,0.0
BSESN,1/15/2007,14129.63965,14202.12012,14103.12012,14110.44043,15400,73.109375,0.0,73.109375,66.12841598,13303.219729999999,14202.12012,91.93676298,-8.063237017999999,93.11239203,76.7336339,0.013441126000000001,2723600,1,0.0
BSESN,1/16/2007,14114.730469999999,14211.15039,14070.65039,14146.0,9000,-14.909179,14.909179,0.0,65.24977576,13303.219729999999,14211.15039,89.38025492,-10.61974508,112.3363284,83.8541728,0.007121735,2714600,-1,0.0
BSESN,1/17/2007,14131.33984,14185.12012,14089.62988,14116.25,9000,16.609375,0.0,16.609375,65.83331923,13303.219729999999,14211.15039,91.20962094,-8.790379064,127.44259540000002,92.57185732,0.018716502,2723600,1,-0.6124
BSESN,1/18/2007,14217.75,14325.919919999998,14140.34961,14165.769530000001,13800,86.410156,0.0,86.410156,68.96204901,13303.219729999999,14325.919919999998,89.42310537,-10.57689463,144.71877030000002,103.00123990000002,0.025773237999999997,2737400,1,-0.5267
BSESN,1/19/2007,14182.70996,14300.11035,14067.519530000001,14271.240230000001,14400,-35.040039,35.040039,0.0,66.12868201,13303.219729999999,14325.919919999998,85.99687751,-14.00312249,153.8098014,113.1629522,0.038862711,2723000,-1,-0.6486
BSESN,1/22/2007,14209.240230000001,14259.07031,14111.75,14217.799809999999,11200,26.530272999999998,0.0,26.530272999999998,67.3023213,13303.219729999999,14325.919919999998,88.59101733,-11.40898267,161.295961,122.78955400000001,0.047390130999999995,2734200,1,0.0
BSESN,1/23/2007,14041.240230000001,14212.12012,14025.740230000001,14212.12012,14600,-168.0,168.0,0.0,53.70551529,13303.219729999999,14325.919919999998,72.16391574,-27.83608426,151.9213457,128.6159123,0.05082113,2719600,-1,0.4404
BSESN,1/24/2007,14110.45996,14156.45996,14043.54004,14069.61035,18000,69.219727,0.0,69.219727,57.76224601,13303.219729999999,14325.919919999998,78.93224602,-21.06775398,148.3670658,132.56614299999998,0.035196259,2737600,1,0.0
BSESN,1/25/2007,14282.71973,14307.19043,14115.40039,14151.62012,15600,172.25976599999998,0.0,172.25976599999998,66.2535892,13303.219729999999,14325.919919999998,95.7758691,-4.224130905,157.6331007,137.5795345,0.016091414,2753200,1,0.0
BSESN,1/29/2007,14211.95996,14316.54004,14185.919919999998,14306.96973,12800,-70.759766,70.759766,0.0,60.48979904,13303.219729999999,14325.919919999998,88.85695323,-11.14304677,157.4517722,141.5539821,0.005826073,2740400,-1,-0.29600000000000004
BSESN,1/31/2007,14090.919919999998,14269.30957,14045.61035,14219.37988,25000,-121.040039,121.040039,0.0,51.62533981,13303.219729999999,14325.919919999998,77.02161385,-22.97838615,145.859768,142.41513930000002,-0.001686929,2715400,-1,0.4404
BSESN,2/1/2007,14267.17969,14278.080080000002,14109.91016,14124.36035,14200,176.25976599999998,0.0,176.25976599999998,61.18322124,13303.219729999999,14325.919919999998,94.25635838,-5.743641615,149.17610190000002,143.76733180000002,0.009612666,2729600,1,0.0
BSESN,2/2/2007,14403.769530000001,14462.769530000001,14293.11035,14293.11035,18400,136.589843,0.0,136.589843,67.0112615,13729.07031,14462.769530000001,91.95855759999999,-8.041442399,160.9704125,147.2079479,0.013083612,2748000,1,0.0
BSESN,2/5/2007,14515.90039,14526.509769999999,14372.36035,14432.08984,11600,112.13086000000001,0.0,112.13086000000001,71.11872793,14025.740230000001,14526.509769999999,97.88138568,-2.118614317,177.3214605,153.2306504,0.02349272,2759600,1,0.0
BSESN,2/6/2007,14478.19043,14564.799809999999,14452.78027,14541.240230000001,18600,-37.709961,37.709961,0.0,67.84095327,14025.740230000001,14564.799809999999,83.93324603,-16.06675397,185.10315119999999,159.6051506,0.018927838,2741000,-1,0.0
BSESN,2/7/2007,14643.12988,14663.259769999999,14478.4502,14493.55957,11400,164.93945300000001,0.0,164.93945300000001,73.90960416,14025.740230000001,14663.259769999999,96.84246804,-3.157531964,202.2480431,168.1337291,0.042865847,2752400,1,-0.0516
BSESN,2/8/2007,14652.08984,14697.69043,14523.16016,14690.580080000002,11600,8.959961,0.0,8.959961,74.21459891,14025.740230000001,14697.69043,93.21369556,-6.7863044420000005,214.09058430000005,177.3251001,0.038384991,2764000,1,0.2023
BSESN,2/9/2007,14538.90039,14723.87988,14493.669919999998,14684.34961,12200,-113.189453,113.189453,0.0,63.40981848,14025.740230000001,14723.87988,73.50394119,-26.49605881,211.8997918,184.2400385,0.017936406000000002,2751800,-1,-0.7096
BSESN,2/12/2007,14190.7002,14529.28027,14146.21973,14529.28027,21200,-348.200196,348.200196,0.0,41.80581455,14025.740230000001,14723.87988,23.62850488,-76.37149512,179.9918927,183.39040930000002,-0.001495907,2730600,-1,0.0
BSESN,2/13/2007,14090.980469999999,14363.740230000001,13957.7002,14168.330080000002,24400,-99.719726,99.719726,0.0,37.57541405,13957.7002,14723.87988,17.39543296,-82.60456704,144.9867868,175.70968480000002,4.3e-06,2706200,-1,-0.5423
BSESN,2/14/2007,14009.90039,14036.61035,13805.36035,13990.41016,22400,-81.080078,81.080078,0.0,34.31748765,13805.36035,14723.87988,22.26844744,-77.73155256,109.44093659999999,162.4559352,-0.018032947,2683800,-1,0.6369
BSESN,2/15/2007,14355.549809999999,14372.95996,14107.08984,14107.08984,16200,345.64941400000004,0.0,345.64941400000004,53.95509744,13805.36035,14723.87988,59.89959216,-40.10040784,107.9176061,151.5482694,-0.0033477159999999997,2700000,1,0.0
BSESN,2/19/2007,14402.90039,14479.17969,14372.07031,14406.87988,12600,47.350586,0.0,47.350586,56.03289934,13805.36035,14723.87988,65.0546906,-34.9453094,109.2715381,143.09292309999998,-0.007784566999999999,2712600,1,0.0
BSESN,2/20/2007,14253.37988,14466.759769999999,14230.46973,14449.230469999999,13200,-149.520508,149.520508,0.0,48.1210034,13805.36035,14723.87988,48.77626614,-51.22373386,97.15948941,133.9062364,-0.015527531,2699400,-1,-0.743
BSESN,2/21/2007,14188.490230000001,14312.87988,14157.71973,14199.07031,14600,-64.889649,64.889649,0.0,44.94322047,13805.36035,14723.87988,41.71167505,-58.28832495,81.38637967,123.40226499999999,-0.031047982999999998,2684800,-1,0.0
BSESN,2/22/2007,14021.30957,14287.03027,13978.049809999999,14200.11035,16200,-167.18066399999998,167.18066399999998,0.0,37.56812563,13805.36035,14723.87988,23.51057443,-76.48942557,54.76470079,109.67475220000001,-0.043050532999999995,2668600,-1,0.29600000000000004
BSESN,2/23/2007,13632.53027,14071.269530000001,13568.080080000002,14071.269530000001,18200,-388.77929700000004,388.77929700000004,0.0,26.08317989,13568.080080000002,14723.87988,5.576242072,-94.42375793,2.269427819,88.19368731,-0.062341035999999996,2650400,-1,0.0
BSESN,2/26/2007,13649.519530000001,13723.40039,13383.87988,13684.9502,17400,16.989258,0.0,16.989258,27.20527207,13383.87988,14723.87988,19.82385433,-80.17614567,-37.52994128,63.04896159,-0.03813629,2667800,1,0.0
BSESN,2/27/2007,13478.830080000002,13703.41016,13408.55957,13703.41016,15400,-170.68945300000001,170.68945300000001,0.0,23.13411122,13383.87988,14723.87988,7.085835447999999,-92.91416455,-81.90034419,34.05910043,-0.043442710999999995,2652400,-1,-0.29600000000000004
BSESN,2/28/2007,12938.08984,13298.51953,12800.91016,13045.12012,35800,-540.740234,540.740234,0.0,14.95408206,12800.91016,14723.87988,7.133741425,-92.86625858,-158.86611619999996,-4.525942892,-0.076503795,2616600,-1,-0.25
BSESN,3/1/2007,13159.549809999999,13193.12988,12861.34961,13013.74023,24200,221.459961,0.0,221.459961,27.13008482,12800.91016,14723.87988,18.65030135,-81.34969865,-199.690173,-43.55878891,-0.083312727,2640800,1,0.0
BSESN,3/2/2007,12886.12988,13254.030270000001,12836.75,13139.09961,19600,-273.41992200000004,273.41992200000004,0.0,22.53413745,12800.91016,14529.28027,4.93064108,-95.06935892,-251.2104372,-85.08911857,-0.105310074,2621200,-1,0.3164
BSESN,3/5/2007,12415.04004,12716.84961,12344.44043,12716.84961,27600,-471.089844,471.089844,0.0,16.85703652,12344.44043,14479.17969,3.307177152,-96.69282285,-326.29233619999997,-133.3297621,-0.128975714,2593600,-1,-0.8658
BSESN,3/6/2007,12697.08984,12760.219729999999,12427.12988,12573.00977,21600,282.049805,0.0,282.049805,29.18233025,12344.44043,14479.17969,16.51955445,-83.48044555,-358.89905510000006,-178.4436207,-0.105113396,2615200,1,-0.6249
BSESN,3/7/2007,12579.75,12902.17969,12390.45996,12792.90039,19800,-117.339844,117.339844,0.0,27.24365628,12344.44043,14479.17969,11.02287172,-88.97712828,-389.71605539999996,-220.6981076,-0.102812049,2595400,-1,0.0
BSESN,3/8/2007,13049.34961,13099.83008,12596.86035,12649.76953,20800,469.599609,0.0,469.599609,44.32358945,12344.44043,14479.17969,33.02085612,-66.97914388,-371.9582828,-250.95014269999996,-0.042778607999999996,2616200,1,0.0
BSESN,3/9/2007,12884.99023,13145.719729999999,12788.16016,13107.37012,25200,-164.359375,164.359375,0.0,40.48538394,12344.44043,14466.759769999999,25.46976767,-74.53023233,-366.9179463,-274.1437034,-0.056011444,2591000,-1,0.0
BSESN,3/12/2007,12902.62988,13056.86035,12844.99023,12916.66992,17200,17.639649,0.0,17.639649,41.11681791,12344.44043,14312.87988,28.35695313,-71.64304687,-357.3804122,-290.7910451,-0.042748532,2608200,1,0.0
BSESN,3/13/2007,12982.98047,13026.84961,12817.62012,12924.5,15000,80.35058599999999,0.0,80.35058599999999,44.22692882,12344.44043,14287.03027,32.87055378,-67.12944622,-339.42554049999995,-300.5179442,0.0034696490000000004,2623200,1,0.0
BSESN,3/14/2007,12529.62012,12694.36035,12504.09961,12694.36035,19200,-453.360352,453.360352,0.0,32.91026567,12344.44043,14071.269530000001,10.72368348,-89.27631652,-357.6557342,-311.94550219999996,-0.047868635,2604000,-1,-0.1027
BSESN,3/15/2007,12543.84961,12789.80957,12510.75,12655.94043,16200,14.229492,0.0,14.229492,33.52625827,12344.44043,13723.40039,14.46083894,-85.53916106,-366.7276845,-322.9019387,-0.026561914,2620200,1,0.3612
BSESN,3/16/2007,12430.40039,12638.780270000001,12316.09961,12570.51953,14800,-113.44921799999999,113.44921799999999,0.0,30.91500629,12316.09961,13703.41016,8.239019176000001,-91.76098082,-378.7061851,-334.062788,0.001237237,2605400,-1,-0.8402
BSESN,3/19/2007,12644.99023,12655.0,12426.66016,12484.63965,12000,214.58984300000003,0.0,214.58984300000003,40.95241085,12316.09961,13298.51953,33.47760134,-66.52239866,-366.65703210000004,-340.5816368,-0.004103272,2617400,1,-0.4585
BSESN,3/20/2007,12705.94043,12798.799809999999,12674.76953,12746.94043,15600,60.950196,0.0,60.950196,43.63622023,12316.09961,13254.030270000001,41.56392748,-58.43607252,-348.176261,-342.10056160000005,0.010031235,2633000,1,0.0
BSESN,3/21/2007,12945.87988,12964.94043,12664.33008,12735.91016,16000,239.939453,0.0,239.939453,53.28146359,12316.09961,13254.030270000001,67.1457175,-32.854282500000004,-310.58873450000004,-335.7981962,-0.00792911,2649000,1,0.0
BSESN,3/22/2007,13308.030270000001,13326.24023,13071.80957,13071.80957,19000,362.15039,0.0,362.15039,64.00790008,12316.09961,13326.24023,98.19728456,-1.802715439,-248.71085519999997,-318.380728,0.032832003,2668000,1,0.0
BSESN,3/23/2007,13285.92969,13386.9502,13196.90039,13343.57031,16400,-22.100585,22.100585,0.0,62.98954917,12316.09961,13386.9502,90.56633032,-9.433669675,-199.1597331,-294.53652900000003,0.029707107000000003,2651600,-1,-0.0516
BSESN,3/26/2007,13124.32031,13345.73047,13090.799809999999,13345.73047,12200,-161.609375,161.609375,0.0,55.53469798,12316.09961,13386.9502,75.47464740000001,-24.5253526,-170.95991819999998,-269.82120679999997,0.010886548000000001,2639400,-1,-0.2732
BSESN,3/28/2007,12884.33984,13035.55957,12861.17969,13034.26953,13200,-239.980469,239.980469,0.0,46.17190311,12316.09961,13386.9502,53.06438101,-46.93561899,-166.06152609999998,-249.0692707,0.028310493,2626200,-1,0.2481
BSESN,3/29/2007,12979.66016,13004.40039,12832.69043,12862.530270000001,15600,95.320312,0.0,95.320312,50.03276178,12316.09961,13386.9502,61.96574533,-38.03425467,-152.727416,-229.80089980000002,0.034742967,2641800,1,0.2023
BSESN,3/30/2007,13072.09961,13111.87012,12984.12988,13018.20996,13600,92.439453,0.0,92.439453,53.74513883,12316.09961,13386.9502,70.59808435,-29.40191565,-133.1658928,-210.47389840000002,0.051623375,2655400,1,0.0
BSESN,4/2/2007,12455.37012,12811.92969,12425.51953,12811.92969,15800,-616.7294919999999,616.7294919999999,0.0,34.19028108,12316.09961,13386.9502,13.00559666,-86.99440334,-165.52014730000002,-201.4831482,-0.014995671,2639600,-1,0.34
BSESN,4/3/2007,12624.58008,12657.75,12481.86035,12503.75,12200,169.20996100000002,0.0,169.20996100000002,40.98760306,12316.09961,13386.9502,28.80705049,-71.19294951,-175.48442219999998,-196.283403,-0.006403331999999999,2651800,1,-0.29600000000000004
BSESN,4/4/2007,12786.76953,12835.36035,12691.24023,12691.24023,18800,162.18945300000001,0.0,162.18945300000001,47.03766125,12316.09961,13386.9502,43.95290325,-56.04709675,-168.35317780000003,-190.69735790000001,-0.012290424,2670600,1,0.3182
BSESN,4/5/2007,12856.08008,12899.30957,12711.5,12791.59961,15800,69.310547,0.0,69.310547,49.58619504,12316.09961,13386.9502,50.42537923,-49.57462077,-155.31841930000002,-183.62157019999998,-0.033960713,2686400,1,-0.6486
BSESN,4/9/2007,13177.74023,13194.0,12904.84961,12904.84961,13800,321.66015600000003,0.0,321.66015600000003,59.91501707,12425.51953,13386.9502,78.23972452,-21.76027548,-117.67649159999999,-170.43255449999998,-0.00814316,2700200,1,0.2732
BSESN,4/10/2007,13189.54004,13236.2002,13075.48047,13236.2002,15400,11.799805000000001,0.0,11.799805000000001,60.25965134,12425.51953,13386.9502,79.46704184,-20.53295816,-85.90261515,-153.5265666,0.004969379,2715600,1,0.0
BSESN,4/11/2007,13183.24023,13294.90039,13161.20996,13221.75977,16000,-6.299805,6.299805,0.0,59.942176399999994,12425.51953,13386.9502,78.81178866,-21.18821134,-60.53215378,-134.927684,0.023198735,2699600,-1,0.2732
BSESN,4/12/2007,13113.80957,13160.15039,13030.87012,13127.86035,12200,-69.43066400000001,69.43066400000001,0.0,56.17839592,12425.51953,13386.9502,71.59018999,-28.40981001,-45.50381503,-117.0429102,0.010335356,2687400,-1,0.0
BSESN,4/13/2007,13384.08008,13421.049809999999,13119.87988,13163.01953,18400,270.270508,0.0,270.270508,65.81843799,12425.51953,13421.049809999999,96.28642865,-3.713571346,-11.65087304,-95.96450281,0.023866132999999998,2705800,1,0.0
BSESN,4/16/2007,13695.580080000002,13708.40039,13479.490230000001,13479.490230000001,14200,311.5,0.0,311.5,73.55491067,12425.51953,13708.40039,99.00066223,-0.9993377720000001,39.85386354,-68.80082954,0.099572309,2720000,1,0.0
BSESN,4/17/2007,13607.04004,13755.759769999999,13581.04004,13733.17969,14200,-88.54003900000001,88.54003900000001,0.0,68.47220491,12425.51953,13755.759769999999,88.82008504,-11.17991496,72.68937925,-40.50278778,0.07782119900000001,2705800,-1,0.0
BSESN,4/18/2007,13672.19043,13762.919919999998,13602.90039,13602.90039,14200,65.150391,0.0,65.150391,70.21940214,12425.51953,13762.919919999998,93.21598135,-6.784018654,102.7840238,-11.84542546,0.069245082,2720000,1,0.0
BSESN,4/19/2007,13619.7002,13658.11035,13423.63965,13538.70996,15800,-52.490235,52.490235,0.0,66.77908714,12425.51953,13762.919919999998,89.2911855,-10.7088145,121.00386599999999,14.72443283,0.059397585999999995,2704200,-1,-0.4019
BSESN,4/20/2007,13897.41016,13915.62012,13684.9502,13684.9502,21200,277.70996099999996,0.0,277.70996099999996,74.42755142,12425.51953,13915.62012,98.77793746,-1.222062535,156.0532108,42.99018842,0.054612544000000006,2725400,1,-0.4767
BSESN,4/23/2007,13928.330080000002,14046.519530000001,13879.38965,13972.80957,42800,30.919921999999996,0.0,30.919921999999996,75.16218522,12481.86035,14046.519530000001,92.44631326,-7.553686744,184.20168600000002,71.23248793,0.056013329,2768200,1,-0.3818
BSESN,4/24/2007,14136.71973,14197.32031,13850.07031,13893.71973,22000,208.389649,0.0,208.389649,79.6977248,12691.24023,14197.32031,95.97627066,-4.023729338,220.7798458,101.1419595,0.072325125,2790200,1,-0.4019
BSESN,4/25/2007,14217.769530000001,14238.29004,14052.169919999998,14141.7002,18000,81.04980400000001,0.0,81.04980400000001,81.23544584,12711.5,14238.29004,98.65597053,-1.344029465,253.38745010000002,131.5910576,0.08418301,2808200,1,0.0
BSESN,4/26/2007,14228.87988,14383.71973,14127.17969,14273.169919999998,16800,11.110352,0.0,11.110352,81.45758388,12904.84961,14383.71973,89.52985512,-10.47014488,276.933408,160.65952769999998,0.063119751,2825000,1,-0.2732
BSESN,4/27/2007,13908.580080000002,14219.25,13884.53027,14219.25,19800,-320.299805,320.299805,0.0,58.44334923,13030.87012,14383.71973,64.87860546,-35.12139454,266.6741779,181.8624577,0.015552463,2805200,-1,-0.6369
BSESN,4/30/2007,13872.37012,13901.12012,13693.58984,13823.40039,15400,-36.209961,36.209961,0.0,56.36603688,13030.87012,14383.71973,62.20203589,-37.79796411,252.7087537,196.0317169,0.019499471,2789800,-1,-0.6249
BSESN,5/3/2007,14078.20996,14107.05957,13987.769530000001,13987.769530000001,14200,205.839844,0.0,205.839844,64.61555204,13030.87012,14383.71973,77.417315,-22.582685,255.3075827,207.8868901,0.029696742999999998,2804000,1,0.0
BSESN,5/4/2007,13934.269530000001,14189.20996,13912.919919999998,14129.88965,13200,-143.94043,143.94043,0.0,56.06324551,13119.87988,14383.71973,64.43772539,-35.56227461,242.9517867,214.8998694,0.023096642,2790800,-1,-0.5106
BSESN,5/7/2007,13879.25,14067.07031,13861.37988,14044.70996,11600,-55.01953100000001,55.01953100000001,0.0,52.97105114,13423.63965,14383.71973,47.45545314,-52.54454686,226.113616,217.14261869999999,-0.00130673,2779200,-1,0.0
BSESN,5/8/2007,13765.45996,13956.40039,13741.240230000001,13886.0,12800,-113.790039,113.790039,0.0,46.80990414,13423.63965,14383.71973,35.60331273,-64.39668727,201.2672556,213.96754610000002,-0.011693442,2766400,-1,0.4404
BSESN,5/9/2007,13781.509769999999,13806.37012,13612.04004,13707.86035,12400,16.049805,0.0,16.049805,47.79805462,13423.63965,14383.71973,37.27502797,-62.72497203,180.78741630000002,207.33152009999998,-0.02512676,2778800,1,0.0
BSESN,5/10/2007,13771.230469999999,13976.79004,13745.230469999999,13823.36035,13600,-10.279297,10.279297,0.0,47.15072975,13423.63965,14383.71973,36.20435718,-63.79564282,161.86170180000002,198.23755649999998,-0.031407111,2765200,-1,0.0
BSESN,5/11/2007,13796.16016,13864.17969,13562.9502,13691.86035,16000,24.929687,0.0,24.929687,49.08046539,13562.9502,14383.71973,28.41357432,-71.58642568,147.177978,188.02564080000002,-0.03041137,2781200,1,0.0
BSESN,5/14/2007,13965.86035,14026.019530000001,13924.019530000001,13954.41016,11200,169.700196,0.0,169.700196,60.42919264,13562.9502,14383.71973,49.08931695,-50.91068305,147.53373159999998,179.92725890000003,0.004118341,2792400,1,-0.6597
BSESN,5/15/2007,13929.330080000002,14023.86035,13885.45996,13948.91016,11200,-36.530274,36.530274,0.0,57.2594196,13562.9502,14383.71973,44.638582299999996,-55.361417700000004,143.217064,172.5852199,0.004106001,2781200,-1,-0.0772
BSESN,5/16/2007,14127.30957,14159.36035,13936.87988,13949.80957,19800,197.979492,0.0,197.979492,67.81624376,13562.9502,14383.71973,68.75978615,-31.24021385,153.99619189999999,168.8674143,0.003487632,2801000,1,0.128
BSESN,5/17/2007,14299.70996,14352.980469999999,14217.36035,14217.36035,17600,172.40039099999998,0.0,172.40039099999998,74.21535874,13562.9502,14383.71973,89.76451212,-10.23548788,174.439173,169.9817661,0.02622602,2818600,1,0.1531
BSESN,5/18/2007,14303.41016,14337.05957,14201.009769999999,14261.46973,12400,3.700195,0.0,3.700195,74.34170004,13562.9502,14352.980469999999,93.72551728,-6.274482717000001,188.7630151,173.7380159,0.03056074,2831000,1,-0.1531
BSESN,5/21/2007,14418.59961,14451.299809999999,14384.61035,14414.830080000002,30800,115.189453,0.0,115.189453,78.18177474,13562.9502,14451.299809999999,96.31899473,-3.681005274,207.0231553,180.3950438,0.047447717,2861800,1,0.0
BSESN,5/22/2007,14453.71973,14483.58984,14348.259769999999,14458.480469999999,17000,35.120118,0.0,35.120118,79.27305964,13562.9502,14483.58984,96.75550396,-3.244496045,221.77189950000002,188.6704149,0.048776220999999995,2878800,1,0.0
BSESN,5/23/2007,14363.259769999999,14500.63965,14325.88965,14490.03027,18000,-90.45996099999999,90.45996099999999,0.0,69.01406768,13562.9502,14500.63965,85.34910662,-14.65089338,223.5836892,195.6530698,0.042990297999999996,2860800,-1,0.0
BSESN,5/24/2007,14218.11035,14389.66016,14174.049809999999,14344.7002,13600,-145.14941399999998,145.14941399999998,0.0,55.67448917,13562.9502,14500.63965,69.8696306,-30.130369399999996,210.87634959999997,198.6977257,0.030584611,2847200,-1,0.0
BSESN,5/25/2007,14338.4502,14364.9502,14046.05957,14073.61035,14000,120.33984299999999,0.0,120.33984299999999,62.59147824,13562.9502,14500.63965,82.70328706,-17.29671294,208.117067,200.581594,0.026678617,2861200,1,0.0
BSESN,5/28/2007,14397.88965,14527.46973,14368.40039,14467.84961,12000,59.439453,0.0,59.439453,65.64671508,13562.9502,14527.46973,86.56532349,-13.43467651,208.32514019999996,202.1303032,0.033638342,2873200,1,0.0
BSESN,5/29/2007,14508.20996,14530.15039,14372.07031,14418.980469999999,11000,110.32031299999998,0.0,110.32031299999998,70.76080474,13562.9502,14530.15039,97.73155236,-2.268447638,214.91456569999997,204.68715569999998,0.026961991,2884200,1,-0.5994
BSESN,5/30/2007,14411.37988,14576.37012,14379.20996,14501.45996,15000,-96.830078,96.830078,0.0,61.49018867,13562.9502,14576.37012,83.71946017,-16.28053983,209.9037154,205.7304677,0.007809244,2869200,-1,0.0
BSESN,5/31/2007,14544.45996,14573.80957,14448.57031,14451.30957,12400,133.08007800000001,0.0,133.08007800000001,68.11473997,13885.45996,14576.37012,95.38143191,-4.618568091,214.20184509999999,207.4247431,0.016852611,2881600,1,0.4939
BSESN,6/1/2007,14570.75,14682.09961,14539.88965,14610.28027,13800,26.290039,0.0,26.290039,69.31782763,13885.45996,14682.09961,86.02258759,-13.97741241,217.22548999999998,209.3848925,0.01055237,2895400,1,-0.5719
BSESN,6/4/2007,14495.769530000001,14683.36035,14465.67969,14618.78027,15200,-74.980469,74.980469,0.0,61.66141039,13936.87988,14683.36035,74.86996261,-25.13003739,211.13759040000002,209.7354321,0.002909272,2880200,-1,0.0
BSESN,6/5/2007,14535.009769999999,14571.30957,14432.669919999998,14514.2002,10800,39.240235,0.0,39.240235,64.05862383,14046.05957,14683.36035,76.72204551,-23.27795449,207.0920173,209.2067491,0.011957592,2891000,1,0.4767
BSESN,6/6/2007,14255.92969,14590.82031,14234.07031,14551.53027,22800,-279.08007799999996,279.08007799999996,0.0,42.33556181,14046.05957,14683.36035,32.93109375,-67.06890625,179.2995875,203.2253168,0.002659941,2868200,-1,-0.5267
BSESN,6/7/2007,14186.17969,14362.580080000002,14139.08984,14195.83984,17000,-69.75,69.75,0.0,38.56425657,14046.05957,14683.36035,21.98649711,-78.01350289,149.91748909999998,192.5637513,-0.010619733000000001,2851200,-1,-0.6908
BSESN,6/8/2007,14063.80957,14229.21973,14010.61035,14063.94043,18600,-122.37011799999999,122.37011799999999,0.0,32.67246549,14010.61035,14683.36035,7.907724712,-92.09227529,115.4271463,177.1364303,-0.023203406,2832600,-1,0.0
BSESN,6/11/2007,14083.41016,14268.91016,14057.62988,14170.80957,12000,19.600586,0.0,19.600586,34.52132471,14010.61035,14683.36035,10.8212269,-89.17877309999999,88.65296841,159.43973789999998,-0.02927996,2844600,1,0.0
BSESN,6/12/2007,14130.9502,14153.44043,13946.990230000001,14122.330080000002,13600,47.540039,0.0,47.540039,39.19430324,13946.990230000001,14683.36035,24.98199703,-75.01800297,70.45812594,141.6434155,-0.019458906,2858200,1,0.0
BSESN,6/13/2007,14003.03027,14152.79004,13968.37988,14139.919919999998,13000,-127.919922,127.919922,0.0,32.08506077,13946.990230000001,14683.36035,7.610308679,-92.38969132,45.19552764,122.3538379,-0.037225836,2845200,-1,0.0
BSESN,6/14/2007,14203.71973,14219.240230000001,14087.91016,14087.91016,11800,200.689454,0.0,200.689454,48.87263835,13946.990230000001,14683.36035,34.86419217,-65.13580783,40.89726004,106.06252240000002,-0.025189525,2857000,1,-0.7351
BSESN,6/15/2007,14162.70996,14326.549809999999,14112.53027,14277.61035,13000,-41.009766,41.009766,0.0,46.1811172,13946.990230000001,14683.36035,29.29501371,-70.70498629,33.7921715,91.60845219,-0.022976329,2844000,-1,0.0
BSESN,6/18/2007,14080.13965,14283.70996,14057.259769999999,14241.759769999999,9400,-82.570313,82.570313,0.0,40.94277533,13946.990230000001,14683.36035,18.08186002,-81.91813998,21.25360512,77.53748278,-0.031294793,2834600,-1,0.0
BSESN,6/19/2007,14295.5,14315.17969,14058.79004,14088.580080000002,9400,215.360352,0.0,215.360352,55.97229701,13946.990230000001,14683.36035,47.32807015,-52.67192985,28.36747885,67.70348199,0.0027757090000000003,2844000,1,0.0
BSESN,6/20/2007,14411.9502,14449.37988,14347.580080000002,14359.95996,11200,116.450195,0.0,116.450195,62.00510794,13946.990230000001,14683.36035,63.14215496,-36.85784504,42.90722478,62.74423055,0.015914821000000003,2855200,1,0.0
BSESN,6/21/2007,14499.240230000001,14526.44043,14406.669919999998,14415.55957,13800,87.29003900000001,0.0,87.29003900000001,66.03088974,13946.990230000001,14683.36035,74.99625345,-25.00374655,60.77310035,62.35000451,0.030961075,2869000,1,-0.5106
BSESN,6/22/2007,14467.36035,14560.32031,14441.759769999999,14508.62988,18600,-31.879882000000002,31.879882000000002,0.0,63.20860301,13946.990230000001,14590.82031,80.824139,-19.175860999999998,71.53488577,64.18698076,0.027262587,2850400,-1,0.0
BSESN,6/25/2007,14487.71973,14521.62012,14424.70996,14469.42969,16200,20.359375,0.0,20.359375,64.33198779,13946.990230000001,14590.82031,83.986367,-16.013633,80.77538135,67.50466088,0.025247383999999998,2866600,1,-0.7184
BSESN,6/26/2007,14501.080080000002,14560.480469999999,14478.75,14478.75,12400,13.360351000000001,0.0,13.360351000000001,65.13798960000001,13946.990230000001,14560.480469999999,90.31763057,-9.682369435,88.16035168,71.63579904,0.035567287999999996,2879000,1,-0.4939
BSESN,6/27/2007,14431.05957,14520.19043,14407.12012,14520.19043,10400,-70.02050799999999,70.02050799999999,0.0,57.30694554,13946.990230000001,14560.480469999999,78.90416316,-21.09583684,87.35593918,74.77982707,0.016005655,2868600,-1,0.5267
BSESN,6/28/2007,14504.57031,14537.04004,14435.240230000001,14498.049809999999,16000,73.510743,0.0,73.510743,62.73408049,13946.990230000001,14560.480469999999,90.88654508,-9.113454919,91.59429704,78.14272106,0.024138061000000002,2884600,1,0.0
BSESN,6/29/2007,14650.509769999999,14663.25,14574.4502,14589.519530000001,10800,145.93945300000001,0.0,145.93945300000001,71.13841574,13946.990230000001,14663.25,98.22128303,-1.778716969,105.5130318,83.61678321,0.04050884,2895400,1,0.0
BSESN,7/2/2007,14664.259769999999,14745.96973,14638.87988,14685.16016,9200,13.75,0.0,13.75,71.82908538,13968.37988,14745.96973,89.49189452,-10.50810548,116.31246180000001,90.15591894,0.025795514,2904600,1,0.0
BSESN,7/3/2007,14806.509769999999,14828.38965,14720.0,14720.0,9200,142.25,0.0,142.25,78.08834385,14057.259769999999,14828.38965,97.16262039,-2.837379605,134.7956339,99.08386194,0.027377251000000002,2913800,1,-0.8225
BSESN,7/4/2007,14880.240230000001,14906.92969,14790.75,14868.13965,14800,73.730468,0.0,73.730468,80.65847494,14057.259769999999,14906.92969,96.85884444,-3.14115556,153.6222519,109.99153989999999,0.026277238999999997,2928600,1,0.0
BSESN,7/5/2007,14861.88965,14963.259769999999,14731.21973,14932.53027,18800,-18.350586,18.350586,0.0,78.03006622,14057.259769999999,14963.259769999999,88.81124525,-11.18875475,165.1579058,121.0248131,0.027270303,2909800,-1,0.5106
BSESN,7/6/2007,14964.12012,15007.21973,14826.55957,14843.42969,20000,102.230469,0.0,102.230469,81.83506893,14058.79004,15007.21973,95.45568738,-4.54431262,180.468807,132.9136119,0.032883048,2929800,1,0.0
BSESN,7/9/2007,15045.730469999999,15085.21973,15005.46973,15018.70996,14200,81.610352,0.0,81.610352,84.33421276,14347.580080000002,15085.21973,94.64653804,-5.3534619580000005,196.9181303,145.7145156,0.037559298,2944000,1,-0.6486
BSESN,7/10/2007,15009.87988,15114.9502,14966.40039,15100.12988,12600,-35.850586,35.850586,0.0,78.83647987,14406.669919999998,15114.9502,85.16543295,-14.83456705,204.7018196,157.5119764,0.040109343,2931400,-1,-0.8176
BSESN,7/11/2007,14910.62012,15015.34961,14829.549809999999,14948.15039,14600,-99.259766,99.259766,0.0,65.24797243,14407.12012,15114.9502,71.1328913,-28.8671087,200.5492095,166.119423,0.027994611000000003,2916800,-1,0.5267
BSESN,7/12/2007,15092.04004,15112.21973,14963.53027,14963.53027,19800,181.41992199999999,0.0,181.41992199999999,74.51262717,14407.12012,15114.9502,96.76332545,-3.236674551,209.4825235,174.7920431,0.030137537000000002,2936600,1,-0.3182
BSESN,7/13/2007,15272.71973,15330.730469999999,15216.830080000002,15216.830080000002,24000,180.679688,0.0,180.679688,80.4896658,14407.12012,15330.730469999999,93.71913255,-6.280867454,228.50748790000003,185.535132,0.041492716,2960600,1,0.0
BSESN,7/16/2007,15311.21973,15341.37988,15239.41016,15295.03027,20000,38.5,0.0,38.5,81.55326918,14407.12012,15341.37988,96.77175909,-3.228240913,243.88023790000003,197.20415319999998,0.034087031000000004,2980600,1,-0.1779
BSESN,7/17/2007,15289.82031,15440.2002,15272.45996,15357.59961,15800,-21.399414,21.399414,0.0,78.79827451,14435.240230000001,15440.2002,85.03623151,-14.96376849,251.4380775,208.0509381,0.027525099,2964800,-1,0.0
BSESN,7/18/2007,15301.169919999998,15325.78027,15160.269530000001,15296.05957,13000,11.349609,0.0,11.349609,79.22770298,14574.4502,15440.2002,83.94106001,-16.05893999,255.39945260000002,217.520641,0.029557497999999998,2977800,1,0.0
BSESN,7/19/2007,15550.12988,15593.30957,15357.37988,15357.37988,18600,248.959961,0.0,248.959961,86.26756017,14638.87988,15593.30957,95.47586505,-4.524134946,275.4526128,229.1070353,0.039160991,2996400,1,-0.4939
BSESN,7/20/2007,15565.549809999999,15683.03027,15524.67969,15625.62988,18000,15.419922,0.0,15.419922,86.592299,14720.0,15683.03027,87.80095795,-12.19904205,289.2547964,241.1365876,0.034549292,3014400,1,0.0
BSESN,7/23/2007,15732.2002,15773.37012,15477.91016,15560.57031,13400,166.65039,0.0,166.65039,89.64567545,14731.21973,15773.37012,96.04952199,-3.9504780110000004,310.0661702,254.92250409999997,0.048122991,3027800,1,0.0
BSESN,7/24/2007,15794.919919999998,15868.84961,15742.32031,15802.19043,22200,62.719727,0.0,62.719727,90.57750735,14731.21973,15868.84961,93.50142888,-6.498571123,327.84114300000005,269.5062319,0.059306709000000006,3050000,1,0.0
BSESN,7/25/2007,15699.330080000002,15771.259769999999,15572.980469999999,15711.87012,25200,-95.589844,95.589844,0.0,78.20135667,14826.55957,15868.84961,83.73585809999999,-16.2641419,330.40592180000004,281.6861698,0.040239095,3024800,-1,-0.0516
BSESN,7/26/2007,15776.30957,15812.269530000001,15654.40039,15768.28027,17000,76.97949200000001,0.0,76.97949200000001,80.65717542,14829.549809999999,15868.84961,91.09592452,-8.904075479,334.7908683,292.3071095,0.032973161,3041800,1,0.0
BSESN,7/27/2007,15234.57031,15495.509769999999,15159.67969,15487.759769999999,30200,-541.7392570000001,541.7392570000001,0.0,42.12284971,14829.549809999999,15868.84961,38.97051712,-61.02948288,291.19542,292.0847716,-0.005006095,3011600,-1,-0.6908
BSESN,7/30/2007,15260.91016,15451.80957,15135.25,15278.03027,20400,26.339843,0.0,26.339843,43.63361067,14829.549809999999,15868.84961,41.50490064,-58.49509936,255.82215970000001,284.83224920000004,-0.001890811,3032000,1,0.5423
BSESN,7/31/2007,15550.990230000001,15568.84961,15224.82031,15358.69043,18200,290.08007799999996,0.0,290.08007799999996,57.67325516,14963.53027,15868.84961,64.88980602,-35.11019398,248.3330057,277.5324005,0.016326877,3050200,1,-0.4939
BSESN,8/1/2007,14935.769530000001,15344.019530000001,14910.519530000001,15344.019530000001,22800,-615.2207030000001,615.2207030000001,0.0,35.83230319,14910.519530000001,15868.84961,2.634791559,-97.36520844,190.55799419999997,260.1375193,-0.039508374,3027400,-1,0.0
BSESN,8/2/2007,14985.7002,15134.53027,14896.46973,15022.87012,14400,49.930664,0.0,49.930664,38.02997617,14896.46973,15868.84961,9.176502893,-90.82349711,147.1041436,237.53084410000002,-0.037252112000000004,3041800,1,0.0
BSESN,8/3/2007,15138.40039,15235.509769999999,15061.12988,15061.12988,11400,152.700196,0.0,152.700196,44.71185776,14896.46973,15868.84961,24.88026218,-75.11973782,123.56391570000001,214.73745840000004,-0.037744231,3053200,1,0.0
BSESN,8/6/2007,14903.03027,14928.799809999999,14705.580080000002,14892.59961,15600,-235.37011800000002,235.37011800000002,0.0,37.51724132,14705.580080000002,15868.84961,16.97372705,-83.02627295,84.93661755,188.7772903,-0.056466867000000004,3037600,-1,0.0
BSESN,8/7/2007,14932.769530000001,15142.04004,14901.830080000002,15038.03027,14000,29.739258000000003,0.0,29.739258000000003,38.94943363,14705.580080000002,15868.84961,19.53025047,-80.46974953,56.07748869,162.23732990000002,-0.048827595999999994,3051600,1,-0.5719
BSESN,8/8/2007,15307.980469999999,15340.240230000001,15088.07031,15088.07031,17200,375.210938,0.0,375.210938,54.22408865,14705.580080000002,15868.84961,51.78510869,-48.21489131,62.75935727,142.3417354,-0.029685593,3068800,1,0.0
BSESN,8/9/2007,15100.15039,15542.40039,15062.09961,15452.44043,16400,-207.83007800000001,207.83007800000001,0.0,46.74872535,14705.580080000002,15868.84961,33.91907915,-66.08092085,50.70019558,124.0134274,-0.008823348,3052400,-1,0.0
BSESN,8/10/2007,14868.25,14901.30957,14570.88965,14674.919919999998,16400,-231.900391,231.900391,0.0,39.70191636,14570.88965,15868.84961,22.90982472,-77.09017528,22.17517793,103.64577750000001,-0.025729798999999998,3036000,-1,0.0
BSESN,8/13/2007,15017.20996,15044.740230000001,14869.15039,14965.65039,9400,148.95996100000002,0.0,148.95996100000002,45.76154502,14570.88965,15812.269530000001,35.95356418,-64.04643582,11.45665469,85.20795297,-0.03432452,3045400,1,-0.5574
BSESN,8/14/2007,15000.91016,15069.63965,14964.66016,15066.70996,9600,-16.299805,16.299805,0.0,45.18818402,14570.88965,15812.269530000001,34.64052494,-65.35947506,1.62812178,68.49198673,0.004361384,3035800,-1,0.0
BSESN,8/16/2007,14358.20996,14584.919919999998,14345.03027,14584.919919999998,21800,-642.700195,642.700195,0.0,28.78164396,14345.03027,15568.84961,1.076930852,-98.92306915,-57.36038106,43.32151317,-0.0418726,3014000,-1,0.0
BSESN,8/17/2007,14141.519530000001,14318.55957,13779.87988,14309.37012,32400,-216.69043,216.69043,0.0,25.21952641,13779.87988,15568.84961,20.21496746,-79.78503254,-120.20861119999999,10.61548829,-0.06585113599999999,2981600,-1,-0.4767
BSESN,8/20/2007,14427.549809999999,14680.08984,14406.91016,14512.28027,12400,286.030274,0.0,286.030274,37.07998878,13779.87988,15568.84961,36.20351494,-63.79648506,-145.2615491,-20.55991919,-0.031904952,2994000,1,0.0
BSESN,8/21/2007,13989.11035,14534.509769999999,13941.92969,14512.19043,15800,-438.439453,438.439453,0.0,28.95704888,13779.87988,15542.40039,11.87109415,-88.12890585,-198.209744,-56.08988414,-0.06319384900000001,2978200,-1,0.0
BSESN,8/22/2007,14248.66016,14281.480469999999,13870.7002,14055.40039,19400,259.549804,0.0,259.549804,38.2038969,13779.87988,15542.40039,26.59715282,-73.40284718,-216.72974419999997,-88.21785616,-0.069200527,2997600,1,0.0
BSESN,8/23/2007,14163.980469999999,14554.92969,14128.71973,14458.330080000002,17800,-84.679687,84.679687,0.0,36.41941504,13779.87988,15542.40039,21.79268748,-78.20731252,-235.5249361,-117.67927209999999,-0.061997391,2979800,-1,-0.3818
BSESN,8/24/2007,14424.87012,14455.490230000001,14163.61035,14237.259769999999,10400,260.889648,0.0,260.889648,45.47337554,13779.87988,15542.40039,36.59476477,-63.40523523,-226.7547591,-139.4943695,-0.029820582999999998,2990200,1,0.0
BSESN,8/27/2007,14842.37988,14858.92969,14581.34961,14581.34961,11600,417.509766,0.0,417.509766,56.82595426,13779.87988,15542.40039,60.28298651,-39.71701349,-183.9938156,-148.3942587,-0.011641981000000001,3001800,1,-0.6908
BSESN,8/28/2007,14919.19043,14952.04004,14751.67969,14841.61035,14200,76.810547,0.0,76.810547,58.6533329,13779.87988,15542.40039,64.64098102,-35.35901898,-142.26751919999998,-147.1689108,-0.0054476509999999995,3016000,1,-0.7906
BSESN,8/29/2007,14993.04004,15029.53027,14592.11035,14651.490230000001,17400,73.849609,0.0,73.849609,60.50769086,13779.87988,15542.40039,68.83098100000001,-31.169019,-102.0635572,-138.1478401,0.044213734000000005,3033400,1,0.0
BSESN,8/30/2007,15121.740230000001,15200.80957,15053.980469999999,15168.69043,18400,128.700195,0.0,128.700195,63.77465596,13779.87988,15200.80957,94.43538011,-5.564619891,-59.13492699,-122.3452575,0.06931509,3051800,1,0.0
BSESN,8/31/2007,15318.59961,15350.91016,15131.36035,15131.36035,14400,196.859375,0.0,196.859375,68.38978845,13779.87988,15350.91016,97.943353,-2.056647001,-9.123600694,-99.70092613,0.061760300000000004,3066200,1,-0.5106
BSESN,9/3/2007,15422.049809999999,15427.16016,15323.049809999999,15401.990230000001,15000,103.45019599999999,0.0,103.45019599999999,70.65655055,13779.87988,15427.16016,99.6897704,-0.3102296,38.4154723,-72.07764644,0.10243249300000001,3081200,1,0.5267
BSESN,9/4/2007,15465.40039,15521.480469999999,15389.62012,15482.12988,13400,43.350586,0.0,43.350586,71.63987808,13779.87988,15521.480469999999,96.77996904,-3.2200309560000004,78.68156801,-41.92580355,0.085393309,3094600,1,-0.4767
BSESN,9/5/2007,15446.15039,15580.86035,15407.0,15535.34961,16200,-19.25,19.25,0.0,70.43058383,13779.87988,15580.86035,92.52018757,-7.479812431,107.79681029999999,-11.98128078,0.090523277,3078400,-1,0.0
BSESN,9/6/2007,15616.30957,15637.740230000001,15350.17969,15383.17969,11200,170.159179,0.0,170.159179,74.77371547,13870.7002,15637.740230000001,98.78719986,-1.212800136,142.9533955,19.00565448,0.0825962,3089600,1,0.2263
BSESN,9/7/2007,15590.419919999998,15716.05957,15565.21973,15655.37012,14000,-25.889648,25.889648,0.0,72.89409037,13870.7002,15716.05957,93.19158915,-6.808410855,166.803359,48.56519539,0.050398927999999996,3075600,-1,-0.7003
BSESN,9/10/2007,15596.830080000002,15626.28027,15363.53027,15413.580080000002,11200,6.410156,0.0,6.410156,73.08736235,13870.7002,15716.05957,93.53895541,-6.461044587000001,184.0996864,75.67209359,0.045420672,3086800,1,-0.1531
BSESN,9/11/2007,15542.769530000001,15698.980469999999,15506.09961,15668.40039,12000,-54.060547,54.060547,0.0,68.34523823,14128.71973,15716.05957,89.08299065,-10.91700935,191.2404156,98.785758,0.036665646,3074800,-1,0.0
BSESN,9/12/2007,15505.36035,15661.44043,15486.80957,15608.5,13200,-37.409178999999995,37.409178999999995,0.0,64.9789672,14163.61035,15716.05957,86.42794782,-13.57205218,191.67141809999998,117.36289,0.025368781,3061600,-1,-0.802
BSESN,9/13/2007,15614.44043,15650.13965,15547.66016,15547.66016,13400,109.080078,0.0,109.080078,69.9574084,14581.34961,15716.05957,91.0444833,-8.955516695,198.5263531,133.5955826,0.019312523999999998,3075000,1,-0.34
BSESN,9/14/2007,15603.799809999999,15824.65039,15568.36035,15713.66016,13400,-10.640625,10.640625,0.0,68.85568184,14592.11035,15824.65039,82.08167045,-17.91832955,200.78579530000002,147.0336252,0.011785074,3061600,-1,0.0
BSESN,9/17/2007,15504.42969,15726.05957,15467.45996,15664.740230000001,9400,-99.37011700000001,99.37011700000001,0.0,58.86620554,14592.11035,15824.65039,74.01944822,-25.98055178,192.34089550000002,156.0950792,0.002523653,3052200,-1,0.0
BSESN,9/18/2007,15669.12012,15691.87988,15468.799809999999,15547.07031,12200,164.690429,0.0,164.690429,67.79973139,15053.980469999999,15824.65039,79.81882132,-20.18117868,196.6703,164.21012340000001,0.014435294,3064400,1,0.0
BSESN,9/19/2007,16322.75,16335.299809999999,15940.79004,15940.79004,22800,653.6298830000001,0.0,653.6298830000001,83.85603881,15131.36035,16335.299809999999,98.95760497,-1.042395028,249.9624417,181.3605871,0.045237348,3087200,1,0.0
BSESN,9/20/2007,16347.9502,16415.88086,16261.36035,16341.549809999999,21600,25.200195,0.0,25.200195,84.2063773,15323.049809999999,16415.88086,93.78397386,-6.2160261420000005,290.8772414,203.2639179,0.048589472,3108800,1,0.0
BSESN,9/21/2007,16564.23047,16616.83984,16308.08984,16352.32031,92400,216.28027400000002,0.0,216.28027400000002,87.00007551,15350.17969,16616.83984,95.84660694,-4.153393059,336.871283,229.9853909,0.062025449,3201200,1,-0.7096
BSESN,9/24/2007,16845.83008,16869.64063,16599.66016,16697.89063,21200,281.599609,0.0,281.599609,89.72940703,15350.17969,16869.64063,98.43296090000001,-1.567039101,391.5312983,262.2945724,0.083837089,3222400,1,0.0
BSESN,9/25/2007,16899.53906,16928.01953,16676.98047,16890.75,18800,53.708985,0.0,53.708985,90.18299076,15350.17969,16928.01953,98.19497092,-1.80502908,434.17867889999997,296.6713937,0.08991591800000001,3241200,1,0.5106
BSESN,9/26/2007,16921.39063,17073.86914,16887.07031,16969.44922,16400,21.851562,0.0,21.851562,90.38238508,15363.53027,17073.86914,91.08489441,-8.915105588,464.38710819999994,330.21453660000003,0.083701379,3257600,1,0.0
BSESN,9/27/2007,17150.56055,17188.40039,17018.56055,17059.60938,19000,229.169922,0.0,229.169922,92.27988016,15363.53027,17188.40039,97.92643632,-2.073563681,501.04388150000005,364.3804056,0.09912718400000001,3276600,1,-0.3818
BSESN,9/28/2007,17291.09961,17361.4707,17152.31055,17152.31055,22600,140.539062,0.0,140.539062,93.22561711,15467.45996,17361.4707,96.28454620000001,-3.715453795,535.2647672,398.5572779,0.115236094,3299200,1,0.0
BSESN,10/1/2007,17328.61914,17425.33984,17144.58008,17356.99023,22200,37.519532,0.0,37.519532,93.47195856,15467.45996,17425.33984,95.05992662,-4.940073384,558.9691301,430.6396483,0.10590888400000001,3321400,1,0.0
BSESN,10/3/2007,17847.03906,17953.07031,17288.41016,17467.41016,32800,518.4199219999999,0.0,518.4199219999999,95.86767143,15467.45996,17953.07031,95.73419664,-4.265803364,612.5263413,467.0169869,0.093384329,3354200,1,0.0
BSESN,10/4/2007,17777.14063,17890.49023,17494.69922,17799.63086,20800,-69.898438,69.898438,0.0,90.68988187,15467.45996,17953.07031,92.92207293,-7.0779270720000005,641.9308182999999,501.9997532,0.08742321900000001,3333400,-1,-0.4404
BSESN,10/5/2007,17773.35938,17979.17969,17708.80078,17831.67969,20000,-3.78125,3.78125,0.0,90.3851729,15467.45996,17979.17969,91.80560192,-8.194398077,657.3514248,533.0700875,0.072996383,3313400,-1,0.0
BSESN,10/8/2007,17491.39063,17982.58984,17322.14063,17901.93945,20400,-281.96875,281.96875,0.0,70.11523964,15468.799809999999,17982.58984,80.4598152,-19.5401848,639.4486787000001,554.3458057999999,0.038321682,3293000,-1,0.2023
BSESN,10/9/2007,18280.24023,18327.41992,17287.18945,17402.24023,25600,788.849609,0.0,788.849609,82.66474322,15940.79004,18327.41992,98.02316696,-1.9768330369999998,681.0633202,579.6893086,0.081700522,3318600,1,0.5994
BSESN,10/10/2007,18658.25,18703.66992,18436.99023,18473.42969,26000,378.009766,0.0,378.009766,85.93128315,16261.36035,18703.66992,98.14028809,-1.8597119119999999,736.0606038,610.9635677,0.10264282699999999,3344600,1,-0.5106
BSESN,10/11/2007,18814.07031,18832.65039,18536.9707,18696.61914,35400,155.820313,0.0,155.820313,87.08847212,16308.08984,18832.65039,99.26402724,-0.7359727629999999,783.1915991000001,645.409174,0.096994484,3380000,1,0.0
BSESN,10/12/2007,18419.03906,18844.61914,18336.0,18794.63086,30000,-395.03125,395.03125,0.0,70.19837506,16599.66016,18844.61914,81.04285732,-18.95714268,779.6798677999999,672.2633127,0.065232373,3350000,-1,0.4215
BSESN,10/15/2007,19058.66992,19095.75,18525.60938,18525.60938,22800,639.630859,0.0,639.630859,78.12469305,16676.98047,19095.75,98.46698590000001,-1.5330141019999999,819.0679547,701.6242411000001,0.099837775,3372800,1,0.0
BSESN,10/16/2007,19051.85938,19174.44922,18777.75,19102.92969,27400,-6.810547,6.810547,0.0,77.87024240000001,16887.07031,19174.44922,94.64059742,-5.359402576,840.0501676000001,729.3094264,0.067508134,3345400,-1,0.4019
BSESN,10/17/2007,18715.82031,18841.28906,17307.90039,18037.90039,36800,-336.039062,336.039062,0.0,65.68966288,17018.56055,19174.44922,78.72668881,-21.27331119,820.1094672,747.4694346,0.052802625,3308600,-1,0.5267
BSESN,10/18/2007,17998.39063,19198.66016,17771.16016,18827.46094,41600,-717.4296879999999,717.4296879999999,0.0,47.41802822,17144.58008,19198.66016,41.56656579,-58.43343421,737.9095762000001,745.5574629,0.012661155,3267000,-1,0.3612
BSESN,10/19/2007,17559.98047,18031.76953,17226.17969,18031.76953,35400,-438.410156,438.410156,0.0,39.64308865,17144.58008,19198.66016,20.22318387,-79.77681613,630.1258363,722.4711376,0.003921349,3231600,-1,0.4019
BSESN,10/22/2007,17613.99023,17704.83008,17171.44922,17259.65039,78400,54.009765,0.0,54.009765,41.01780794,17171.44922,19198.66016,21.83004279,-78.16995721,542.8074363,686.5383972999999,-0.036446458,3310000,1,0.4144
BSESN,10/23/2007,18492.83984,18542.41016,17910.30078,17910.30078,21600,878.84961,0.0,878.84961,58.68549671,17171.44922,19198.66016,65.18269021,-34.81730979,538.3174058999999,656.8941990000001,-0.008865256,3331600,1,-0.3724
BSESN,10/24/2007,18512.91016,18832.49023,18317.16992,18727.90039,25200,20.070312,0.0,20.070312,59.00904147,17171.44922,19198.66016,66.17273578,-33.82726422,530.2659551,631.5685502,-0.016007177,3356800,1,-0.29600000000000004
BSESN,10/25/2007,18770.89063,18900.09961,18459.50977,18519.23047,23200,257.98046899999997,0.0,257.98046899999997,63.27462707,17171.44922,19198.66016,78.89861764,-21.10138236,538.49456,612.9537522,0.019102601,3380000,1,-0.4215
BSESN,10/26/2007,19243.16992,19276.44922,18629.5293,18823.66016,23200,472.279297,0.0,472.279297,69.89258551,17171.44922,19276.44922,98.41903577,-1.580964228,576.4794843,605.6588986,0.009680634,3403200,1,0.0
BSESN,10/29/2007,19977.66992,20024.86914,19621.39063,19621.39063,20600,734.5,0.0,734.5,77.24942137,17171.44922,20024.86914,98.34587196,-1.6541280390000002,658.2627785,616.1796746,0.048594236,3423800,1,0.0
BSESN,10/30/2007,19783.50977,20238.16016,19694.84961,20103.43945,20600,-194.160156,194.160156,0.0,71.89132740000001,17171.44922,20238.16016,85.17465782,-14.82534218,699.3478794,632.8133155,0.05704743,3403200,-1,-0.6908
BSESN,10/31/2007,19837.99023,19984.13086,19735.21094,19827.40039,31000,54.480468,0.0,54.480468,72.50868838,17171.44922,20238.16016,86.95116918,-13.04883082,727.9133048,651.8333134,0.10220911699999999,3434200,1,0.0
BSESN,11/1/2007,19724.34961,20204.21094,19634.4707,20130.23047,26000,-113.640625,113.640625,0.0,68.86821104,17171.44922,20238.16016,83.24555012,-16.75444988,732.9329666,668.0532440000001,0.12325578300000001,3408200,-1,0.0
BSESN,11/2/2007,19976.23047,20025.63086,19255.76953,19364.60938,19200,251.88086,0.0,251.88086,72.41077170000001,17171.44922,20238.16016,91.45893785,-8.541062147,748.6062976,684.1638547,0.13411159,3427400,1,0.2023
BSESN,11/5/2007,19590.7793,20009.34961,19502.44922,20009.34961,19000,-385.45117200000004,385.45117200000004,0.0,60.29580034,17171.44922,20238.16016,78.89005934,-21.10994066,721.6066053999999,691.6524049,0.059371057000000005,3408400,-1,0.3818
BSESN,11/6/2007,19400.66992,19919.33984,19337.84961,19689.78906,18000,-190.109375,190.109375,0.0,55.053893200000005,17171.44922,20238.16016,72.69093008,-27.30906992,677.0641431,688.7347525,0.04795355,3390400,-1,0.0
BSESN,11/7/2007,19289.83008,19678.5,19249.4707,19552.5293,13600,-110.839844,110.839844,0.0,52.01198592,17171.44922,20238.16016,69.07663952,-30.92336048,625.6084469,676.1094914,0.027645969,3376800,-1,0.0
BSESN,11/8/2007,19058.92969,19209.91016,18917.40039,19110.40039,16400,-230.90039,230.90039,0.0,45.91408283,17171.44922,20238.16016,61.54738767,-38.45261233,559.7453097,652.8366551,-0.009574318,3360400,-1,0.29600000000000004
BSESN,11/12/2007,18737.26953,18815.10938,18333.21094,18640.51953,22800,-321.66015699999997,321.66015699999997,0.0,38.63356349,17910.30078,20238.16016,35.52485854,-64.47514146,476.10477310000005,617.4902787000001,-0.062089343,3337600,-1,0.0
BSESN,11/13/2007,19035.48047,19210.48047,18636.21094,18681.09961,23200,298.210938,0.0,298.210938,47.53325187,18317.16992,20238.16016,37.39272248,-62.60727752,428.9376494,579.7797528,-0.037810748,3360800,1,0.5106
BSESN,11/14/2007,19929.06055,19987.71094,19336.96094,19336.96094,20800,893.580078,0.0,893.580078,65.05525051,18333.21094,20238.16016,83.7738662,-16.226133800000003,458.3779132,555.4993849,0.004590703,3381600,1,0.0
BSESN,11/15/2007,19784.89063,19967.08008,19723.19922,19947.7207,19200,-144.16992199999999,144.16992199999999,0.0,61.247430099999995,18333.21094,20238.16016,76.20568954,-23.79431046,464.71923250000003,537.3433544,0.0030693540000000003,3362400,-1,-0.8689
BSESN,11/16/2007,19698.35938,19838.0293,19472.50977,19603.08984,19000,-86.53125,86.53125,0.0,58.86142643,18333.21094,20238.16016,71.66324562,-28.33675438,457.48877910000004,521.3724394,-0.013910087,3343400,-1,-0.5267
BSESN,11/19/2007,19633.35938,19971.43945,19583.9707,19895.49023,12600,-65.0,65.0,0.0,56.93886456,18333.21094,20238.16016,68.25108117,-31.74891883,441.4251615,505.38298380000003,0.002173475,3330800,-1,0.7184
BSESN,11/20/2007,19280.80078,19714.2207,19196.41992,19510.93945,14400,-352.55859399999997,352.55859399999997,0.0,47.27507203,18333.21094,20204.21094,50.64617012,-49.35382988,395.6848876,483.44336460000005,-0.006178608,3316400,-1,-0.1779
BSESN,11/21/2007,18602.61914,19218.88086,18515.30078,19197.57031,16600,-678.18164,678.18164,0.0,34.33928898,18333.21094,20204.21094,14.39915569,-85.60084431,301.2393013,447.00255189999996,-0.035625557,3299800,-1,0.0
BSESN,11/22/2007,18526.32031,18744.55078,18182.83008,18724.10938,19800,-76.298828,76.298828,0.0,33.16137704,18182.83008,20025.63086,18.63957507,-81.36042493,217.72402889999998,401.14684730000005,-0.027945398,3280000,-1,0.4019
BSESN,11/23/2007,18852.86914,18910.46094,18548.06055,18737.2207,14000,326.54882799999996,0.0,326.54882799999996,42.84339952,18182.83008,20009.34961,36.68392545,-63.31607455,175.8601291,356.0895037,0.006169501,3294000,1,-0.2023
BSESN,11/26/2007,19247.53906,19360.23047,19137.66016,19171.25,11400,394.66992200000004,0.0,394.66992200000004,52.44913866,18182.83008,19987.71094,58.99054107,-41.00945893,172.5403138,319.3796657,0.011140176000000002,3305400,1,0.1779
BSESN,11/27/2007,19127.73047,19211.58008,19019.33008,19128.85938,8800,-119.808594,119.808594,0.0,49.53329987,18182.83008,19987.71094,52.35250769,-47.64749231,158.4156669,287.1868659,-0.040209125,3296600,-1,0.0
BSESN,11/28/2007,18938.86914,19316.75977,18884.19922,19316.75977,11000,-188.86132800000001,188.86132800000001,0.0,44.98455527,18182.83008,19987.71094,41.88858554,-58.11141446,130.4781804,255.84512880000003,-0.042760989000000006,3285600,-1,0.0
BSESN,11/29/2007,19003.25977,19297.00977,18930.31055,19290.66992,13400,64.390625,0.0,64.390625,46.90275484,18182.83008,19987.71094,45.45616867,-54.54383133,112.23947949999999,227.1239989,-0.035287183,3299000,1,0.0
BSESN,11/30/2007,19363.18945,19424.99023,19006.89063,19136.11914,13800,359.929687,0.0,359.929687,56.6510868,18182.83008,19987.71094,65.39818783,-34.60181217,125.38315630000001,206.7758304,-0.013760759,3312800,1,-0.4588
BSESN,12/3/2007,19603.41016,19619.43945,19446.67969,19547.08984,12800,240.220703,0.0,240.220703,62.02073191,18182.83008,19987.71094,78.70769254,-21.29230746,153.414946,196.10365349999998,0.016732156,3325600,1,-0.5423
BSESN,12/4/2007,19529.5,19707.85938,19482.33984,19707.58984,14400,-73.910156,73.910156,0.0,59.408235999999995,18182.83008,19971.43945,75.29144937,-24.70855063,167.7328891,190.4295007,0.049825287999999995,3311200,-1,0.3182
BSESN,12/5/2007,19738.07031,19790.91992,19560.67969,19628.84961,14600,208.570313,0.0,208.570313,64.30413969,18182.83008,19971.43945,86.95248145,-13.04751855,193.67725249999998,191.079051,0.06540694400000001,3325800,1,0.0
BSESN,12/6/2007,19795.86914,20064.31055,19716.57031,20018.16992,14800,57.798828,0.0,57.798828,65.62968007,18182.83008,20064.31055,85.73243728,-14.26756272,216.4076175,196.14476430000002,0.050018912,3340600,1,0.0772
BSESN,12/7/2007,19966.0,20094.56055,19706.42969,20063.5,14800,170.13085900000002,0.0,170.13085900000002,69.47901439,18182.83008,20094.56055,93.27517403,-6.724825967,245.3218168,205.98017480000001,0.037327418,3355400,1,0.0
BSESN,12/10/2007,19930.67969,20095.68945,19834.00977,20074.91992,10200,-35.320312,35.320312,0.0,67.66371916,18182.83008,20095.68945,91.37365939,-8.626340606,262.3621268,217.25656519999998,0.04197828,3345200,-1,-0.4767
BSESN,12/11/2007,20290.89063,20333.06055,20019.33984,20049.34961,11600,360.210937,0.0,360.210937,75.26766490000001,18182.83008,20333.06055,98.03881851,-1.961181492,301.4576908,234.09679029999998,0.07138871200000001,3356800,1,0.0
BSESN,12/12/2007,20375.86914,20419.10938,20045.41992,20197.43945,14800,84.978516,0.0,84.978516,76.75554671,18548.06055,20419.10938,97.68898420000001,-2.311015798,335.43161610000004,254.36375550000002,0.07223020599999999,3371600,1,-0.3182
BSESN,12/13/2007,20104.39063,20498.10938,20065.63086,20498.10938,17000,-271.478516,271.478516,0.0,62.8239005,18884.19922,20498.10938,75.60466743,-24.39533257,336.5703755,270.8050795,0.038278877999999995,3354600,-1,-0.5859
BSESN,12/14/2007,20030.83008,20171.57031,19936.49023,20108.08984,14800,-73.560547,73.560547,0.0,59.45022314,18884.19922,20498.10938,71.046759,-28.953241,327.75892830000004,282.1958493,0.021803345,3339800,-1,0.2023
BSESN,12/17/2007,19261.34961,20032.66992,19177.18945,20032.66992,15400,-769.4804690000001,769.4804690000001,0.0,36.070761100000006,18884.19922,20498.10938,23.36873516,-76.63126484,255.73717090000002,276.9041136,-0.01373053,3324400,-1,0.1779
BSESN,12/18/2007,19079.64063,19375.07031,19009.34961,19339.14063,15200,-181.70898400000002,181.70898400000002,0.0,32.57971915,18930.31055,20498.10938,9.524823934,-90.47517607,181.9001809,257.90332709999996,-0.033358362,3309200,-1,0.4939
BSESN,12/19/2007,19091.96094,19397.75977,18886.40039,19255.39063,12600,12.320313,0.0,12.320313,33.08636864,18886.40039,20498.10938,12.7541975,-87.2458025,122.96056770000001,230.91477519999998,-0.035558337999999995,3321800,1,-0.7845
BSESN,12/20/2007,19162.57031,19291.14063,19097.69922,19210.2207,11400,70.609375,0.0,70.609375,36.25416599,18886.40039,20498.10938,17.135222600000002,-82.86477740000001,81.01420476,200.9346611,-0.040239892,3333200,1,0.0
BSESN,12/24/2007,19854.11914,19879.0,19308.19922,19308.19922,12200,691.5488280000001,0.0,691.5488280000001,58.47168269,18886.40039,20498.10938,60.04302015,-39.95697985,102.3932947,181.2263878,-0.003841341,3345400,1,0.0
BSESN,12/26/2007,20192.51953,20211.4707,19896.60938,19940.96094,12000,338.40039,0.0,338.40039,65.30020232,18886.40039,20498.10938,81.03939067,-18.96060933,144.9713216,173.9753746,-0.004848042,3357400,1,-0.2263
BSESN,12/27/2007,20216.7207,20323.75977,20159.73047,20301.05078,13200,24.201172,0.0,24.201172,65.76472772,18886.40039,20498.10938,82.54097515,-17.45902485,178.6086576,174.90203119999998,-0.007810633000000001,3370600,1,0.0
BSESN,12/28/2007,20206.94922,20259.44922,20022.88086,20158.11914,10600,-9.771484,9.771484,0.0,65.35711527,18886.40039,20498.10938,81.93469424,-18.06530576,202.14777790000002,180.3511805,0.005101303,3360000,-1,-0.5994
BSESN,12/31/2007,20286.99023,20484.2793,20239.63086,20323.2793,10400,80.041015,0.0,80.041015,67.27421392,18886.40039,20498.10938,86.9009143,-13.099085699999998,224.6714685,189.2152381,0.012788295,3370400,1,-0.6249
BSESN,1/2/2008,20465.30078,20529.48047,20077.40039,20393.09961,20600,178.31054699999999,0.0,178.31054699999999,71.34963857,18886.40039,20529.48047,96.09394035,-3.9060596530000002,253.9820792,202.16860630000002,0.062506065,3391000,1,0.0
BSESN,1/3/2008,20345.19922,20519.69922,20293.86914,20383.0293,20600,-120.10156200000002,120.10156200000002,0.0,65.05351717,18886.40039,20529.48047,88.78440239,-11.21559761,264.4710988,214.6291048,0.066330316,3370400,-1,-0.6697
BSESN,1/4/2008,20686.89063,20762.80078,20367.93945,20367.93945,18600,341.69140600000003,0.0,341.69140600000003,72.90292699,18886.40039,20762.80078,95.95447984,-4.0455201569999995,296.9325101,231.0897859,0.083539333,3389000,1,0.0
BSESN,1/7/2008,20812.65039,20861.83008,20438.18945,20637.21094,17600,125.75976599999998,0.0,125.75976599999998,75.26255699,18886.40039,20861.83008,97.5104309,-2.489569096,329.0135116,250.674531,0.08610953800000001,3406600,1,0.0
BSESN,1/8/2008,20873.33008,21077.5293,20696.59961,20970.07031,22800,60.679687,0.0,60.679687,76.40639708,18886.40039,21077.5293,90.68063871,-9.319361286,355.2393024,271.5874853,0.051334986,3429400,1,-0.7096
BSESN,1/9/2008,20869.7793,21113.13086,20701.49023,20903.0,22200,-3.5507809999999997,3.5507809999999997,0.0,76.1685954,18886.40039,21113.13086,89.07135078,-10.92864922,371.45501010000004,291.5609903,0.033540132,3407200,-1,0.0
BSESN,1/10/2008,20582.08008,21206.76953,20530.07031,20930.2793,21200,-287.69921899999997,287.69921899999997,0.0,59.0010674,18886.40039,21206.76953,73.07801409,-26.92198591,356.9761539,304.644023,0.018072138,3386000,-1,0.2732
BSESN,1/11/2008,20827.44922,20894.78906,20505.81055,20702.93945,18200,245.369141,0.0,245.369141,66.44381882,19097.69922,21206.76953,82.01480957,-17.98519043,361.137823,315.942783,0.030707257999999998,3404200,1,0.0
BSESN,1/14/2008,20728.05078,20959.2207,20661.90039,20918.23047,16800,-99.398438,99.398438,0.0,61.24682646,19308.19922,21206.76953,74.78530308,-25.21469692,352.3536391,323.2249542,0.021741054,3387400,-1,0.0
BSESN,1/15/2008,20251.08984,20872.92969,20203.63086,20836.4707,19400,-476.960937,476.960937,0.0,42.73847691,19896.60938,21206.76953,27.05626998,-72.94373002,303.4078517,319.2615337,-0.010467031,3368000,-1,0.0
BSESN,1/16/2008,19868.10938,20079.89063,19513.25,20079.89063,24600,-382.98046899999997,382.98046899999997,0.0,33.38997673,19513.25,21206.76953,20.95395822,-79.04604178,231.0512248,301.61947189999995,-0.02344975,3343400,-1,-0.1531
BSESN,1/17/2008,19700.82031,20026.11914,19643.75977,19972.75,20200,-167.289062,167.289062,0.0,30.07440265,19513.25,21206.76953,11.075769099999999,-88.9242309,158.383501,272.97227769999995,-0.047666434,3323200,-1,0.0
BSESN,1/18/2008,19013.69922,19715.7793,18930.41992,19579.60938,28000,-687.1210940000001,687.1210940000001,0.0,20.45036482,18930.41992,21206.76953,3.658458115,-96.34154188,44.83208024,227.34423819999998,-0.086435468,3295200,-1,0.0
BSESN,1/21/2008,17605.34961,18919.57031,16951.5,18919.57031,35800,-1408.34961,1408.34961,0.0,11.64064081,16951.5,21206.76953,15.36564498,-84.63435502,-156.99059240000003,150.4772721,-0.156562487,3259400,-1,-0.6808
BSESN,1/22/2008,16729.93945,17068.57031,15332.419919999998,16884.08984,30600,-875.410156,875.410156,0.0,8.893006828999999,15332.419919999998,21206.76953,23.79020018,-76.20979982,-383.1579912,43.75021944,-0.19836529100000003,3228800,-1,-0.3818
BSESN,1/23/2008,17594.07031,17997.10938,16951.0293,17520.01953,22000,864.13086,0.0,864.13086,28.19676409,15332.419919999998,21206.76953,38.50043905,-61.49956095,-487.0546825,-62.41076094,-0.145175306,3250800,1,0.0
BSESN,1/24/2008,17221.74023,18185.09961,17070.05078,17920.98047,22800,-372.330079,372.330079,0.0,25.50962178,15332.419919999998,21206.76953,32.16220412,-67.83779588,-592.6062881,-168.44986640000002,-0.173122928,3228000,-1,0.2023
BSESN,1/25/2008,18361.66016,18406.25,17504.0,17504.0,15200,1139.919922,0.0,1139.919922,44.27106582,15332.419919999998,21206.76953,51.56724464,-48.43275536,-577.616284,-250.28314989999998,-0.114163683,3243200,1,-0.7783
BSESN,1/28/2008,18152.7793,18213.21094,17443.28906,18011.89063,12400,-208.88085900000002,208.88085900000002,0.0,42.03272685,15332.419919999998,21206.76953,48.01143212,-51.98856788,-575.9523177,-315.4169835,-0.10361469699999999,3230800,-1,0.0
BSESN,1/29/2008,18091.93945,18491.06055,17927.91992,18346.49023,14800,-60.83984399999999,60.83984399999999,0.0,41.33044203,15332.419919999998,21206.76953,46.97574565,-53.02425435,-572.938402,-366.9212672,-0.089398034,3216000,-1,0.0
BSESN,1/30/2008,17758.64063,18129.17969,17683.50977,18120.2207,13400,-333.29882799999996,333.29882799999996,0.0,37.382361100000004,15332.419919999998,20959.2207,43.11900843,-56.88099157,-590.6358002000001,-411.6641738,-0.098583696,3202600,-1,0.0
BSESN,1/31/2008,17648.71094,18008.71094,17417.63086,17810.13086,16800,-109.92968700000002,109.92968700000002,0.0,36.07105537,15332.419919999998,20959.2207,41.16532833,-58.83467167,-606.5397106,-450.63928110000006,-0.071789727,3185800,-1,-0.29600000000000004
BSESN,2/1/2008,18242.58008,18312.40039,17534.96094,17820.66992,14800,593.86914,0.0,593.86914,47.54142453,15332.419919999998,20872.92969,52.52513359,-47.47486641,-564.7137293999999,-473.45417080000004,0.036195275,3200600,1,0.0
BSESN,2/4/2008,18660.32031,18895.33984,18447.25,18496.0293,17400,417.740235,0.0,417.740235,54.20974386,15332.419919999998,20079.89063,70.0983871,-29.901612899999996,-492.1845945,-477.20025549999997,0.115384808,3218000,1,0.0
BSESN,2/5/2008,18663.16016,18729.83008,18509.53906,18592.58008,19000,2.839843,0.0,2.839843,54.25535554,15332.419919999998,20026.11914,70.96194448,-29.03805552,-429.5242924,-467.66506289999995,0.060764213,3237000,1,0.0772
BSESN,2/6/2008,18139.49023,18274.15039,17936.00977,18247.0293,16400,-523.6699219999999,523.6699219999999,0.0,44.76733785,15332.419919999998,19715.7793,64.03924643,-35.96075357,-417.3108381,-457.59421789999993,0.053290200999999995,3220600,-1,0.5994
BSESN,2/7/2008,17526.92969,18198.67969,17492.2793,18198.67969,17400,-612.560546,612.560546,0.0,36.21857087,15332.419919999998,18919.57031,61.17696575,-38.82303425,-451.8514421,-456.44566280000004,-0.045460512,3203200,-1,0.0
BSESN,2/8/2008,17464.89063,17688.73047,17203.06055,17610.07031,19200,-62.039063,62.039063,0.0,35.42797836,15332.419919999998,18895.33984,59.85177185,-40.14822815,-478.71284979999996,-460.8991002,-0.0378944,3184000,-1,0.0
BSESN,2/11/2008,16630.91016,17427.33984,16457.74023,17427.33984,20000,-833.9804690000001,833.9804690000001,0.0,26.46685769,16457.74023,18895.33984,7.104116742,-92.89588326,-560.8310516,-480.8854905,-0.08075581400000001,3164000,-1,0.0
BSESN,2/12/2008,16608.00977,16966.7207,16565.48047,16812.63086,14400,-22.900389999999998,22.900389999999998,0.0,26.25643786,16457.74023,18895.33984,6.164651954,-93.83534805,-620.6042487999999,-508.8292421,-0.06479273299999999,3149600,-1,-0.4767
BSESN,2/13/2008,16949.14063,17141.06055,16725.67969,16816.93945,14200,341.130859,0.0,341.130859,35.12202686,16457.74023,18895.33984,20.15919222,-79.84080778,-633.1499701,-533.6933877,-0.039638607,3163800,1,-0.4404
BSESN,2/14/2008,17766.63086,17836.64063,17265.18945,17265.18945,14400,817.490234,0.0,817.490234,51.30832871,16457.74023,18895.33984,53.69588261,-46.30411739,-570.5509586000001,-541.0649019,-0.026090017000000004,3178200,1,-0.6908
BSESN,2/15/2008,18115.25,18142.91992,17445.05078,17541.16992,17400,348.619141,0.0,348.619141,56.63227389,16457.74023,18895.33984,67.99762189,-32.00237811,-487.19406979999997,-530.2907355000001,-0.029210126,3195600,1,-0.6486
BSESN,2/18/2008,18048.05078,18256.82031,17900.96094,18228.21094,11800,-67.199219,67.199219,0.0,55.28774943,16457.74023,18895.33984,65.24084351,-34.75915649,-421.6945183,-508.571492,-0.032958479,3183800,-1,-0.6124
BSESN,2/19/2008,18075.66016,18314.09961,18018.48047,18215.25977,12800,27.609375,0.0,27.609375,55.78538432,16457.74023,18895.33984,66.37348953,-33.62651047,-363.3691131,-479.53101619999995,-0.003518846,3196600,1,-0.6249
BSESN,2/20/2008,17617.59961,17991.28906,17505.56055,17991.28906,12800,-458.060547,458.060547,0.0,45.98738837,16457.74023,18895.33984,47.58202989,-52.41797011,-350.0720545,-453.6392239,0.005173178,3183800,-1,0.0
BSESN,2/21/2008,17734.67969,17887.21094,17482.31055,17825.2207,15800,117.080079,0.0,117.080079,48.64742186,16457.74023,18895.33984,52.3851189,-47.6148811,-326.3249845,-428.176376,0.015447509,3199600,1,0.0
BSESN,2/22/2008,17349.07031,17526.80078,17347.25977,17503.03906,9800,-385.609375,385.609375,0.0,40.97811093,16457.74023,18729.83008,39.22952613,-60.77047387,-334.7617889,-409.4934586,0.043182252000000004,3189800,-1,-0.7579
BSESN,2/25/2008,17650.57031,17674.06055,17137.99023,17523.81055,13200,301.5,0.0,301.5,48.32738726,16457.74023,18314.09961,64.25642012,-35.74357988,-313.5055896,-390.2958848,0.062774562,3203000,1,-0.2023
BSESN,2/26/2008,17806.18945,17860.09961,17678.74023,17799.56055,11000,155.61914,0.0,155.61914,51.89475211,16457.74023,18314.09961,72.63944887,-27.36055113,-280.8650965,-368.4097271,0.050565915999999995,3214000,1,0.4767
BSESN,2/27/2008,17825.99023,18137.2793,17770.65039,17983.41992,13000,19.800781,0.0,19.800781,52.37744073,16457.74023,18314.09961,73.70609476,-26.29390524,-250.51176919999997,-344.8301356,0.00334106,3227000,1,-0.5574
BSESN,2/28/2008,17824.48047,17921.50977,17690.16016,17810.51953,18200,-1.509765,1.509765,0.0,52.33124407,16457.74023,18314.09961,73.62476541,-26.37523459,-223.9962745,-320.6633633,-0.016051091,3208800,-1,0.0
BSESN,2/29/2008,17578.7207,17779.53906,17258.19922,17779.53906,23000,-245.759766,245.759766,0.0,44.89411856,16565.48047,18314.09961,57.94516432,-42.05483568,-220.2741301,-300.58551669999997,-0.026004475,3185800,-1,-0.2732
BSESN,3/3/2008,16677.88086,17227.56055,16634.63086,17227.56055,21800,-900.839844,900.839844,0.0,28.03998244,16634.63086,18314.09961,2.5752190980000003,-97.4247809,-286.7095414,-297.8103216,-0.077329364,3164000,-1,0.0
BSESN,3/4/2008,16339.88965,16754.06055,16164.57031,16742.19922,20600,-337.99121099999996,337.99121099999996,0.0,24.119876100000003,16164.57031,18314.09961,8.156173322999999,-91.84382668,-362.454994,-310.73925610000003,-0.072524634,3143400,-1,0.0
BSESN,3/5/2008,16542.08008,16595.64063,16253.019530000001,16328.91016,21600,202.19043,0.0,202.19043,30.79782302,16164.57031,18314.09961,17.562438699999998,-82.4375613,-401.5400295,-328.8994108,-0.067246752,3165000,1,0.0
BSESN,3/7/2008,15975.519530000001,16211.95996,15689.919919999998,16211.95996,24400,-566.5605469999999,566.5605469999999,0.0,23.97569609,15689.919919999998,18314.09961,10.88338617,-89.11661383,-472.78196669999994,-357.675922,-0.079171434,3140600,-1,-0.836
BSESN,3/10/2008,15923.71973,15998.330080000002,15362.169919999998,15684.240230000001,21800,-51.799803999999995,51.799803999999995,0.0,23.42821555,15362.169919999998,18314.09961,19.02314298,-80.97685702,-527.3426486999999,-391.6092673,-0.097835399,3118800,-1,-0.6486
BSESN,3/11/2008,16123.15039,16168.12988,15739.04004,15778.269530000001,22400,199.43066399999998,0.0,199.43066399999998,30.48029363,15362.169919999998,18137.2793,27.421638800000004,-72.5783612,-548.1710201000001,-422.92161789999994,-0.09451989,3141200,1,0.0
BSESN,3/12/2008,16127.980469999999,16683.36914,16064.08984,16541.14063,23000,4.830078,0.0,4.830078,30.65875741,15362.169919999998,18137.2793,27.595688800000005,-72.40431120000001,-557.8572761,-449.9087495,-0.09525472300000001,3164200,1,0.0
BSESN,3/13/2008,15357.34961,15873.28027,15228.990230000001,15873.28027,21200,-770.63086,770.63086,0.0,20.8196495,15228.990230000001,18137.2793,4.413570048,-95.58642995,-620.5637017000001,-484.03973990000003,-0.138412498,3143000,-1,0.0
BSESN,3/14/2008,15760.519530000001,15798.419919999998,15331.34961,15467.38965,23800,403.16992200000004,0.0,403.16992200000004,33.66964886,15228.990230000001,18137.2793,18.27635718,-81.72364282,-630.4590134,-513.3235946000001,-0.103431939,3166800,1,-0.4767
BSESN,3/17/2008,14809.490230000001,15326.92969,14739.71973,15326.92969,22600,-951.029297,951.029297,0.0,23.35393263,14739.71973,18137.2793,2.053547717,-97.94645228,-706.8926174,-552.0373992000001,-0.112028059,3144200,-1,0.4939
BSESN,3/18/2008,14833.45996,15164.730469999999,14677.240230000001,14725.67969,47600,23.969727,0.0,23.969727,24.03081834,14677.240230000001,18137.2793,4.514970038,-95.48502996,-756.8086238,-592.9916441,-0.09219338199999999,3191800,1,-0.4404
BSESN,3/19/2008,14994.830080000002,15465.80957,14930.080080000002,15325.79004,28200,161.370117,0.0,161.370117,28.9078445,14677.240230000001,17921.50977,9.789255821,-90.21074418,-774.4191764999999,-629.2771506,-0.09353418599999999,3220000,1,-0.6908
BSESN,3/24/2008,15289.40039,15351.30957,15056.08984,15093.769530000001,20200,294.570313,0.0,294.570313,37.37571463,14677.240230000001,17779.53906,19.73246907,-80.26753093,-755.8928417999999,-654.6002887999999,-0.042948158,3240200,1,0.0
BSESN,3/25/2008,16217.490230000001,16262.37988,15612.61035,15612.61035,29400,928.089843,0.0,928.089843,56.298887300000004,14677.240230000001,17227.56055,60.39437447,-39.60562553,-658.7280868,-655.4258484000001,0.018448611,3269600,1,-0.6486
BSESN,3/26/2008,16086.830080000002,16309.87988,16009.87012,16270.12012,24600,-130.660156,130.660156,0.0,53.66473305,14677.240230000001,16754.06055,67.87249890000001,-32.127501099999996,-585.5180138999999,-641.4442815,-0.002252681,3245000,-1,0.0
BSESN,3/27/2008,16015.55957,16111.44043,15869.08984,15950.29004,24200,-71.27050799999999,71.27050799999999,0.0,52.129619399999996,14677.240230000001,16683.36914,66.71153241,-33.28846759,-527.1725213000001,-618.5899295,-0.00697055,3220800,-1,-0.29600000000000004
BSESN,3/28/2008,16371.29004,16452.08008,15884.4502,16100.259769999999,23800,355.73046899999997,0.0,355.73046899999997,58.90052758,14677.240230000001,16683.36914,84.44371641,-15.55628359,-447.0752174,-584.2869870000001,0.06602313900000001,3244600,1,0.0
BSESN,3/31/2008,15644.44043,16226.66016,15563.15039,16226.66016,23200,-726.849609,726.849609,0.0,44.17100355,14677.240230000001,16683.36914,48.21226555,-51.78773445,-437.2083501,-554.8712597,-0.007365182,3221400,-1,0.0
BSESN,4/1/2008,15626.62012,15834.049809999999,15297.95996,15771.71973,15300,-17.820313,17.820313,0.0,43.86071631,14677.240230000001,16683.36914,47.32397204,-52.67602796,-425.9170307,-529.0804138999999,0.055176098,3206100,-1,0.0
BSESN,4/2/2008,15750.40039,16236.7002,15719.46973,16023.299809999999,16800,123.780274,0.0,123.780274,46.85291301,14677.240230000001,16683.36914,53.49407774,-46.50592226,-402.3425901,-503.73284910000007,0.061815681,3222900,1,0.0
BSESN,4/3/2008,15832.549809999999,16002.730469999999,15699.20996,15805.62988,15600,82.14941400000001,0.0,82.14941400000001,48.93706775,14677.240230000001,16452.08008,65.09373648,-34.90626352,-372.7342565,-477.5331306,0.055867237,3238500,1,0.0
BSESN,4/4/2008,15343.12012,15896.08984,15303.04004,15896.08984,19000,-489.429688,489.429688,0.0,38.54593628,14677.240230000001,16452.08008,37.51774478,-62.48225522,-384.33198439999995,-458.8929013,0.0035135270000000002,3219500,-1,0.0
BSESN,4/7/2008,15757.080080000002,15851.87988,15321.55957,15390.15039,19800,413.95996099999996,0.0,413.95996099999996,49.09474562,14677.240230000001,16452.08008,60.8415372,-39.158462799999995,-356.01622460000004,-438.317566,-0.028389729,3239300,1,0.0
BSESN,4/8/2008,15587.62012,15770.40039,15479.419919999998,15770.16016,18400,-169.45996100000002,169.45996100000002,0.0,45.412718299999995,14677.240230000001,16452.08008,51.29363565,-48.70636435,-343.2925211,-419.31255699999997,-0.031032214,3220900,-1,0.0
BSESN,4/9/2008,15790.509769999999,15829.58984,15464.71973,15512.7002,16400,202.889649,0.0,202.889649,50.53742922,14930.080080000002,16452.08008,56.53283101,-43.46716899,-313.22671280000003,-398.0953882,-0.014051948,3237300,1,0.0
BSESN,4/10/2008,15695.09961,15953.54004,15655.2002,15754.87012,22000,-95.410157,95.410157,0.0,48.08782638,15056.08984,16452.08008,45.77465869,-54.22534131,-293.71241150000003,-377.2187928,-0.04130343,3215300,-1,0.0
BSESN,4/11/2008,15807.63965,15957.240230000001,15673.669919999998,15840.55957,19600,112.540039,0.0,112.540039,51.30050544,15297.95996,16452.08008,44.16175401,-55.83824599,-266.0987261,-354.9947795,0.010431771,3234900,1,0.0
BSESN,4/15/2008,16153.66016,16249.45996,15573.03027,15694.41016,22400,346.020508,0.0,346.020508,60.06777441,15297.95996,16452.08008,74.14307942,-25.85692058,-213.8288326,-326.76159010000003,0.033727065,3257300,1,0.0
BSESN,4/16/2008,16244.19043,16413.80078,16198.55957,16288.759769999999,22000,90.530274,0.0,90.530274,62.12612577,15297.95996,16452.08008,81.98717404,-18.01282596,-163.2180528,-294.05288260000003,0.031350952,3279300,1,-0.4588
BSESN,4/17/2008,16481.19922,16570.57031,16397.16992,16456.03906,17800,237.008789,0.0,237.008789,67.2288917,15297.95996,16570.57031,92.97734033,-7.022659674,-102.7990136,-255.80210879999998,0.040969359,3297100,1,0.34
BSESN,4/21/2008,16739.33008,16778.58984,16611.41016,16611.41016,20200,258.130859,0.0,258.130859,71.97404005,15297.95996,16778.58984,97.3484416,-2.651558398,-33.69902533,-211.3814921,0.09099909,3317300,1,0.0
BSESN,4/22/2008,16783.86914,16853.96094,16597.5293,16686.55078,21400,44.539063,0.0,44.539063,72.75932203,15297.95996,16853.96094,95.49538863,-4.504611375,24.37615028,-164.22996369999998,0.065163663,3338700,1,0.0
BSESN,4/23/2008,16698.03906,16871.26953,16589.44922,16823.99023,17000,-85.830078,85.830078,0.0,68.49203789,15303.04004,16871.26953,88.95375525,-11.04624475,62.75200927,-118.83356909999999,0.07123723400000001,3321700,-1,-0.4939
BSESN,4/24/2008,16721.08008,16844.01953,16668.59961,16796.25977,19000,23.041014999999998,0.0,23.041014999999998,69.05421661,15303.04004,16871.26953,90.42299270000001,-9.577007304,93.94147254,-76.27856075,0.058932253,3340700,1,0.2023
BSESN,4/25/2008,17125.98047,17150.91992,16781.9707,16781.9707,21600,404.900391,0.0,404.900391,77.27554595,15303.04004,17150.91992,98.65037478,-1.349625223,149.60684990000001,-31.10147862,0.091167364,3362300,1,0.0
BSESN,4/28/2008,17015.96094,17271.56055,16978.89063,17251.56055,19200,-110.019531,110.019531,0.0,71.3339093,15321.55957,17271.56055,86.89233431,-13.10766569,182.7379169,11.66640048,0.076439071,3343100,-1,0.0
BSESN,4/29/2008,17378.46094,17424.93945,17011.59961,17050.86914,27600,362.5,0.0,362.5,77.81802029,15464.71973,17424.93945,97.628913,-2.371086995,235.5302011,56.4391606,0.075821874,3370700,1,-0.2263
BSESN,4/30/2008,17287.31055,17480.74023,17241.88086,17479.00977,26200,-91.150391,91.150391,0.0,73.0255934,15464.71973,17480.74023,90.40537106,-9.59462894,266.9363162,98.53859171,0.064214965,3344500,-1,0.29600000000000004
BSESN,5/2/2008,17600.11914,17621.24023,17445.92969,17560.15039,24600,312.80859399999997,0.0,312.80859399999997,78.31398022,15573.03027,17621.24023,98.96880235,-1.031197651,313.4536296,141.5215993,0.06789068599999999,3369100,1,0.0
BSESN,5/5/2008,17490.90039,17735.69922,17457.26953,17687.0,20200,-109.21875,109.21875,0.0,72.58124161,15573.03027,17735.69922,88.68070731,-11.31929269,337.61409019999996,180.74009750000002,0.04489847,3348900,-1,0.0
BSESN,5/6/2008,17373.00977,17502.15039,17237.67969,17441.41016,23200,-117.890625,117.890625,0.0,66.51688514,15573.03027,17735.69922,83.22954358,-16.77045642,343.29139169999996,213.25035630000002,0.035101598,3325700,-1,0.0
BSESN,5/7/2008,17339.31055,17413.81055,17229.98047,17404.15039,21200,-33.699219,33.699219,0.0,64.73296942,16198.55957,17735.69922,74.21257904,-25.78742096,341.1390105,238.8280872,0.038404,3304500,-1,0.0
BSESN,5/8/2008,17080.65039,17212.60938,17038.0293,17212.60938,18200,-258.66015600000003,258.66015600000003,0.0,52.30862835,16397.16992,17735.69922,51.06204777,-48.93795223,314.9311893,254.0487076,0.021504012000000003,3286300,-1,0.0
BSESN,5/9/2008,16737.07031,17125.94922,16678.93945,17020.78906,18600,-343.58007799999996,343.58007799999996,0.0,40.41875744,16589.44922,17735.69922,12.87861234,-87.12138766,263.4009393,255.9191539,-0.022708782,3267700,-1,0.0
BSESN,5/12/2008,16860.90039,16897.35938,16546.55078,16641.44922,18000,123.830078,0.0,123.830078,45.56432733,16546.55078,17735.69922,26.43485035,-73.56514965,229.90469900000002,250.71626290000003,-0.009112653,3285700,1,-0.7184
BSESN,5/13/2008,16752.85938,17085.63086,16697.4707,17008.0293,17000,-108.04101599999998,108.04101599999998,0.0,41.91970476,16546.55078,17735.69922,17.34927175,-82.65072825,192.4225528,239.05752090000001,-0.035998675,3268700,-1,0.29600000000000004
BSESN,5/14/2008,16978.34961,17014.93945,16626.34961,16691.30078,19000,225.490234,0.0,225.490234,51.30048962,16546.55078,17735.69922,36.31160032,-63.68839968,178.85117419999997,227.01625159999998,-0.017872123,3287700,1,-0.6705
BSESN,5/15/2008,17353.53906,17366.18945,17079.93945,17084.89063,25000,375.189454,0.0,375.189454,62.827221200000004,16546.55078,17735.69922,67.86270378,-32.13729622,196.1097808,220.8349574,-0.014010136999999999,3312700,1,-0.29600000000000004
BSESN,5/16/2008,17434.93945,17497.35938,17315.51953,17476.41016,17000,81.40039,0.0,81.40039,64.9065873,16546.55078,17735.69922,74.70797115,-25.29202885,213.8900903,219.44598399999998,-0.0031994320000000003,3329700,1,0.0
BSESN,5/20/2008,17230.17969,17367.13086,17136.25977,17366.05078,16600,-204.759765,204.759765,0.0,55.84047528,16546.55078,17735.69922,57.4889463,-42.5110537,209.0489259,217.3665724,-0.008221378,3313100,-1,0.0258
BSESN,5/21/2008,17243.16016,17293.33984,17041.63086,17065.60938,19600,12.980468,0.0,12.980468,56.28709267,16546.55078,17735.69922,58.58052307,-41.41947693,203.9091459,214.67508709999998,-0.0055452259999999995,3332700,1,0.0
BSESN,5/22/2008,16907.10938,17104.58984,16863.38086,17104.58984,16800,-336.05078100000003,336.05078100000003,0.0,43.22740311,16546.55078,17735.69922,30.32073898,-69.67926102,170.751032,205.8902761,-0.010160094,3315900,-1,-0.29600000000000004
BSESN,5/23/2008,16649.64063,17054.33984,16626.10938,16958.80078,17600,-257.46875,257.46875,0.0,35.87002272,16546.55078,17735.69922,8.669215777,-91.33078422,122.2877544,189.16977169999998,-0.005223715,3298300,-1,0.3412
BSESN,5/26/2008,16348.5,16498.24023,16300.87988,16468.32031,15800,-301.140625,301.140625,0.0,29.16978737,16300.87988,17502.15039,3.964146017,-96.03585398,58.90174342,163.1161661,-0.030389858999999998,3282500,-1,-0.25
BSESN,5/27/2008,16275.58984,16506.34961,16237.919919999998,16454.75,16200,-72.910156,72.910156,0.0,27.72312503,16237.919919999998,17497.35938,2.9910069839999998,-97.00899302,2.752899077,131.0435127,-0.02848884,3266300,-1,0.0
BSESN,5/28/2008,16525.36914,16563.30078,16217.78027,16358.62012,21600,249.779297,0.0,249.779297,39.56997766,16217.78027,17497.35938,24.03828474,-75.96171526,-21.3443188,100.5659464,-0.026679888,3287900,1,0.4576
BSESN,5/29/2008,16316.259769999999,16666.0293,16196.019530000001,16666.0293,20000,-209.109375,209.109375,0.0,34.16117226,16196.019530000001,17497.35938,9.23972593,-90.76027407,-56.6617551,69.12040608,-0.059773358,3267900,-1,-0.25
BSESN,5/30/2008,16415.57031,16540.49023,16314.990230000001,16454.0293,18400,99.310547,0.0,99.310547,38.74911212,16196.019530000001,17497.35938,16.87113347,-83.12886653,-75.76418429,40.14348801,-0.058467030999999996,3286300,1,-0.6908
BSESN,6/2/2008,16063.17969,16632.7207,15991.20996,16591.46094,17600,-352.390625,352.390625,0.0,30.14774725,15991.20996,17497.35938,4.778392258,-95.22160774,-117.97799850000001,8.519190705,-0.067729996,3268700,-1,-0.6908
BSESN,6/3/2008,15962.55957,15985.40039,15709.509769999999,15851.71973,20200,-100.620118,100.620118,0.0,28.09320407,15709.509769999999,17497.35938,14.1538641,-85.84613590000001,-157.7336971,-24.73138686,-0.074267163,3248500,-1,0.0
BSESN,6/4/2008,15514.79004,15992.90039,15442.33984,15992.90039,23800,-447.769531,447.769531,0.0,20.81089897,15442.33984,17497.35938,3.525523427,-96.47447657,-222.803296,-64.34576869,-0.082351117,3224700,-1,0.0
BSESN,6/5/2008,15769.71973,15814.799809999999,15314.019530000001,15479.65039,28600,254.929688,0.0,254.929688,32.33360357,15314.019530000001,17497.35938,20.87170246,-79.12829754,-250.9084107,-101.65829709999998,-0.052849243,3253300,1,-0.5267
BSESN,6/6/2008,15572.17969,15970.7002,15526.5,15914.41016,19600,-197.54003899999998,197.54003899999998,0.0,28.61131937,15314.019530000001,17367.13086,12.57409442,-87.42590558,-285.826912,-138.4920201,-0.047485720999999995,3233700,-1,0.0
BSESN,6/9/2008,15066.09961,15202.740230000001,14846.17969,15115.96973,24400,-506.080079,506.080079,0.0,21.34688327,14846.17969,17293.33984,8.986740016,-91.01325998,-350.29848589999995,-180.8533132,-0.074313143,3209300,-1,-0.29600000000000004
BSESN,6/10/2008,14889.25,15088.03027,14645.30957,14979.95996,26400,-176.84960900000002,176.84960900000002,0.0,19.36443601,14645.30957,17104.58984,9.919179712,-90.08082029,-410.9260584,-226.8678623,-0.09900651099999999,3182900,-1,0.2732
BSESN,6/11/2008,15185.32031,15225.80957,15009.480469999999,15018.67969,34600,296.070313,0.0,296.070313,31.62961426,14645.30957,17054.33984,22.41610447,-77.58389553,-430.1252305,-267.51933590000004,-0.06931364599999999,3217500,1,-0.6249
BSESN,6/12/2008,15250.2002,15270.84961,14748.07031,14957.53027,25000,64.879882,0.0,64.879882,34.16175913,14645.30957,16666.0293,29.9344148,-70.0655852,-435.09000180000004,-301.0334691,-0.070991753,3242500,1,-0.4404
BSESN,6/13/2008,15189.62012,15337.09961,15135.80957,15327.09961,20200,-60.580078,60.580078,0.0,32.85095964,14645.30957,16666.0293,26.93646921,-73.06353079,-438.8540881,-328.59759289999994,-0.05438273,3222300,-1,0.0
BSESN,6/16/2008,15395.82031,15553.37012,15340.33984,15400.57031,15200,206.200196,0.0,206.200196,41.64487346,14645.30957,16666.0293,37.14076391,-62.85923609,-420.3529539,-346.9486651,-0.035504285,3237500,1,0.0
BSESN,6/17/2008,15696.90039,15732.75,15358.75,15388.36035,18200,301.08007799999996,0.0,301.08007799999996,52.19298823,14645.30957,16666.0293,52.04040951,-47.95959049,-377.04963219999996,-352.9688585,0.011737855,3255700,1,0.2263
BSESN,6/18/2008,15422.30957,15789.62012,15390.21973,15744.20996,22000,-274.590821,274.590821,0.0,43.85168322,14645.30957,16632.7207,39.09608772,-60.90391228,-360.7303473,-354.52115630000003,-0.022030205,3233700,-1,0.0
BSESN,6/19/2008,15087.990230000001,15259.36035,15051.66016,15250.46973,18600,-334.31933599999996,334.31933599999996,0.0,35.8114729,14645.30957,16632.7207,22.2742369,-77.7257631,-370.5030443,-357.7175339,-0.031093236,3215100,-1,0.5106
BSESN,6/20/2008,14571.29004,15194.730469999999,14520.87988,15194.730469999999,26000,-516.700195,516.700195,0.0,26.98742853,14520.87988,15992.90039,3.424555278,-96.57544472,-415.1557081,-369.2051687,-0.032842579,3189100,-1,0.0
BSESN,6/23/2008,14293.32031,14509.69043,14163.4502,14423.049809999999,24600,-277.969726,277.969726,0.0,23.40726437,14163.4502,15992.90039,7.098860537,-92.90113946,-467.5830927,-388.8807535,-0.040024157000000005,3164500,-1,0.3182
BSESN,6/24/2008,14106.580080000002,14432.90039,13991.30957,14290.16016,24800,-186.740235,186.740235,0.0,21.22468066,13991.30957,15970.7002,5.823535109,-94.17646489,-518.2267536999999,-414.7499536,-0.07103835900000001,3139700,-1,0.3612
BSESN,6/25/2008,14220.07031,14247.16016,13736.009769999999,13776.20996,23000,113.49023500000001,0.0,113.49023500000001,26.05940472,13736.009769999999,15970.7002,21.66119032,-78.33880968,-542.9457656000001,-440.389116,-0.067548614,3162700,1,-0.1027
BSESN,6/26/2008,14421.82031,14449.80957,14196.67969,14300.71973,21800,201.75,0.0,201.75,34.32686679,13736.009769999999,15789.62012,33.39535889,-66.60464111,-540.0310796,-460.3175087,-0.050547663,3184500,1,0.0
BSESN,6/27/2008,13802.21973,14127.759769999999,13760.78027,14127.759769999999,32200,-619.600586,619.600586,0.0,24.58558674,13736.009769999999,15789.62012,3.2240761239999998,-96.77592388,-581.0201207,-484.4580311000001,-0.103508651,3152300,-1,0.0
BSESN,6/30/2008,13461.59961,13872.05957,13405.54004,13791.019530000001,22400,-340.620118,340.620118,0.0,20.835127800000002,13405.54004,15789.62012,2.351413047,-97.64858695,-633.6847051,-514.3033659,-0.14240396,3129900,-1,0.0
BSESN,7/1/2008,12961.67969,13613.009769999999,12904.08984,13480.019530000001,27600,-499.919921,499.919921,0.0,16.55770615,12904.08984,15789.62012,1.99581493,-98.00418507,-707.6043053,-552.9635538,-0.159550025,3102300,-1,0.2732
BSESN,7/2/2008,13664.62012,13711.009769999999,12822.75,12948.049809999999,32000,702.940429,0.0,702.940429,37.40650655,12822.75,15789.62012,28.37569842,-71.62430158,-701.3796352999999,-582.6467701,-0.094337953,3134300,1,0.0
BSESN,7/3/2008,13094.11035,13458.299809999999,12934.91992,13458.299809999999,29200,-570.509765,570.509765,0.0,30.3135923,12822.75,15789.62012,9.146350912,-90.85364909,-734.0205772999999,-612.9215315,-0.10137604,3105100,-1,0.0
BSESN,7/4/2008,13454.0,13508.37988,13031.42969,13097.00977,31400,359.889648,0.0,359.889648,38.76504116,12822.75,15789.62012,21.27663076,-78.72336924,-722.5199123,-634.8412077,-0.058721157,3136500,1,0.0
BSESN,7/7/2008,13525.990230000001,13793.38965,13476.29004,13561.919919999998,21200,71.990234,0.0,71.990234,40.4324607,12822.75,15789.62012,23.70310146,-76.29689854,-699.5327639,-647.7795189,-0.041157378,3157700,1,0.0
BSESN,7/8/2008,13349.65039,13451.669919999998,13049.95996,13226.04004,25400,-176.339843,176.339843,0.0,37.54310867,12822.75,15259.36035,21.62431882,-78.37568118,-687.6180025,-655.7472156,-0.061210662,3132300,-1,-0.4404
BSESN,7/9/2008,13964.259769999999,13998.480469999999,13581.41016,13581.41016,27600,614.609375,0.0,614.609375,51.48553029999999,12822.75,15194.730469999999,48.12475402,-51.87524598,-621.4183048,-648.8814335,-0.031726962000000004,3159900,1,-0.1779
BSESN,7/10/2008,13926.240230000001,14046.58984,13763.94043,13851.58984,26400,-38.019532,38.019532,0.0,50.67804762,12822.75,14509.69043,65.41370486,-34.58629514,-565.5036518999999,-632.2058772,0.008985548000000001,3133500,-1,0.0
BSESN,7/11/2008,13469.84961,14063.4502,13351.33984,14063.4502,29000,-456.390625,456.390625,0.0,41.63380876,12822.75,14449.80957,39.7711074,-60.228892599999995,-551.6586186000001,-616.0964253999999,0.000612854,3104500,-1,-0.2263
BSESN,7/14/2008,13330.50977,13557.20996,13270.40039,13333.030270000001,23600,-139.339843,139.339843,0.0,39.17114605,12822.75,14449.80957,31.20720196,-68.79279804,-545.6400915,-602.0051587,0.028455422999999997,3080900,-1,0.0
BSESN,7/15/2008,12676.19043,13067.08008,12607.62012,13067.08008,30000,-654.319336,654.319336,0.0,29.66398867,12607.62012,14449.80957,3.722218303,-96.2777817,-586.9030147999999,-598.9847298999999,-0.072334955,3050900,-1,0.6249
BSESN,7/16/2008,12575.799809999999,12935.25,12514.99023,12759.75977,31200,-100.390625,100.390625,0.0,28.44192265,12514.99023,14127.759769999999,3.77050594,-96.22949406,-620.5515315,-603.2980902,-0.039583487,3019700,-1,0.0
BSESN,7/17/2008,13111.84961,13150.34961,12843.79004,12909.57031,33600,536.049804,0.0,536.049804,42.92792824,12514.99023,14063.4502,38.545354100000004,-61.4546459,-597.0807093999999,-602.054614,-0.025431127999999997,3053300,1,0.0
BSESN,7/18/2008,13635.40039,13684.269530000001,13093.33984,13234.530270000001,36600,523.550782,0.0,523.550782,53.52947318,12514.99023,14063.4502,72.35641768,-27.64358232,-530.1228154,-587.6682543,0.008088883,3089900,1,0.0
BSESN,7/21/2008,13850.04004,13878.87988,13581.19043,13782.12988,32400,214.639648,0.0,214.639648,57.28304595,12514.99023,14063.4502,86.21790932,-13.78209068,-454.4993901,-561.0344815000001,0.037483352000000005,3122300,1,-0.4588
BSESN,7/22/2008,14104.2002,14206.12988,13798.17969,13837.63965,35600,254.160156,0.0,254.160156,61.52874341,12514.99023,14206.12988,93.97272199999999,-6.027277999,-369.7959033,-522.7867658,0.010021328000000001,3157900,1,0.5106
BSESN,7/23/2008,14942.28027,14979.90039,14568.21973,14568.21973,39000,838.0800780000001,0.0,838.0800780000001,72.0850426,12514.99023,14979.90039,98.47377326,-1.526226743,-232.36318340000003,-464.7020493,0.072958675,3196900,1,0.6369
BSESN,7/24/2008,14777.009769999999,15130.08984,14608.049809999999,15082.37012,31200,-165.270507,165.270507,0.0,67.84885127,12514.99023,15130.08984,86.49840807,-13.50159193,-135.2239341,-398.80642630000006,0.097043411,3165700,-1,0.0
BSESN,7/25/2008,14274.94043,14484.38965,14210.62988,14451.9502,27800,-502.069336,502.069336,0.0,56.25986744,12514.99023,15130.08984,67.29954719,-32.70045281,-97.62778631,-338.5706983,0.070847303,3137900,-1,0.0
BSESN,7/28/2008,14349.11035,14421.61035,14219.37988,14267.03027,21800,74.169922,0.0,74.169922,57.49732733,12514.99023,15130.08984,70.13576504,-29.86423496,-61.14285865,-283.08513039999997,0.13197339800000002,3159700,1,0.0
BSESN,7/29/2008,13791.54004,14153.12012,13727.13965,14085.53027,23600,-557.5703129999999,557.5703129999999,0.0,46.16783874,12514.99023,15130.08984,48.8145767,-51.1854233,-76.33956013,-241.73601630000002,0.096672995,3136100,-1,-0.6908
BSESN,7/30/2008,14287.20996,14322.669919999998,14002.19043,14007.32031,26000,495.669922,0.0,495.669922,55.21887802,12514.99023,15130.08984,67.76872744,-32.23127256,-47.83522068,-202.9558572,0.089641079,3162100,1,-0.3818
BSESN,7/31/2008,14355.75,14369.419919999998,14161.759769999999,14359.480469999999,27800,68.54003900000001,0.0,68.54003900000001,56.38879333,12514.99023,15130.08984,70.3896616,-29.610338399999996,-19.49004882,-166.2626955,0.05282937,3189900,1,0.0
BSESN,8/1/2008,14656.69043,14682.330080000002,14032.87012,14064.259769999999,40200,300.94043,0.0,300.94043,61.48631027,12514.99023,15130.08984,81.89746149,-18.10253851,26.94645973,-127.6208645,0.058241737,3230100,1,-0.29600000000000004
BSESN,8/4/2008,14577.87012,14725.94043,14503.509769999999,14594.63965,24800,-78.820313,78.820313,0.0,59.38848951,12514.99023,15130.08984,78.88341519,-21.11658481,56.73359718,-90.74997214,0.033583607,3205300,-1,-0.4215
BSESN,8/5/2008,14961.07031,14986.62988,14529.20996,14562.67969,35600,383.200196,0.0,383.200196,65.91257466,12843.79004,15130.08984,92.60728927,-7.39271073,109.9932379,-50.60133013,0.001257508,3240900,1,-0.7184
BSESN,8/6/2008,15073.54004,15422.82031,15035.59961,15263.65039,32600,112.469726,0.0,112.469726,67.67137113,13093.33984,15422.82031,85.00608704,-14.99391296,159.4393364,-8.593196817,0.020067001,3273500,1,-0.5267
BSESN,8/7/2008,15117.25,15280.05957,14992.96973,15031.86035,25800,43.709961,0.0,43.709961,68.40245535,13581.19043,15422.82031,83.40761541,-16.59238459,199.8490192,33.09524639,0.059006170999999996,3299300,1,-0.7783
BSESN,8/8/2008,15167.82031,15228.82031,14888.12012,15036.57031,21000,50.570313,0.0,50.570313,69.32838894,13727.13965,15422.82031,84.96179114,-15.03820886,233.2656444,73.12932599,0.057056496,3320300,1,-0.29600000000000004
BSESN,8/11/2008,15503.919919999998,15520.70996,15367.96973,15430.30957,26200,336.099609,0.0,336.099609,74.95627932,13727.13965,15520.70996,99.06387618,-0.936123824,283.5998279,115.2234264,0.124161615,3346500,1,0.0382
BSESN,8/12/2008,15212.12988,15579.78027,15124.91016,15577.2002,27000,-291.79003900000004,291.79003900000004,0.0,63.31804946,13727.13965,15579.78027,80.15533153,-19.84466847,296.5268366,151.4841084,0.064737617,3319500,-1,0.4215
BSESN,8/13/2008,15093.12012,15272.55957,15013.05957,15030.20996,19200,-119.00976599999998,119.00976599999998,0.0,59.00644969,13727.13965,15579.78027,73.73154029999999,-26.2684597,293.78195519999997,179.94367780000002,0.051364096,3300300,-1,-0.6705
BSESN,8/14/2008,14724.17969,15033.28027,14686.66016,15017.67969,22000,-368.940429,368.940429,0.0,47.4490531,13727.13965,15579.78027,53.81723938,-46.18276062,258.85231919999995,195.7254061,0.004604672,3278300,-1,-0.0772
BSESN,8/18/2008,14645.66016,14824.919919999998,14600.65039,14681.13965,19600,-78.519532,78.519532,0.0,45.27156686,13727.13965,15579.78027,49.57898988,-50.42101012,222.2722449,201.0347738,0.004650202,3258700,-1,0.0
BSESN,8/19/2008,14543.730469999999,14604.11035,14368.71973,14517.759769999999,17600,-101.929687,101.929687,0.0,42.35982469,14002.19043,15579.78027,34.32704904,-65.67295096,182.94848230000002,197.4175155,-0.027895053,3241100,-1,-0.5267
BSESN,8/20/2008,14678.230469999999,14746.2002,14584.03027,14610.57031,18400,134.5,0.0,134.5,47.50084376,14032.87012,15579.78027,41.71931702,-58.28068298,160.7837284,190.0907581,-0.026225397,3259500,1,0.0
BSESN,8/21/2008,14243.730469999999,14646.980469999999,14201.17969,14646.980469999999,19400,-434.5,434.5,0.0,35.64898444,14032.87012,15579.78027,13.631066500000001,-86.3689335,106.9249186,173.45759019999997,-0.057782965,3240100,-1,0.0
BSESN,8/22/2008,14401.490230000001,14428.519530000001,14136.86035,14153.38965,20400,157.759765,0.0,157.759765,41.73898823,14136.86035,15579.78027,18.33988693,-81.66011307,76.09415240000001,153.98490259999997,-0.050523415,3260500,1,-0.4939
BSESN,8/25/2008,14450.34961,14672.69043,14416.2002,14643.37012,17000,48.859375,0.0,48.859375,43.64486669,14136.86035,15579.78027,21.72603292,-78.27396708,54.9694378,134.1818097,-0.067955093,3277500,1,-0.4767
BSESN,8/26/2008,14482.21973,14495.269530000001,14286.37988,14338.269530000001,18800,31.870117999999998,0.0,31.870117999999998,44.99903048,14136.86035,15579.78027,23.93475688,-76.06524312,40.33464874,115.41237749999999,-0.047982114000000006,3296300,1,0.0
BSESN,8/27/2008,14296.79004,14563.09961,14261.69043,14563.09961,15600,-185.429688,185.429688,0.0,38.74826161,14136.86035,15579.78027,11.08375348,-88.91624652,13.61687993,95.05327798,-0.05276113,3280700,-1,0.0
BSESN,8/28/2008,14048.33984,14347.19043,14002.42969,14289.96973,18800,-248.450195,248.450195,0.0,31.89807062,14002.42969,15579.78027,2.910586678,-97.08941332,-27.29041182,70.58454002,-0.0459,3261900,-1,-0.6705
BSESN,8/29/2008,14564.53027,14586.16016,14279.019530000001,14279.019530000001,32400,516.190429,0.0,516.190429,52.16915636,14002.42969,15579.78027,35.63574201,-64.36425799,-17.85169834,52.89729235,-0.005539517,3294300,1,0.4215
BSESN,9/1/2008,14498.509769999999,14547.41016,14281.09961,14412.990230000001,14800,-66.020507,66.020507,0.0,49.97393676,14002.42969,15579.78027,31.45021042,-68.54978958,-15.5198499,39.2138639,-0.003109292,3279500,-1,0.0
BSESN,9/2/2008,15049.86035,15106.15039,14543.20996,14609.44043,25700,551.350586,0.0,551.350586,64.40622279,14002.42969,15272.55957,82.46642165,-17.53357835,30.466344199999998,37.46435996,0.025318438999999998,3305200,1,-0.3612
BSESN,9/4/2008,14899.09961,14994.15039,14766.009769999999,14895.84961,19800,-150.760743,150.760743,0.0,59.03291902,14002.42969,15106.15039,81.24065432,-18.75934568,54.12172083,40.79583213,0.04601106,3285400,-1,0.0
BSESN,9/5/2008,14483.830080000002,14601.38965,14438.58984,14569.009769999999,23200,-415.26953100000003,415.26953100000003,0.0,46.660544200000004,14002.42969,15106.15039,43.61614208,-56.38385792,38.91144966,40.41895564,0.005717453000000001,3262200,-1,-0.25
BSESN,9/8/2008,14944.96973,15107.009769999999,14917.05957,15038.05957,23400,461.139649,0.0,461.139649,57.95209261,14002.42969,15107.009769999999,85.33016825,-14.66983175,63.33720409,45.00260533,0.034228938,3285600,1,0.0
BSESN,9/9/2008,14900.759769999999,14998.32031,14714.919919999998,14814.330080000002,19800,-44.209961,44.209961,0.0,56.62605214,14002.42969,15107.009769999999,81.3277458,-18.672254199999998,78.22567914,51.64722009,0.028900269,3265800,-1,0.5423
BSESN,9/10/2008,14662.61035,14866.32031,14609.830080000002,14717.53027,22800,-238.149414,238.149414,0.0,49.57537318,14002.42969,15107.009769999999,59.76756934,-40.23243066,70.00130401,55.31803687,0.025587584,3243000,-1,0.0
BSESN,9/11/2008,14324.29004,14557.330080000002,14265.37988,14557.330080000002,22800,-338.320313,338.320313,0.0,41.17216981,14002.42969,15107.009769999999,29.13870686,-70.86129314,35.77145461,51.40872042,0.019642904,3220200,-1,-0.0387
BSESN,9/12/2008,14000.80957,14433.2002,13933.87012,14433.2002,26800,-323.48046899999997,323.48046899999997,0.0,34.68584039,13933.87012,15107.009769999999,5.706008918999999,-94.29399108,-17.25916515,37.67514331,-0.038705038,3193400,-1,0.128
BSESN,9/15/2008,13531.269530000001,13592.049809999999,13150.80957,13592.049809999999,24000,-469.540039,469.540039,0.0,27.44444617,13150.80957,15107.009769999999,19.44892766,-80.55107234,-96.06687132,10.92674038,-0.06671308,3169400,-1,-0.6486
BSESN,9/16/2008,13518.799809999999,13556.03027,13051.73047,13051.73047,33600,-12.469726,12.469726,0.0,27.26998968,13051.73047,15107.009769999999,22.72534622,-77.27465378,-157.7107575,-22.80075919,-0.101732542,3135800,-1,0.0
BSESN,9/17/2008,13262.90039,13620.740230000001,13127.95996,13620.740230000001,30400,-255.899414,255.899414,0.0,23.70232597,13051.73047,15107.009769999999,10.27451219,-89.72548781,-224.62360440000003,-63.16532822,-0.10981866400000001,3105400,-1,-0.743
BSESN,9/18/2008,13315.59961,13346.79004,12558.13965,12712.82031,48000,52.699218,0.0,52.699218,26.00269559,12558.13965,15107.009769999999,29.71747974,-70.28252026,-270.28446010000005,-104.5891546,-0.080657565,3153400,1,0.0
BSESN,9/19/2008,14042.32031,14097.44043,13674.95996,13763.830080000002,47400,726.720704,0.0,726.720704,49.99272514,12558.13965,15107.009769999999,58.22896406,-41.77103594,-245.00644810000003,-132.6726133,-0.06039821,3200800,1,-0.6908
BSESN,9/22/2008,13994.95996,14215.330080000002,13917.480469999999,14215.330080000002,35800,-47.360352,47.360352,0.0,48.80297309,12558.13965,15107.009769999999,56.37087205,-43.62912795,-226.1876753,-151.3756257,-0.06078883400000001,3165000,-1,-0.4767
BSESN,9/23/2008,13570.30957,13978.259769999999,13543.46973,13721.419919999998,29600,-424.650391,424.650391,0.0,39.16096403,12558.13965,15107.009769999999,39.710533500000004,-60.2894665,-242.7412301,-169.6487466,-0.074495656,3135400,-1,-0.4404
BSESN,9/24/2008,13692.519530000001,13840.80957,13592.79004,13636.70996,40200,122.209961,0.0,122.209961,42.90663706,12558.13965,15107.009769999999,44.50520546,-55.49479454,-243.1953148,-184.35806019999998,-0.04410483900000001,3175600,1,-0.8555
BSESN,9/25/2008,13547.17969,13716.87988,13430.67969,13716.87988,36600,-145.339843,145.339843,0.0,39.56411002,12558.13965,15107.009769999999,38.80307722,-61.19692278,-252.37368419999999,-197.961185,-0.032400261,3139000,-1,-0.6249
BSESN,9/26/2008,13102.17969,13486.2002,13054.41992,13486.2002,29000,-445.0,445.0,0.0,31.02541838,12558.13965,14998.32031,22.29507216,-77.70492784,-292.18723650000004,-216.80639530000002,-0.031710982,3110000,-1,-0.5267
BSESN,9/29/2008,12595.75,13109.95996,12402.83984,13109.95996,37000,-506.429688,506.429688,0.0,24.17443008,12402.83984,14866.32031,7.830797054,-92.16920295,-360.44937089999996,-245.5349904,-0.06827897599999999,3073000,-1,-0.4767
BSESN,9/30/2008,12860.42969,12995.2002,12153.549809999999,12178.17969,38400,264.679688,0.0,264.679688,33.08505329,12153.549809999999,14557.330080000002,29.40700907,-70.59299093,-388.7093658,-274.16986549999996,-0.030345602000000003,3111400,1,-0.6908
BSESN,10/1/2008,13055.66992,13203.86035,12697.299809999999,13006.719729999999,32400,195.24023400000002,0.0,195.24023400000002,39.16936376,12153.549809999999,14433.2002,39.57273979,-60.42726021,-390.84593160000003,-297.5050787,-0.01952069,3143800,1,-0.7964
BSESN,10/3/2008,12526.32031,13001.19043,12472.61035,12851.469729999999,37200,-529.349609,529.349609,0.0,30.49499343,12153.549809999999,14215.330080000002,18.08003078,-81.91996922,-430.2931137,-324.0626857,-0.107959366,3106600,-1,-0.6124
BSESN,10/6/2008,11801.7002,12284.49023,11732.969729999999,12284.49023,33000,-724.6201179999999,724.6201179999999,0.0,22.59240177,11732.969729999999,14215.330080000002,2.768754664,-97.23124534,-514.0998542,-362.07011939999995,-0.156717831,3073600,-1,0.0
BSESN,10/7/2008,11695.24023,12181.08008,11501.84961,12068.11035,40400,-106.459961,106.459961,0.0,21.64167507,11501.84961,14215.330080000002,7.127032135,-92.87296787,-582.3942506,-406.1349457,-0.138174397,3033200,-1,0.4019
BSESN,10/8/2008,11328.36035,11405.73047,10740.75977,11316.24023,66200,-366.879882,366.879882,0.0,18.53943572,10740.75977,14215.330080000002,16.9114605,-83.0885395,-658.5310561000001,-456.6141677,-0.17266064,2967000,-1,-0.34
BSESN,10/10/2008,10527.84961,10904.12988,10239.75977,10632.26953,62400,-800.5107429999999,800.5107429999999,0.0,13.62301667,10239.75977,14215.330080000002,7.24650353,-92.75349647,-774.5361788,-520.19857,-0.222875178,2904600,-1,-0.5267
BSESN,10/13/2008,11309.08984,11361.32031,10817.67969,10817.67969,43800,781.240235,0.0,781.240235,33.48551796,10239.75977,14215.330080000002,26.8975265,-73.1024735,-794.2756017,-575.0139763,-0.136854316,2948400,1,0.0
BSESN,10/14/2008,11483.40039,11870.219729999999,11410.49023,11781.42969,36000,174.31054699999999,0.0,174.31054699999999,37.2031042,10239.75977,13978.259769999999,33.26576501,-66.73423499,-786.7842728999999,-617.3680356000001,-0.08831150300000001,2984400,1,-0.5994
BSESN,10/15/2008,10809.12012,11257.15039,10760.33008,11245.26953,34800,-674.2802740000001,674.2802740000001,0.0,29.77522837,10239.75977,13840.80957,15.81095464,-84.18904536,-825.7375354,-659.0419356000001,-0.159505524,2949600,-1,-0.5994
BSESN,10/16/2008,10581.49023,10787.2002,10017.799809999999,10221.530270000001,51600,-227.629883,227.629883,0.0,27.62665362,10017.799809999999,13716.87988,15.23866521,-84.76133479,-865.0048682,-700.2345220999999,-0.18950997600000002,2898000,-1,0.0
BSESN,10/17/2008,9975.349609,10786.92969,9911.320313,10763.33984,47400,-606.140625,606.140625,0.0,22.61308272,9911.320313,13486.2002,1.7910894380000002,-98.20891056,-934.2653654,-747.0406908,-0.20364884800000002,2850600,-1,-0.4215
BSESN,10/20/2008,10223.08984,10538.049809999999,10023.280270000001,10160.469729999999,35400,247.740235,0.0,247.740235,28.71398768,9911.320313,13203.86035,9.468967037999999,-90.53103296,-958.1196352,-789.2564796,-0.133761265,2886000,1,-0.128
BSESN,10/21/2008,10683.38965,10750.2002,10250.23047,10428.11035,45800,460.299804,0.0,460.299804,39.02031722,9911.320313,13203.86035,23.44904924,-76.55095076,-929.1710629,-817.2393963,-0.08651815300000001,2931800,1,-0.4019
BSESN,10/22/2008,10169.90039,10484.84961,10128.219729999999,10455.23047,33400,-513.4892570000001,513.4892570000001,0.0,32.89809686,9911.320313,13203.86035,7.853513547,-92.14648645,-936.8638195,-841.1642809,-0.10226192699999999,2898400,-1,-0.29600000000000004
BSESN,10/23/2008,9771.700195,10260.549809999999,9682.400391,9683.259766,41000,-398.200196,398.200196,0.0,28.848110600000002,9682.400391,13001.19043,2.69073376,-97.30926624,-963.9796551000001,-865.7273558,-0.071823729,2857400,-1,0.5719
BSESN,10/24/2008,8701.070313,9570.709961,8566.820313,9497.480469,63600,-1070.629882,1070.629882,0.0,20.87543482,8566.820313,12284.49023,3.6111328560000002,-96.38886714,-1059.645105,-904.5109056,-0.230612681,2793800,-1,-0.34
BSESN,10/27/2008,8509.55957,8739.480469,7697.390137,8588.860352,55400,-191.510743,191.510743,0.0,19.74893262,7697.390137,12181.08008,18.11386255,-81.88613745,-1137.798151,-951.1683546,-0.258968661,2738400,-1,0.0
BSESN,10/29/2008,9044.509766,9297.759766,8894.339844,9297.759766,55000,534.950196,0.0,534.950196,31.63873698,7697.390137,11870.219729999999,32.28312108,-67.71687892,-1143.388719,-989.6124274,-0.16325198800000001,2793400,1,-0.4767
BSESN,10/31/2008,9788.05957,9870.419922,9361.660156,9361.660156,57200,743.549804,0.0,743.549804,44.76357794,7697.390137,11870.219729999999,50.1019605,-49.8980395,-1075.424209,-1006.774784,-0.074982885,2850600,1,0.0
BSESN,11/3/2008,10337.67969,10373.16992,10112.66016,10209.37012,44800,549.6201179999999,0.0,549.6201179999999,52.53588306,7697.390137,11870.219729999999,63.27336149,-36.72663851,-966.0757743999999,-998.6349818,0.036322544,2895400,1,0.0
BSESN,11/4/2008,10631.12012,10668.48047,10116.219729999999,10304.57031,51000,293.440429,0.0,293.440429,56.32198602,7697.390137,11870.219729999999,70.3055305,-29.6944695,-845.9861602,-968.1052175000001,0.039912617000000004,2946400,1,-0.6908
BSESN,11/5/2008,10120.00977,10945.41016,10051.51953,10931.16992,53400,-511.110351,511.110351,0.0,48.54032469,7697.390137,11257.15039,68.05569634,-31.94430366,-783.0303235,-931.0902387,-0.052734188,2893000,-1,0.0
BSESN,11/6/2008,9734.219727,10109.4502,9635.219727,9755.030273,49400,-385.79003900000004,385.79003900000004,0.0,43.32675944,7697.390137,10945.41016,62.70988412,-37.29011588,-755.5578012999999,-895.9837512,-0.04284021,2843600,-1,0.5719
BSESN,11/7/2008,9964.290039,10065.37012,9631.589844,9631.589844,42000,230.070312,0.0,230.070312,47.22708365,7697.390137,10945.41016,69.79328602,-30.20671398,-707.0702127999999,-858.2010435000001,0.019708938999999998,2885600,1,-0.6124
BSESN,11/10/2008,10536.16016,10570.58008,10095.90039,10154.55957,45400,571.8701169999999,0.0,571.8701169999999,55.92641327,7697.390137,10945.41016,87.40001608,-12.59998392,-615.4043126,-809.6416974,0.21090392100000002,2931000,1,0.0
BSESN,11/11/2008,9839.69043,10397.36035,9800.669922,10386.4502,63600,-696.4697259999999,696.4697259999999,0.0,45.40781157,7697.390137,10945.41016,65.95711481,-34.04288519,-592.1319837,-766.1397546000001,0.15631018800000002,2867400,-1,-0.7351
BSESN,11/12/2008,9536.330078,9928.599609,9376.730469,9683.75,52400,-303.360352,303.360352,0.0,41.48632699,7697.390137,10945.41016,56.61726006,-43.38273994,-591.3504209,-731.1818879,0.054377774000000004,2815000,-1,0.0258
BSESN,11/14/2008,9385.419922,9826.25,9267.490234,9784.849609,46200,-150.910156,150.910156,0.0,39.52693798,7697.390137,10945.41016,51.97104005,-48.02895995,-596.0374662,-704.1530035000001,-0.041135799,2768800,-1,0.0772
BSESN,11/17/2008,9291.009766,9424.25,8956.679688,9396.929688,41800,-94.410156,94.410156,0.0,38.22377884,7697.390137,10945.41016,49.06434134,-50.93565866,-600.4484974999999,-683.4121022999999,-0.10124805099999999,2727000,-1,-0.8934
BSESN,11/18/2008,8937.200195,9169.049805,8871.709961,9084.120117,41000,-353.809571,353.809571,0.0,33.45445309,7697.390137,10945.41016,38.17125667,-61.82874333,-625.285841,-671.7868501,-0.15933597800000002,2686000,-1,0.0
BSESN,11/19/2008,8773.780273,9236.269531,8726.799805,8970.669922,42600,-163.41992199999999,163.41992199999999,0.0,31.36851843,8726.799805,10945.41016,2.117562824,-97.88243718,-650.6558807,-667.5606562,-0.133026501,2643400,-1,-0.8176
BSESN,11/20/2008,8451.009766,8540.459961,8316.389648,8400.879883,40000,-322.770507,322.770507,0.0,27.4657327,8316.389648,10945.41016,5.120542711000001,-94.87945729,-688.8658853,-671.821702,-0.131824635,2603400,-1,-0.6908
BSESN,11/21/2008,8915.209961,8988.030273,8442.30957,8481.019531,59200,464.200195,0.0,464.200195,39.87853023,8316.389648,10945.41016,22.77731616,-77.22268384,-673.92196,-672.2417536,-0.105283976,2662600,1,0.0
BSESN,11/24/2008,8903.120117,9042.019531,8701.929688,8840.530273,43800,-12.089844,12.089844,0.0,39.67449688,8316.389648,10945.41016,22.31745501,-77.68254499,-655.4981662,-668.8930361,-0.154993851,2618800,-1,0.0
BSESN,11/25/2008,8695.530273,9182.799805,8649.400391,9170.280273,41600,-207.589844,207.589844,0.0,36.02296741,8316.389648,10945.41016,14.4213643,-85.5786357,-650.1533789,-665.1451047,-0.116280097,2577200,-1,-0.6124
BSESN,11/26/2008,9026.719727,9061.719727,8658.530273,8806.019531,44600,331.189454,0.0,331.189454,45.29196559,8316.389648,10570.58008,31.51153822,-68.48846178,-612.1370406000001,-654.5434918,-0.053438833,2621800,1,0.0
BSESN,11/28/2008,9092.719727,9157.620117,8889.179688,8889.179688,34000,66.0,0.0,66.0,47.05573958,8316.389648,10570.58008,34.43941863,-65.56058137,-570.1112822000001,-637.6570499,-0.031186691000000002,2655800,1,-0.6486
BSESN,12/1/2008,8839.870117,9326.679688,8803.339844,9162.94043,45200,-252.84961,252.84961,0.0,41.18613175,8316.389648,10570.58008,23.22254864,-76.77745136,-550.8584628,-620.2973325,-0.048556579,2610600,-1,-0.7579
BSESN,12/2/2008,8739.240234,8785.040039,8467.429688,8535.830078,41000,-100.62988299999999,100.62988299999999,0.0,38.95477131,8316.389648,10397.36035,20.31987212,-79.68012788,-537.5242107999999,-603.7427082,-0.022150108999999998,2569600,-1,0.29600000000000004
BSESN,12/3/2008,8747.429688,8854.80957,8601.410156,8851.219727,52400,8.189454,0.0,8.189454,39.26375995,8316.389648,9928.599609,26.73597425,-73.26402575,-520.2982255,-587.0538116,-0.003003333,2622000,1,0.3182
BSESN,12/4/2008,9229.75,9245.05957,8726.709961,8779.019531,55200,482.320312,0.0,482.320312,54.8083027,8316.389648,9826.25,60.49303505,-39.50696495,-462.3970642,-562.1224621,0.092147596,2677200,1,-0.0772
BSESN,12/5/2008,8965.200195,9340.69043,8914.379883,9172.580078,53000,-264.549805,264.549805,0.0,47.16820066,8316.389648,9424.25,58.56428979,-41.43571021,-432.8671124,-536.2713922,0.005607297,2624200,-1,0.0
BSESN,12/8/2008,9162.620117,9432.110352,9095.700195,9276.889648,50200,197.41992199999999,0.0,197.41992199999999,52.82994932,8316.389648,9432.110352,75.84608459999998,-24.1539154,-389.049554,-506.8270245,0.029147085,2674400,1,-0.4939
BSESN,12/10/2008,9654.900391,9678.700195,9280.160156,9349.530273,65000,492.280274,0.0,492.280274,63.9465377,8316.389648,9678.700195,98.25298248,-1.747017525,-311.01572369999997,-467.66476439999997,0.11032911,2739400,1,0.128
BSESN,12/11/2008,9645.459961,9746.009766,9441.969727,9679.320313,68800,-9.440430000000001,9.440430000000001,0.0,63.61480322,8316.389648,9746.009766,92.96667669,-7.03332331,-247.08685130000003,-423.5491818,0.068545413,2670600,-1,-0.7506
BSESN,12/12/2008,9690.070313,9745.509766,9281.889648,9370.870117,6400,44.610352,0.0,44.610352,64.61567015,8442.30957,9746.009766,95.70917814,-4.29082186,-190.62566280000001,-376.964478,0.06569548,2677000,1,-0.6486
BSESN,12/15/2008,9832.389648,9948.330078,9749.290039,9821.849609,47000,142.319335,0.0,142.319335,67.86916271,8467.429688,9948.330078,92.17095013,-7.829049866,-132.86420729999998,-328.14442379999997,0.112277615,2724000,1,-0.0258
BSESN,12/16/2008,9976.980469,10009.20996,9790.30957,9794.480469,41000,144.590821,0.0,144.590821,70.99545529,8467.429688,10009.20996,97.90959240000001,-2.0904076000000003,-74.56107325,-277.4277537,0.14163018800000002,2765000,1,-0.5244
BSESN,12/17/2008,9715.290039,10073.09961,9682.910156,10073.09961,75800,-261.69043,261.69043,0.0,59.00601552,8467.429688,10073.09961,77.71587016,-22.28412984,-48.9078706,-231.72377709999998,0.110645114,2689200,-1,-0.29600000000000004
BSESN,12/18/2008,10076.42969,10110.33984,9633.040039,9710.200195,69200,361.139649,0.0,361.139649,67.69349129,8467.429688,10110.33984,97.93597015,-2.064029848,0.557007985,-185.2676201,0.091733762,2758400,1,-0.6597
BSESN,12/19/2008,10099.91016,10188.54004,9987.419922,10001.33008,59600,23.480468,0.0,23.480468,68.19907459,8467.429688,10188.54004,94.85042415,-5.149575851,41.17828059,-139.97843989999998,0.126568279,2818000,1,-0.6369
BSESN,12/22/2008,9928.349609,10173.33984,9895.549805,10102.41992,39000,-171.56054699999999,171.56054699999999,0.0,60.24997173,8467.429688,10188.54004,84.88240862,-15.11759138,58.84905417,-100.2129411,0.083571018,2779000,-1,0.0
BSESN,12/23/2008,9686.75,9838.379883,9643.55957,9813.200195,52600,-241.599609,241.599609,0.0,50.65602219,8601.410156,10188.54004,68.38380749999999,-31.6161925,52.75012957,-69.62032699,0.003298802,2726400,-1,0.0
BSESN,12/24/2008,9568.719727,9653.419922,9502.530273,9626.070313,68800,-118.030273,118.030273,0.0,46.48362484,8726.709961,10188.54004,57.59970182,-42.40029818,37.95510841,-48.10523991,-0.007956099,2657600,-1,0.0516
BSESN,12/26/2008,9328.919922,9706.379883,9294.980469,9655.070313,43000,-239.799805,239.799805,0.0,38.960730100000006,8914.379883,10188.54004,32.53437467,-67.46562533,6.801701594,-37.12385161,-0.037270152,2614600,-1,0.0
BSESN,12/29/2008,9533.519531,9550.400391,9162.660156,9318.860352,65800,204.59960900000002,0.0,204.59960900000002,47.34938497,9095.700195,10188.54004,40.06253418,-59.93746582,-1.3624141580000002,-29.97156412,-0.030396488,2680400,1,-0.3612
BSESN,12/30/2008,9716.160156,9785.040039,9494.700195,9625.129883,56600,182.640625,0.0,182.640625,53.87813906,9162.660156,10188.54004,53.95368495,-46.04631505,6.826347452,-22.6119818,-0.026142209,2737000,1,0.0
BSESN,12/31/2008,9647.30957,9825.900391,9587.919922,9806.639648,63800,-68.85058599999999,68.85058599999999,0.0,51.12084522,9162.660156,10188.54004,47.24231579,-52.75768421,7.671896297999999,-16.55520618,-0.006997265999999999,2673200,-1,0.0
BSESN,1/2/2009,9958.219727,10070.280270000001,9863.860352,9973.05957,51600,310.91015699999997,0.0,310.91015699999997,61.41076163,9162.660156,10188.54004,77.54899809999999,-22.451001899999998,33.04888417,-6.634388112000001,-0.011731334,2724800,1,-0.1027
BSESN,1/5/2009,10275.59961,10306.16992,10069.11035,10124.91992,51200,317.379882,0.0,317.379882,69.07812959,9162.660156,10306.16992,97.32662423,-2.673375769,77.87256743,10.267003,0.01739515,2776000,1,0.0
BSESN,1/6/2009,10335.92969,10392.12012,10150.67969,10241.50977,55600,60.330079000000005,0.0,60.330079000000005,70.36941639,9162.660156,10392.12012,95.42966581,-4.570334194,116.91605700000001,31.596813800000003,0.041052148,2831600,1,-0.3612
BSESN,1/7/2009,9586.879883,10469.719729999999,9510.150391,10424.95996,217600,-749.049805,749.049805,0.0,44.02908163,9162.660156,10469.719729999999,32.45603616,-67.54396384,86.42004806,42.56146065,-0.010309971999999999,2614000,-1,0.0
BSESN,1/9/2009,9406.469727,9630.400391,9250.820313,9434.849609,158200,-180.410156,180.410156,0.0,39.88053038,9162.660156,10469.719729999999,18.65328684,-81.34671316,47.15062636,43.47929379,-0.016956291000000002,2455800,-1,-0.3182
BSESN,1/12/2009,9110.049805,9327.299805,9024.450195,9306.740234,98000,-296.41992200000004,296.41992200000004,0.0,33.83638261,9024.450195,10469.719729999999,5.922743689,-94.07725631,-7.799377312000001,33.22355957,-0.023461463999999998,2357800,-1,0.0
BSESN,1/13/2009,9071.360352,9261.0,8992.919922,9042.360352,45200,-38.689453,38.689453,0.0,33.0813079,8992.919922,10469.719729999999,5.311514109,-94.68848589,-53.84883083,15.80908149,-0.04847728900000001,2312600,-1,0.0
BSESN,1/14/2009,9370.490234,9412.969727,9071.360352,9223.160156,32000,299.129882,0.0,299.129882,44.19149783,8992.919922,10469.719729999999,25.56679048,-74.43320952,-65.45158781,-0.443052368,-0.035576804,2344600,1,0.0
BSESN,1/15/2009,9046.740234,9123.780273,8946.620117,9000.620117,37600,-323.75,323.75,0.0,36.60252541,8946.620117,10469.719729999999,6.573445121000001,-93.42655488,-99.6223907,-20.27892004,-0.06225252,2307000,-1,0.0
BSESN,1/16/2009,9323.589844,9342.469727,9125.650391,9125.650391,35400,276.84961,0.0,276.84961,45.78836404,8946.620117,10469.719729999999,24.75016897,-75.24983103,-103.17422020000001,-36.85798007,-0.063729251,2342400,1,0.0772
BSESN,1/19/2009,9329.570313,9409.509766,9273.469727,9365.040039,30000,5.980469,0.0,5.980469,45.98344414,8946.620117,10469.719729999999,25.14282017,-74.85717983,-104.3041436,-50.34721277,-0.092065605,2372400,1,-0.29600000000000004
BSESN,1/20/2009,9100.549805,9159.759766,9033.549805,9159.759766,31200,-229.020508,229.020508,0.0,39.67497275,8946.620117,10469.719729999999,10.10634413,-89.89365587,-122.27020220000001,-64.73181065,-0.119522861,2341200,-1,-0.0772
BSESN,1/21/2009,8779.169922,9051.30957,8734.929688,8900.780273,32400,-321.379883,321.379883,0.0,32.463687,8734.929688,10469.719729999999,2.550178005,-97.449822,-160.5899231,-83.90343313,-0.08425159900000001,2308800,-1,-0.4215
BSESN,1/22/2009,8813.839844,8927.69043,8699.320313,8905.969727,39200,34.669922,0.0,34.669922,33.95785463,8699.320313,10469.719729999999,6.468570317999999,-93.53142968,-186.01672,-104.3260905,-0.06300237,2348000,1,-0.802
BSESN,1/23/2009,8674.349609,8858.839844,8631.599609,8804.150391,44000,-139.490235,139.490235,0.0,30.794988099999998,8631.599609,10469.719729999999,2.325745721,-97.67425428,-214.94557719999997,-126.4499879,-0.047826324,2304000,-1,0.0
BSESN,1/27/2009,9004.080078,9021.969727,8791.580078,8803.070313,34200,329.73046899999997,0.0,329.73046899999997,44.81439419,8631.599609,10469.719729999999,20.26420718,-79.73579282,-208.85782869999997,-142.931556,-0.007416779,2338200,1,0.0
BSESN,1/28/2009,9257.469727,9270.75,9053.799805,9077.650391,39800,253.38964900000002,0.0,253.38964900000002,53.21771912,8631.599609,10469.719729999999,34.04946782,-65.95053218,-181.49465969999997,-150.64417680000003,-0.012061323,2378000,1,0.0
BSESN,1/29/2009,9236.280273,9379.679688,9164.959961,9340.589844,38800,-21.189454,21.189454,0.0,52.44712475,8631.599609,9630.400391,60.54066786,-39.45933214,-159.6782911,-152.45099960000002,0.020951197,2339200,-1,-0.3818
BSESN,1/30/2009,9424.240234,9438.30957,9088.150391,9111.120117,48000,187.95996100000002,0.0,187.95996100000002,58.58503284,8631.599609,9438.30957,98.25596104,-1.7440389580000002,-125.7720419,-147.1152081,0.01079524,2387200,1,0.5719
BSESN,2/2/2009,9066.700195,9363.580078,9048.969727,9363.580078,39800,-357.54003900000004,357.54003900000004,0.0,45.65176165,8631.599609,9438.30957,53.93519444,-46.06480556,-126.2957297,-142.9513124,-0.028176016,2347400,-1,0.0
BSESN,2/3/2009,9149.299805,9302.25,9040.55957,9128.990234,46000,82.59961,0.0,82.59961,48.67223679,8631.599609,9438.30957,64.17426597,-35.82573403,-118.67761609999998,-138.0965731,0.0053568190000000005,2393400,1,-0.6705
BSESN,2/4/2009,9201.849609,9338.209961,9164.160156,9226.200195,41600,52.549804,0.0,52.549804,50.68418599,8631.599609,9438.30957,70.68835487,-29.31164513,-107.16455,-131.9101685,0.048145745999999996,2435000,1,-0.5994
BSESN,2/5/2009,9090.879883,9247.089844,9017.080078,9241.55957,29600,-110.969726,110.969726,0.0,46.26540608,8631.599609,9438.30957,56.93251555,-43.06748445,-105.7753789,-126.6832106,0.031432389,2405400,-1,0.3182
BSESN,2/6/2009,9300.860352,9321.379883,9160.830078,9161.490234,28400,209.980469,0.0,209.980469,54.85814457,8631.599609,9438.30957,82.9617552,-17.0382448,-86.73100081,-118.6927686,0.072225674,2433800,1,-0.7506
BSESN,2/9/2009,9583.889648,9601.55957,9329.299805,9359.0,20000,283.029296,0.0,283.029296,63.84895557,8631.599609,9601.55957,98.17828336,-1.8217166390000001,-48.24396873,-104.6030086,0.064394093,2453800,1,0.0
BSESN,2/10/2009,9647.469727,9724.870117,9510.629883,9589.950195,45000,63.580079000000005,0.0,63.580079000000005,65.62362365,8631.599609,9724.870117,92.92028922,-7.079710779,-12.46860717,-86.17612835,0.042128142,2498800,1,-0.7351
BSESN,2/11/2009,9618.540039,9648.389648,9459.589844,9462.139648,37600,-28.929688,28.929688,0.0,63.97479404,8631.599609,9724.870117,90.27412912,-9.725870882,13.39483327,-66.26193603,0.041386766,2461200,-1,0.0
BSESN,2/12/2009,9465.830078,9578.990234,9445.540039,9559.030273,33800,-152.70996100000002,152.70996100000002,0.0,55.48388894,8631.599609,9724.870117,76.30595199,-23.69404801,21.32357366,-48.74483409,0.004413071,2427400,-1,-0.6908
BSESN,2/13/2009,9634.740234,9695.589844,9540.599609,9540.599609,30000,168.910156,0.0,168.910156,61.93211358,8791.580078,9724.870117,90.34277885,-9.657221146,40.76686051,-30.84249517,0.062651243,2457400,1,-0.5267
BSESN,2/16/2009,9305.450195,9637.040039,9279.099609,9637.040039,37200,-329.29003900000004,329.29003900000004,0.0,46.71188771,9017.080078,9724.870117,40.74232486,-59.25767514,29.26747403,-18.82050133,0.017066921999999998,2420200,-1,0.3818
BSESN,2/17/2009,9035.0,9213.400391,8994.339844,9213.400391,28400,-270.450195,270.450195,0.0,37.88794206,8994.339844,9724.870117,5.565841348999999,-94.43415865,-1.649923789,-15.38638582,-0.018132182,2391800,-1,0.0
BSESN,2/18/2009,9015.179688,9112.990234,8929.620117,8939.379883,36800,-19.820312,19.820312,0.0,37.29224558,8929.620117,9724.870117,10.75882691,-89.24117309,-27.43526123,-17.7961609,-0.008327048,2355000,-1,-0.6249
BSESN,2/19/2009,9042.629883,9111.269531,8977.799805,9034.900391,27400,27.450195,0.0,27.450195,38.82916564,8929.620117,9724.870117,14.21059616,-85.78940384,-45.13503699,-23.26393612,-0.027764149,2382400,1,-0.7717
BSESN,2/20/2009,8843.209961,8943.780273,8762.580078,8943.780273,28000,-199.41992199999999,199.41992199999999,0.0,32.21140933,8762.580078,9724.870117,8.378958498,-91.6210415,-74.3961652,-33.49038194,-0.077283829,2354400,-1,-0.3818
BSESN,2/24/2009,8822.05957,8856.519531,8619.219727,8707.349609,32400,-21.150391,21.150391,0.0,31.55330413,8619.219727,9724.870117,18.34574879,-81.65425121,-98.16094168,-46.42449389,-0.085557165,2322000,-1,0.0
BSESN,2/25/2009,8902.55957,8995.040039,8880.150391,8913.44043,32200,80.5,0.0,80.5,37.18898976,8619.219727,9724.870117,25.62653128,-74.37346872,-109.2397729,-58.98754969,-0.074437541,2354200,1,0.4767
BSESN,2/26/2009,8954.860352,8998.30957,8788.94043,8905.55957,37200,52.300782,0.0,52.300782,40.84055109,8619.219727,9724.870117,30.35684951,-69.64315049,-112.5027291,-69.69058557,-0.053980445999999994,2391400,1,-0.5994
BSESN,2/27/2009,8891.610352,8944.110352,8728.660156,8944.110352,42200,-63.25,63.25,0.0,37.77605105,8619.219727,9724.870117,24.6362347,-75.3637653,-118.8226778,-79.51700402,-0.077130246,2349200,-1,0.5574
BSESN,3/2/2009,8607.080078,8762.879883,8563.519531,8762.879883,30200,-284.530274,284.530274,0.0,27.18720808,8563.519531,9724.870117,3.7508524580000002,-96.24914754,-145.1176718,-92.63713757,-0.075049579,2319000,-1,0.0
BSESN,3/3/2009,8427.290039,8635.200195,8393.049805,8583.05957,35200,-179.79003899999998,179.79003899999998,0.0,22.57380173,8393.049805,9695.589844,2.628727945,-97.37127206,-178.4076255,-109.79123519999999,-0.06726175599999999,2283800,-1,0.0
BSESN,3/4/2009,8446.490234,8501.459961,8373.240234,8473.25,40600,19.200195,0.0,19.200195,24.15959174,8373.240234,9695.589844,5.539382282,-94.46061772,-200.9247232,-128.0179328,-0.063081322,2324400,1,0.0
BSESN,3/5/2009,8197.919922,8535.030273,8167.75,8535.030273,51400,-248.570312,248.570312,0.0,18.49964182,8167.75,9695.589844,1.974678309,-98.02532169,-236.1055543,-149.6354571,-0.093414192,2273000,-1,-0.5423
BSESN,3/6/2009,8325.820313,8347.099609,8047.169922,8103.75,52200,127.90039099999998,0.0,127.90039099999998,28.4512963,8047.169922,9637.040039,17.52661353,-82.47338647,-250.77534169999998,-169.863434,-0.058506996,2325200,1,0.0
BSESN,3/9/2009,8160.399901999999,8259.219727,8110.100098000001,8259.219727,26400,-165.420411,165.420411,0.0,24.06594985,8047.169922,9213.400391,9.709056915,-90.29094308,-272.6068565,-190.41211850000002,-0.075000589,2298800,-1,0.0
BSESN,3/12/2009,8343.75,8439.259766,8274.780273,8274.780273,36200,183.350098,0.0,183.350098,36.56965879,8047.169922,9112.990234,27.82646143,-72.17353857,-271.97847010000004,-206.7253888,-0.06276954,2335000,1,0.6908
BSESN,3/13/2009,8756.610352,8793.209961,8480.740234,8480.740234,49400,412.860352,0.0,412.860352,55.57573545,8047.169922,9111.269531,66.67049062,-33.32950938,-235.451946,-212.47070019999998,-0.022138815,2384400,1,0.0
BSESN,3/16/2009,8943.540039,8955.730469,8697.459961,8793.889648,49400,186.929687,0.0,186.929687,61.5885659,8047.169922,8998.30957,94.24169404,-5.758305956,-189.2393159,-207.82442340000003,0.0058403019999999995,2433800,1,-0.0516
BSESN,3/17/2009,8863.820313,9024.120117,8801.790039,8942.009766,47200,-79.719726,79.719726,0.0,57.74272419,8047.169922,9024.120117,83.59181411,-16.40818589,-157.23567419999998,-197.70667350000002,0.029828959,2386600,-1,0.0
BSESN,3/18/2009,8976.679688,9120.400391,8951.320313,8956.299805,45600,112.859375,0.0,112.859375,61.65410371,8047.169922,9120.400391,86.60858901,-13.39141099,-121.3667094,-182.4386807,0.065191734,2432200,1,0.4215
BSESN,3/19/2009,9001.75,9086.769531,8900.389648,9023.040039,36000,25.070312,0.0,25.070312,62.54276084,8047.169922,9120.400391,88.94455623,-11.05544377,-89.88123678,-163.9271919,0.06573852,2468200,1,-0.0258
BSESN,3/20/2009,8966.679688,8999.980469,8867.129883,8951.339844,32800,-35.070312,35.070312,0.0,60.28763199,8047.169922,9120.400391,85.67682269,-14.32317731,-66.98647557,-144.5390487,0.09377497900000001,2435400,-1,-0.29600000000000004
BSESN,3/23/2009,9424.019531,9454.69043,9040.299805,9040.299805,43200,457.339843,0.0,457.339843,74.25541590000002,8047.169922,9454.69043,97.82092703,-2.179072974,-11.80265551,-117.99176999999999,0.131902825,2478600,1,0.0
BSESN,3/24/2009,9471.040039,9699.0,9402.639648,9549.519531,50000,47.020508,0.0,47.020508,75.28658678,8047.169922,9699.0,86.19955139,-13.80044861,35.31795805,-87.32982441,0.160609793,2528600,1,0.29600000000000004
BSESN,3/25/2009,9667.900391,9704.69043,9430.450195,9442.299805,49400,196.860352,0.0,196.860352,79.29319362,8047.169922,9704.69043,97.78041727,-2.2195827340000003,87.53729354,-52.35640082,0.15869967199999999,2578000,1,0.1531
BSESN,3/26/2009,10003.09961,10061.36035,9739.929688,9739.929688,45200,335.19921800000003,0.0,335.19921800000003,84.29541675,8047.169922,10061.36035,97.10748586,-2.89251414,154.19184109999998,-11.04675244,0.142348375,2623200,1,-0.10099999999999999
BSESN,3/27/2009,10048.49023,10127.08984,9913.400391,10036.799809999999,52800,45.390625,0.0,45.390625,84.86662796,8047.169922,10127.08984,96.22102711,-3.7789728910000004,208.27779750000002,32.81815755,0.12354729699999999,2676000,1,-0.7351
BSESN,3/30/2009,9568.139648,9902.349609,9521.759766,9902.349609,41400,-480.350586,480.350586,0.0,58.76660148,8110.100098000001,10127.08984,72.28790096,-27.71209904,209.9607332,68.24667268,0.07946002,2634600,-1,0.0
BSESN,3/31/2009,9708.5,9826.219727,9547.209961,9633.209961,53000,140.360352,0.0,140.360352,62.64042603,8274.780273,10127.08984,77.40173399999999,-22.598266,220.08339480000004,98.61401711,0.08152461,2687600,1,0.0
BSESN,4/1/2009,9901.990234,9921.959961,9546.290039,9745.769531,45800,193.49023400000002,0.0,193.49023400000002,67.49745498,8480.740234,10127.08984,86.32735059999999,-13.672649400000001,240.9413006,127.07947379999999,0.100007247,2733400,1,0.0
BSESN,4/2/2009,10348.83008,10431.98047,10107.25,10107.25,64600,446.839844,0.0,446.839844,75.86011902,8697.459961,10431.98047,95.20614541,-4.7938545910000006,290.18253849999996,159.7000868,0.154142942,2798000,1,0.29600000000000004
BSESN,4/6/2009,10534.87012,10654.88965,10410.44043,10521.780270000001,53800,186.04003899999998,0.0,186.04003899999998,78.51565307,8801.790039,10654.88965,93.52330925,-6.4766907520000006,340.2957333,195.81921609999998,0.11787439300000001,2851800,1,-0.34
BSESN,4/8/2009,10742.33984,10778.11035,10173.0,10283.58008,56400,207.469727,0.0,207.469727,81.17968733,8867.129883,10778.11035,98.12815941,-1.871840586,392.23048539999996,235.1014699,0.13423022199999998,2908200,1,-0.4767
BSESN,4/9/2009,10803.86035,10929.33008,10655.95996,10876.15039,58400,61.52050799999999,0.0,61.52050799999999,81.94565844,8867.129883,10929.33008,93.91573494,-6.084265062999999,433.35786179999997,274.7527483,0.117498104,2966600,1,-0.0516
BSESN,4/13/2009,10967.219729999999,11069.54004,10800.83984,10916.42969,43000,163.359375,0.0,163.359375,83.94737946,8867.129883,11069.54004,95.35416636,-4.645833644,473.6731312,314.5368249,0.09638213699999999,3009600,1,0.5574
BSESN,4/15/2009,11284.73047,11337.75,10719.17969,10805.13965,70200,317.510742,0.0,317.510742,87.14399375,9040.299805,11337.75,97.6922446,-2.3077554030000003,525.1896763,356.6673952,0.12302746,3079800,1,0.0
BSESN,4/16/2009,10947.40039,11362.30957,10900.469729999999,11358.05957,60200,-337.33007799999996,337.33007799999996,0.0,70.04514451,9402.639648,11362.30957,78.82759875,-21.17240125,532.6570524,391.8653266,0.14415140199999998,3019600,-1,0.0
BSESN,4/17/2009,11023.08984,11339.469729999999,10946.25,11067.70996,53600,75.689453,0.0,75.689453,71.49326629999999,9430.450195,11362.30957,82.44076508,-17.55923492,538.4753,421.18732130000006,0.135406071,3073200,1,-0.6486
BSESN,4/20/2009,10979.5,11209.66016,10863.280270000001,11065.09961,43200,-43.589844,43.589844,0.0,69.26806765,9521.759766,11362.30957,79.20134684,-20.79865316,533.420033,443.6338636,0.108817494,3030000,-1,0.0
BSESN,4/21/2009,10898.11035,11068.82031,10764.08008,10765.38965,45000,-81.389648,81.389648,0.0,64.91514038,9521.759766,11362.30957,74.77931773,-25.22068227,516.8878714,458.28466519999995,0.053076557,2985000,-1,-0.2023
BSESN,4/22/2009,10817.54004,11036.24023,10715.66016,10968.59961,39000,-80.570313,80.570313,0.0,60.56761059,9521.759766,11362.30957,70.40180441,-29.59819559,491.6176016,464.9512525,0.026831837,2946000,-1,0.0
BSESN,4/23/2009,11134.99023,11200.86035,10758.969729999999,10841.57031,41800,317.450195,0.0,317.450195,69.77134121,9546.290039,11362.30957,87.48255004,-12.51744996,491.5401397,470.26902989999996,0.036551663,2987800,1,-0.2263
BSESN,4/24/2009,11329.049809999999,11362.87988,11070.33008,11149.469729999999,44600,194.059571,0.0,194.059571,74.04448774,9546.290039,11362.87988,98.13771512,-1.86228488,501.35838870000003,476.4869017,0.048611277,3032400,1,0.0
BSESN,4/27/2009,11371.84961,11492.09961,11176.549809999999,11237.41992,52400,42.799803999999995,0.0,42.799803999999995,74.94577754,10107.25,11492.09961,91.31674665,-8.683253345,506.7514925,482.5398198,0.036894481,3084800,1,0.0
BSESN,4/28/2009,11001.75,11371.33984,10961.75977,11371.33984,47600,-370.099609,370.099609,0.0,55.66113272,10173.0,11492.09961,62.82694607,-37.17305393,475.67829739999996,481.1675153,-0.025076405,3037200,-1,0.0
BSESN,4/29/2009,11403.25,11430.25,11091.55957,11091.55957,40400,401.5,0.0,401.5,66.46308802,10173.0,11492.09961,93.26437455,-6.735625452000001,477.9408563,480.5221835,0.041639987,3077600,1,-0.4588
BSESN,5/4/2009,12134.75,12160.32031,11635.24023,11635.24023,46400,731.5,0.0,731.5,77.82165606,10655.95996,12160.32031,98.30025346,-1.699746538,532.6201732,490.94178150000005,0.100848326,3124000,1,0.0
BSESN,5/5/2009,12131.08008,12197.87988,11985.87988,12159.74023,48400,-3.669922,3.669922,0.0,77.6693768,10715.66016,12197.87988,95.49325894,-4.506741058,569.0975911,506.57294339999993,0.104884565,3075600,-1,0.0
BSESN,5/6/2009,11952.75,12272.04004,11899.41016,12100.69043,49200,-178.33007800000001,178.33007800000001,0.0,69.99054233,10715.66016,12272.04004,79.48508314,-20.51491686,576.9655607999999,520.6514669,0.09677270800000001,3026400,-1,0.0
BSESN,5/7/2009,12116.94043,12143.9502,11981.12988,12064.50977,47800,164.19043,0.0,164.19043,72.84287647,10715.66016,12272.04004,90.03459177,-9.965408233,589.6526305,534.4516996,0.12011976699999999,3074200,1,0.0
BSESN,5/8/2009,11876.42969,12180.07031,11765.05957,12092.969729999999,55200,-240.510742,240.510742,0.0,62.76049433,10715.66016,12272.04004,74.58137597,-25.41862403,573.6869121,542.2987421,0.066586449,3019000,-1,0.5106
BSESN,5/11/2009,11682.99023,12026.59961,11621.299809999999,11997.37012,36000,-193.439454,193.439454,0.0,55.61654218,10715.66016,12272.04004,62.15256883,-37.84743117,539.2093482999999,541.6808632999999,0.031241846,2983000,-1,0.0
BSESN,5/12/2009,12158.030270000001,12194.62988,11625.38965,11629.969729999999,40000,475.040039,0.0,475.040039,66.44077584,10715.66016,12272.04004,92.67468262,-7.325317376,543.947108,542.1341123,0.069133931,3023000,1,0.0
BSESN,5/13/2009,12019.65039,12256.42969,11934.44043,12201.92969,217600,-138.379882,138.379882,0.0,61.40709984,10715.66016,12272.04004,83.78354470000001,-16.2164553,530.4213495,539.7915597,0.09252168,2805400,-1,0.0
BSESN,5/14/2009,11872.91016,11935.86035,11695.51953,11774.04004,39000,-146.740235,146.740235,0.0,56.19763882,10758.969729999999,12272.04004,73.62119395,-26.37880605,502.07378389999997,532.2480045,0.041186518,2766400,-1,0.0
BSESN,5/15/2009,12173.41992,12218.98047,11948.7002,11948.7002,35000,300.509766,0.0,300.509766,63.51207225,10961.75977,12272.04004,92.47335711,-7.526642889,498.1148031,525.4213642,0.0031867090000000002,2801400,1,0.0258
BSESN,5/18/2009,14284.20996,14284.20996,13479.38965,13479.38965,800,2110.790039,0.0,2110.790039,84.49547647,10961.75977,14284.20996,100.0,0.0,657.7186268999999,551.8808167999999,0.17748872100000002,2802200,1,-0.4019
BSESN,5/19/2009,14302.03027,14930.54004,13840.830080000002,14757.82031,89400,17.820312,0.0,17.820312,84.58184932,10961.75977,14930.54004,84.16365425,-15.83634575,776.6905522000001,596.8427638999999,0.19654726100000003,2891600,1,-0.29600000000000004
BSESN,5/20/2009,14060.66016,14405.509769999999,13976.490230000001,14230.730469999999,51000,-241.370117,241.370117,0.0,77.80766126,11091.55957,14930.54004,77.34086198,-22.65913802,841.7964039999999,645.8334919,0.160413409,2840600,-1,0.5859
BSESN,5/21/2009,13736.54004,14089.509769999999,13704.42969,14043.37988,44800,-324.120117,324.120117,0.0,69.21811481,11621.299809999999,14930.54004,63.91921059,-36.08078941,857.3564050000001,688.1380745,0.156622015,2795800,-1,0.0
BSESN,5/22/2009,13887.15039,13936.92969,13611.299809999999,13663.54004,39400,150.610352,0.0,150.610352,70.9382642,11621.299809999999,14930.54004,68.47041695,-31.52958305,871.7913466,724.868729,0.188664042,2835200,1,0.0
BSESN,5/25/2009,13913.21973,14027.59961,13819.78027,13999.44043,37400,26.069336,0.0,26.069336,71.25903538,11621.299809999999,14930.54004,69.258191,-30.741809000000003,875.2454349,754.9440701000001,0.144364623,2872600,1,0.0258
BSESN,5/26/2009,13589.230469999999,13991.45996,13524.92969,13983.259769999999,37800,-323.989258,323.989258,0.0,61.52149596,11621.299809999999,14930.54004,59.46774863,-40.53225137,842.1320255,772.3816612,0.13058450300000002,2834800,-1,0.0
BSESN,5/27/2009,14109.63965,14122.78027,13848.15039,13851.84961,47000,520.409179,0.0,520.409179,69.29733993,11621.299809999999,14930.54004,75.19369,-24.80631,848.1056474999999,787.5264585,0.188389322,2881800,1,0.0
BSESN,5/28/2009,14296.009769999999,14376.33984,14080.980469999999,14139.13965,42600,186.370118,0.0,186.370118,71.66355372,11621.299809999999,14930.54004,80.82549987,-19.17450013,857.9879460000001,801.618756,0.174362657,2924400,1,0.3182
BSESN,5/29/2009,14625.25,14726.59961,14384.759769999999,14384.759769999999,45200,329.240234,0.0,329.240234,75.51070135,11625.38965,14930.54004,90.76320279,-9.236797207,882.2170252999998,817.7384097999999,0.023875317000000004,2969600,1,-0.0772
BSESN,6/1/2009,14840.62988,14906.80957,14658.009769999999,14790.88965,44200,215.379883,0.0,215.379883,77.78705508,11695.51953,14930.54004,97.22072377,-2.77927623,908.3274681,835.8562215,0.037658962000000004,3013800,1,0.0
BSESN,6/2/2009,14874.91016,14994.21973,14608.230469999999,14942.20996,43800,34.280273,0.0,34.280273,78.15988045,11695.51953,14994.21973,96.38313384,-3.616866157,921.1676662999998,852.9185105,0.057909799000000005,3057600,1,0.0
BSESN,6/3/2009,14870.90039,15045.87988,14734.90039,14902.62012,43000,-4.009765,4.009765,0.0,77.98322662,11948.7002,15045.87988,94.35036034,-5.64963966,920.4101461000001,866.4168376,0.082579773,3014600,-1,-0.4404
BSESN,6/4/2009,15008.67969,15026.03027,14601.91016,14755.080080000002,39200,137.77929699999999,0.0,137.77929699999999,79.79387902,13479.38965,15045.87988,97.62525203,-2.374747966,920.3185839,877.1971868999999,0.080760218,3053800,1,0.0
BSESN,6/5/2009,15103.549809999999,15257.299809999999,14994.049809999999,15040.240230000001,36800,94.87011700000001,0.0,94.87011700000001,81.03315996,13524.92969,15257.299809999999,91.12487577,-8.87512423,917.3268727,885.223124,0.08555389099999999,3090600,1,0.0
BSESN,6/8/2009,14665.919919999998,15184.87012,14604.230469999999,15153.20996,31400,-437.629883,437.629883,0.0,61.09040102,13524.92969,15257.299809999999,65.86295981,-34.13704019,869.6184258999999,882.1021844,0.079231083,3059200,-1,-0.6908
BSESN,6/9/2009,15127.0,15159.269530000001,14526.69043,14618.980469999999,51600,461.080078,0.0,461.080078,70.05076249,13524.92969,15257.299809999999,92.47852386,-7.52147614,859.1111484999999,877.5039772,0.072103922,3110800,1,-0.8885
BSESN,6/10/2009,15466.80957,15580.80957,15168.17969,15168.17969,42400,339.80957,0.0,339.80957,74.95524053,13524.92969,15580.80957,94.45492896,-5.545071042000001,868.1958267000001,875.6423471,0.081896964,3153200,1,0.0
BSESN,6/11/2009,15411.46973,15568.740230000001,15242.19043,15517.36035,42000,-55.339843,55.339843,0.0,72.71756769,13524.92969,15580.80957,91.76314509,-8.23685491,861.0049082,872.7148593000001,0.053757695,3111200,-1,-0.7184
BSESN,6/12/2009,15237.94043,15600.299809999999,15174.28027,15446.82031,40600,-173.52929699999999,173.52929699999999,0.0,65.62878378,13524.92969,15600.299809999999,82.54001192,-17.45998808,831.7161831000001,864.5151241000001,0.026771812000000002,3070600,-1,-0.6249
BSESN,6/15/2009,14875.519530000001,15261.03027,14808.08984,15195.830080000002,34600,-362.420899,362.420899,0.0,53.14414105,13848.15039,15600.299809999999,58.63479061,-41.36520939,770.3798602,845.6880712999999,4.1e-05,3036000,-1,0.0
BSESN,6/16/2009,14957.91016,15022.19043,14621.96973,14788.269530000001,32000,82.390625,0.0,82.390625,55.37109123,14080.980469999999,15600.299809999999,57.71858925,-42.28141075,720.1175505,820.5739671,0.005851009,3068000,1,0.0
BSESN,6/17/2009,14522.83984,14995.66016,14447.92969,14978.5,35400,-435.070312,435.070312,0.0,42.93713756,14384.759769999999,15600.299809999999,11.35956641,-88.64043359,637.8253165,784.024237,-0.032370592000000004,3032600,-1,0.0
BSESN,6/18/2009,14265.53027,14630.730469999999,14188.25,14503.049809999999,75800,-257.309571,257.309571,0.0,37.231763,14188.25,15600.299809999999,5.4729141089999995,-94.52708589,545.5565598,736.3307016,-0.055484938,2956800,-1,-0.539
BSESN,6/19/2009,14521.88965,14559.080080000002,14179.769530000001,14321.980469999999,37400,256.359375,0.0,256.359375,45.5493161,14179.769530000001,15600.299809999999,24.08397225,-75.91602775,487.4993751,686.5644363,-0.009820746,2994200,1,0.0
BSESN,6/22/2009,14326.21973,14668.40039,14269.769530000001,14591.28027,31600,-195.669921,195.669921,0.0,40.78914046,14179.769530000001,15600.299809999999,10.30954417,-89.69045583,420.84843190000004,633.4212353999999,-0.05293715,2962600,-1,-0.5719
BSESN,6/23/2009,14324.009769999999,14394.19043,14016.9502,14147.87012,35600,-2.209961,2.209961,0.0,40.73366473,14016.9502,15600.299809999999,19.3930367,-80.60696329999999,363.6567452,579.4683374,-0.073887236,2927000,-1,-0.4939
BSESN,6/24/2009,14422.730469999999,14479.82031,14207.019530000001,14388.20996,30600,98.720703,0.0,98.720703,44.61617804,14016.9502,15600.299809999999,25.62796438,-74.37203562,322.579363,528.0905425,-0.064156065,2957600,1,-0.5267
BSESN,6/25/2009,14345.62012,14578.45996,14261.13965,14476.15039,29600,-77.110352,77.110352,0.0,42.1288296,14016.9502,15600.299809999999,20.75788695,-79.24211305,280.56885760000006,478.58620549999995,-0.058559115,2928000,-1,0.0
BSESN,6/26/2009,14764.63965,14781.94043,14373.57031,14373.57031,32400,419.01953100000003,0.0,419.01953100000003,57.11828607,14016.9502,15600.299809999999,47.22200633,-52.77799367,277.8833375,438.4456319,-0.007453849,2960400,1,0.0
BSESN,6/29/2009,14785.740230000001,14955.549809999999,14685.4502,14764.63965,26600,21.100586,0.0,21.100586,57.75408025,14016.9502,15600.299809999999,48.55466122,-51.44533878,274.2957735,405.6156602,-0.011510293000000001,2987000,1,0.1531
BSESN,6/30/2009,14493.83984,14907.480469999999,14420.41016,14785.740230000001,35200,-291.90039,291.90039,0.0,46.70150763,14016.9502,15600.299809999999,30.11903663,-69.88096337,245.073625,373.5072532,-0.001996855,2951800,-1,0.4364
BSESN,7/1/2009,14645.46973,14727.490230000001,14355.519530000001,14493.83984,28800,151.629883,0.0,151.629883,52.18597028,14016.9502,15600.299809999999,39.69556237,-60.30443763,231.48174869999997,345.1021523,0.026633392000000002,2980600,1,-0.34
BSESN,7/2/2009,14658.490230000001,14764.34961,14469.69043,14694.30957,31200,13.020507,0.0,13.020507,52.66854,14016.9502,15261.03027,51.56742322,-48.43257678,219.2335469,319.9284312,0.00940653,3011800,1,-0.7783
BSESN,7/3/2009,14913.049809999999,14945.84961,14499.740230000001,14552.71973,29000,254.559571,0.0,254.559571,61.44624268,14016.9502,15022.19043,89.14283161,-10.85716839,227.44573590000002,301.4318922,0.040961963,3040800,1,0.0
BSESN,7/6/2009,14043.40039,15097.87012,13959.44043,14962.12012,43400,-869.6494140000001,869.6494140000001,0.0,35.49697883,13959.44043,15097.87012,7.375067776,-92.62493222,161.9140705,273.5283278,-0.019590141000000002,2997400,-1,-0.7579
BSESN,7/7/2009,14170.4502,14251.87988,14000.67969,14103.65039,35800,127.04980400000001,0.0,127.04980400000001,39.78366534,13959.44043,15097.87012,18.53516009,-81.46483991,118.8614501,242.59495230000002,-0.017491852,3033200,1,0.0
BSESN,7/8/2009,13769.15039,14039.580080000002,13701.759769999999,14039.580080000002,37600,-401.299804,401.299804,0.0,32.02663007,13701.759769999999,15097.87012,4.8270271010000005,-95.1729729,51.76369813,204.4287014,-0.040184371,2995600,-1,0.3182
BSESN,7/9/2009,13757.45996,13879.17969,13643.96973,13796.19043,28400,-11.690430000000001,11.690430000000001,0.0,31.81809715,13643.96973,15097.87012,7.805915369,-92.19408463,-2.328235234,163.0773141,-0.068215663,2967200,-1,-0.4588
BSESN,7/10/2009,13504.21973,13897.19043,13418.38965,13803.12012,27800,-253.240234,253.240234,0.0,27.36458738,13418.38965,15097.87012,5.110513673,-94.88948633,-64.88292266,117.4852668,-0.08667273199999999,2939400,-1,0.0
BSESN,7/13/2009,13400.32031,13461.67969,13219.99023,13405.9502,24600,-103.89941400000001,103.89941400000001,0.0,25.66406647,13219.99023,15097.87012,9.602854828,-90.39714517,-121.44187120000001,69.69983916,-0.075447193,2914800,-1,0.0
BSESN,7/14/2009,13853.7002,13903.480469999999,13549.419919999998,13549.419919999998,23800,453.379882,0.0,453.379882,43.37987413,13219.99023,15097.87012,33.74603279,-66.25396721,-128.2034287,30.11918559,-0.05406242,2938600,1,-0.5267
BSESN,7/15/2009,14253.240230000001,14299.54004,13891.04004,13917.269530000001,27200,399.54003900000004,0.0,399.54003900000004,54.42426579,13219.99023,15097.87012,55.02215607,-44.97784393,-100.16779759999999,4.061788944,-0.027646094,2965800,1,-0.2732
BSESN,7/16/2009,14250.25,14493.09961,14169.580080000002,14351.96973,35000,-2.990234,2.990234,0.0,54.33274382,13219.99023,15097.87012,54.8629215,-45.137078499999994,-77.29958345,-12.21048553,-0.044444283,2930800,-1,0.0
BSESN,7/17/2009,14744.919919999998,14800.7002,14250.25,14325.580080000002,37600,494.669922,0.0,494.669922,65.42951267,13219.99023,15097.87012,81.20485777,-18.79514223,-19.04113601,-13.57661563,0.04995368,2968400,1,0.0
BSESN,7/20/2009,15191.009769999999,15209.36035,14854.169919999998,14854.169919999998,34800,446.089844,0.0,446.089844,72.40631042,13219.99023,15209.36035,99.07756803,-0.922431972,62.40545437,1.619798371,0.072020264,3003200,1,0.4019
BSESN,7/21/2009,15062.490230000001,15234.20996,14955.87988,15218.830080000002,35000,-128.519532,128.519532,0.0,67.8541088,13219.99023,15234.20996,91.47462788,-8.525372118,115.2534419,24.34652709,0.093930258,2968200,-1,0.0
BSESN,7/22/2009,14843.12012,15369.419919999998,14786.580080000002,15124.919919999998,41800,-219.370117,219.370117,0.0,60.37793231,13219.99023,15369.419919999998,75.51444423,-24.48555577,137.84552040000003,47.04632575,0.078914288,2926400,-1,0.0
BSESN,7/23/2009,15231.04004,15264.83984,14843.12012,15008.78027,55200,387.91992200000004,0.0,387.91992200000004,67.65044146,13219.99023,15369.419919999998,93.56201862,-6.437981376000001,184.92015659999998,74.62109193,0.127872646,2981600,1,0.0258
BSESN,7/24/2009,15378.95996,15418.61035,15168.519530000001,15272.009769999999,43200,147.91992199999999,0.0,147.91992199999999,70.06768259,13219.99023,15418.61035,98.19657836,-1.80342164,231.49452169999998,105.99577790000001,0.147656146,3024800,1,0.25
BSESN,7/27/2009,15375.04004,15463.08984,15228.45996,15350.88965,36600,-3.919922,3.919922,0.0,69.90795612,13219.99023,15463.08984,96.07463687,-3.925363127,265.0335944,137.80334119999998,0.109814694,2988200,-1,0.5574
BSESN,7/28/2009,15331.94043,15463.45996,15240.53027,15428.5,40800,-43.099609,43.099609,0.0,67.94302285,13219.99023,15463.45996,94.13767302,-5.862326976,284.8521743,167.21310780000002,0.075681051,2947400,-1,0.0
BSESN,7/29/2009,15173.45996,15379.42969,14888.41016,15293.19043,39000,-158.480469,158.480469,0.0,60.70386763,13219.99023,15463.45996,87.07359424,-12.92640576,284.4910565,190.6686975,0.064785527,2908400,-1,0.0
BSESN,7/30/2009,15387.95996,15409.91016,15065.480469999999,15169.230469999999,30400,214.5,0.0,214.5,66.30978023,13219.99023,15463.45996,96.63467712,-3.365322879,298.0771772,212.1503935,0.043610955,2938800,1,0.5859
BSESN,7/31/2009,15670.30957,15732.80957,15449.46973,15449.46973,34000,282.349609,0.0,282.349609,72.30954709999999,13549.419919999998,15732.80957,97.13747841,-2.862521587,327.8482984,235.2899744,0.031551543,2972800,1,0.0
BSESN,8/3/2009,15924.230469999999,15963.36035,15608.40039,15694.78027,32400,253.92089900000002,0.0,253.92089900000002,76.62848164,13891.04004,15963.36035,98.11178403,-1.888215965,367.6928862,261.7705568,0.057211007,3005200,1,-0.4767
BSESN,8/4/2009,15830.980469999999,16002.45996,15699.12988,15940.09961,43400,-93.25,93.25,0.0,71.87796713,14169.580080000002,16002.45996,90.64425915,-9.355740853,387.281177,286.8726808,0.06655341599999999,2961800,-1,0.0
BSESN,8/5/2009,15903.830080000002,15973.09961,15695.11035,15882.38965,29600,72.849609,0.0,72.849609,73.36632645,14250.25,16002.45996,94.37111504,-5.628884962000001,404.02603270000003,310.3033512,0.044172298,2991400,1,0.0
BSESN,8/6/2009,15514.03027,15969.80957,15443.21973,15881.46973,37800,-389.799805,389.799805,0.0,55.29753354,14786.580080000002,16002.45996,59.82911677,-40.17088323,381.4457952,324.53184,0.008782799,2953600,-1,0.0
BSESN,8/7/2009,15160.240230000001,15501.94043,15104.0,15440.9502,33200,-353.79003900000004,353.79003900000004,0.0,43.95951528,14786.580080000002,16002.45996,30.73166694,-69.26833306,331.185198,325.86251160000006,-0.013970683000000001,2920400,-1,0.4767
BSESN,8/10/2009,15009.769530000001,15417.33984,14902.019530000001,15287.13965,37200,-150.47070300000001,150.47070300000001,0.0,39.94067247,14786.580080000002,16002.45996,18.35620904,-81.64379096,276.0296861,315.8959465,-0.021013054,2883200,-1,-0.4767
BSESN,8/11/2009,15074.58984,15218.65039,14864.230469999999,15000.37988,31000,64.820313,0.0,64.820313,42.55124536,14843.12012,16002.45996,19.96564926,-80.03435074,234.84189190000004,299.6851356,-0.00651599,2914200,1,0.0
BSESN,8/12/2009,15020.16016,15043.62012,14701.049809999999,14953.44043,34000,-54.429688,54.429688,0.0,40.83165512,14701.049809999999,16002.45996,24.52035198,-75.47964802,195.5540223,278.85891289999995,-0.023901791000000002,2880200,-1,0.0
BSESN,8/13/2009,15518.490230000001,15545.12988,15207.95996,15207.95996,28800,498.330078,0.0,498.330078,58.53409154,14701.049809999999,16002.45996,62.81189871,-37.18810129,202.2972188,263.5465741,-0.009688343,2909000,1,0.0
BSESN,8/14/2009,15411.62988,15535.46973,15367.61035,15530.37988,28600,-106.860351,106.860351,0.0,54.49963866,14701.049809999999,16002.45996,54.6007786,-45.399221399999995,196.750496,250.1873585,-0.032189975,2880400,-1,0.0
BSESN,8/17/2009,14784.919919999998,15411.62988,14740.62988,15284.230469999999,25600,-626.709961,626.709961,0.0,37.16519008,14701.049809999999,16002.45996,6.444556822999999,-93.55544318,140.1686452,228.18361580000004,-0.06607680099999999,2854800,-1,0.0
BSESN,8/18/2009,15035.259769999999,15134.509769999999,14740.259769999999,14745.799809999999,29200,250.339844,0.0,250.339844,45.198913299999994,14701.049809999999,16002.45996,25.68060188,-74.31939812,114.21090179999999,205.389073,-0.054613907999999996,2884000,1,0.0
BSESN,8/19/2009,14809.63965,15096.94043,14684.4502,15079.04004,26600,-225.62011800000002,225.62011800000002,0.0,39.89462956,14684.4502,16002.45996,9.498370667,-90.50162933,74.57390367,179.2260392,-0.045403458,2857400,-1,-0.5106
BSESN,8/20/2009,15012.32031,15145.0,14928.17969,14930.049809999999,16800,202.680665,0.0,202.680665,46.41302096,14684.4502,16002.45996,24.8761524,-75.12384759999999,58.83768863,155.148369,-0.009757096,2874200,1,0.0
BSESN,8/21/2009,15240.830080000002,15275.169919999998,14835.080080000002,14951.490230000001,21400,228.509765,0.0,228.509765,53.03839547,14684.4502,16002.45996,42.21363888,-57.78636112,64.06692945,136.9320811,0.01539401,2895600,1,-0.6369
BSESN,8/24/2009,15628.75,15676.34961,15362.92969,15362.92969,19800,387.91992200000004,0.0,387.91992200000004,62.19417125,14684.4502,15973.09961,73.2782551,-26.721744899999997,98.37898451,129.22146180000001,0.03676121,2915400,1,0.0
BSESN,8/25/2009,15688.46973,15735.32031,15423.38965,15573.91016,29200,59.719727,0.0,59.719727,63.45963226,14684.4502,15969.80957,78.1119702,-21.8880298,128.9044875,129.1580669,0.044494171,2944600,1,-0.5719
BSESN,8/26/2009,15769.84961,15831.490230000001,15695.94043,15763.08984,20000,81.379882,0.0,81.379882,65.28661372,14684.4502,15831.490230000001,94.62611392,-5.373886081,157.8433253,134.8951186,0.016197411999999998,2964600,1,0.4939
BSESN,8/27/2009,15781.07031,15853.70996,15685.490230000001,15711.799809999999,18600,11.220704,0.0,11.220704,65.56056179,14684.4502,15853.70996,93.78755259,-6.212447406,179.6125185,143.8385986,0.023971535,2983200,1,0.0
BSESN,8/28/2009,15922.33984,15957.669919999998,15663.34961,15770.19043,30400,141.269531,0.0,141.269531,69.10271895,14684.4502,15957.669919999998,97.22513897,-2.774861028,205.89065219999998,156.2490093,0.076931084,3013600,1,0.4939
BSESN,8/31/2009,15666.63965,15821.34961,15589.799809999999,15812.15039,25600,-255.700196,255.700196,0.0,56.88384518,14684.4502,15957.669919999998,77.14217995,-22.85782005,203.7348649,165.74618049999998,0.04199328099999999,2988000,-1,0.128
BSESN,9/1/2009,15551.19043,15923.08984,15475.28027,15691.269530000001,26800,-115.44921799999999,115.44921799999999,0.0,52.08581123,14684.4502,15957.669919999998,68.07467844,-31.92532156,190.51446869999998,170.6998381,0.05007216900000001,2961200,-1,0.5719
BSESN,9/2/2009,15467.45996,15628.09961,15392.67969,15482.049809999999,23600,-83.730469,83.730469,0.0,48.65171131,14684.4502,15957.669919999998,61.49840042,-38.50159958,171.30614980000001,170.8211004,0.030317742,2937600,-1,0.0
BSESN,9/3/2009,15398.330080000002,15598.17969,15356.71973,15539.33984,22000,-69.12988299999999,69.12988299999999,0.0,45.77652171,14684.4502,15957.669919999998,56.0688676,-43.931132399999996,148.7900556,166.4148915,0.010334083,2915600,-1,0.0
BSESN,9/4/2009,15689.12012,15740.830080000002,15358.94043,15425.86035,30800,290.79003900000004,0.0,290.79003900000004,57.86286623,14684.4502,15957.669919999998,78.90781934,-21.09218066,152.6505542,163.662024,0.00386276,2946400,1,0.0
BSESN,9/7/2009,16016.32031,16035.5,15793.269530000001,15793.269530000001,25000,327.200196,0.0,327.200196,67.32020349,14684.4502,16035.5,98.58038638,-1.4196136169999998,180.0369939,166.937018,0.02089755,2971400,1,0.3818
BSESN,9/8/2009,16123.669919999998,16232.16016,16030.55957,16030.55957,35000,107.34960900000002,0.0,107.34960900000002,69.87939287,14835.080080000002,16232.16016,92.23450139,-7.7654986070000005,208.0054042,175.15069530000002,0.022436505,3006400,1,-0.7506
BSESN,9/9/2009,16183.549809999999,16215.740230000001,16044.769530000001,16111.08984,30600,59.87988299999999,0.0,59.87988299999999,71.32469775,14835.080080000002,16232.16016,96.52057518,-3.4794248210000003,232.3242873,186.58541369999998,0.025503941000000002,3037000,1,0.0
BSESN,9/10/2009,16216.86035,16434.76953,16166.419919999998,16295.919919999998,30000,33.310547,0.0,33.310547,72.18149538,15356.71973,16434.76953,79.78672431,-20.21327569,251.38722459999997,199.5457758,0.018497313,3067000,1,0.0
BSESN,9/11/2009,16264.299809999999,16337.980469999999,16130.32031,16254.57031,28200,47.439453,0.0,47.439453,73.48344211,15356.71973,16434.76953,84.18721237,-15.81278763,267.2421065,213.085042,0.038148586,3095200,1,0.0
BSESN,9/14/2009,16214.19043,16252.17969,16119.9502,16185.259769999999,23600,-50.109375,50.109375,0.0,69.51806643,15356.71973,16434.76953,79.53906209,-20.46093791,272.6211994,224.99227349999998,0.042633392,3071600,-1,-0.4019
BSESN,9/15/2009,16454.44922,16477.23047,16255.419919999998,16255.419919999998,19600,240.258789,0.0,240.258789,76.52600218,15356.71973,16477.23047,97.96688696,-2.033113039,292.8947374,238.5727662,0.063810688,3091200,1,0.0
BSESN,9/16/2009,16677.03906,16700.56055,16498.58984,16498.58984,30200,222.589844,0.0,222.589844,81.15697466,15356.71973,16700.56055,98.24968228,-1.75031772,323.19718639999996,255.4976503,0.083042056,3121400,1,0.4404
BSESN,9/17/2009,16711.10938,16820.01953,16636.55078,16686.38086,44200,34.070312,0.0,34.070312,81.79139978,15356.71973,16820.01953,92.55722199,-7.4427780079999994,345.9731223,273.59274469999997,0.065139998,3165600,1,0.0
BSESN,9/18/2009,16741.30078,16765.0293,16610.05078,16650.05078,28000,30.191406,0.0,30.191406,82.39738505,15356.71973,16820.01953,94.6204633,-5.379536701,362.2832341,291.33084260000004,0.045265108,3193600,1,0.0
BSESN,9/22/2009,16886.42969,16943.49023,16763.7793,16805.2207,22800,145.128907,0.0,145.128907,85.14030904,15356.71973,16943.49023,96.40398244,-3.596017556,382.51046260000004,309.5667666,0.047306833,3216400,1,0.0
BSESN,9/23/2009,16719.5,16905.58008,16683.7793,16905.5,48400,-166.929688,166.929688,0.0,70.55009254,15356.71973,16943.49023,85.88389228,-14.11610772,380.68258430000003,323.78993010000005,0.033116974,3168000,-1,0.0
BSESN,9/24/2009,16781.42969,16834.09961,16494.91992,16634.08008,24600,61.929688,0.0,61.929688,72.56279509999999,15358.94043,16943.49023,89.77245489,-10.22754511,379.8524829,335.00244069999997,0.034813726,3192600,1,0.0
BSESN,9/25/2009,16693.0,16812.01953,16613.2207,16679.99023,20400,-88.429688,88.429688,0.0,65.21905539,15793.269530000001,16943.49023,78.22241998,-21.77758002,367.8190952,341.5657716,0.026358355,3172200,-1,0.0
BSESN,9/29/2009,16852.91016,16907.83984,16802.80078,16829.10938,16000,159.910156,0.0,159.910156,71.28314959,16030.55957,16943.49023,90.07809886,-9.921901145,366.9559224,346.6438018,0.039392638,3188200,1,-0.29600000000000004
BSESN,9/30/2009,17126.83984,17142.51953,16868.46094,16868.46094,20600,273.929688,0.0,273.929688,78.64308556,16044.769530000001,17142.51953,98.57165229,-1.428347711,383.9497546,354.1049923,0.040863758,3208800,1,0.0
BSESN,10/1/2009,17134.55078,17195.60938,17059.35938,17186.19922,28000,7.7109369999999995,0.0,7.7109369999999995,78.81940144,16119.9502,17195.60938,94.3236115,-5.676388501,393.50363219999997,361.98472030000005,0.02743363,3236800,1,-0.3818
BSESN,10/5/2009,16866.41016,17062.00977,16835.80078,17062.00977,24800,-268.140625,268.140625,0.0,59.20704879,16119.9502,17195.60938,69.39558318,-30.60441682,375.1143567,364.61064760000005,0.009293266,3212000,-1,-0.2732
BSESN,10/6/2009,16958.53906,16988.56055,16622.05078,16879.38086,50200,92.128907,0.0,92.128907,62.86978186,16119.9502,17195.60938,77.96046216,-22.03953784,363.7813118,364.44478039999996,0.012976188999999999,3262200,1,0.3412
BSESN,10/7/2009,16806.66016,17120.56055,16764.07031,17069.41992,32800,-151.878907,151.878907,0.0,53.69846918,16255.419919999998,17195.60938,58.6307613,-41.369238700000004,338.6407932,359.28398300000003,-0.004723884,3229400,-1,0.0
BSESN,10/8/2009,16843.53906,16998.51953,16775.35938,16908.01953,37000,36.878907,0.0,36.878907,55.51656331,16494.91992,17195.60938,49.75373034,-50.24626966,318.0265586,351.0324981,0.007418826,3266400,1,0.29600000000000004
BSESN,10/9/2009,16642.66016,16963.08008,16606.94922,16915.96094,27000,-200.878907,200.878907,0.0,44.52764504,16494.91992,17195.60938,21.08498042,-78.91501958,282.22704239999996,337.271407,-0.008269232,3239400,-1,0.0
BSESN,10/12/2009,17026.66992,17068.7793,16687.32031,16687.32031,24200,384.009766,0.0,384.009766,61.38648117,16494.91992,17195.60938,75.88953961,-24.11046039,281.5959835,326.1363223,0.019988613,3263600,1,-0.5106
BSESN,10/14/2009,17231.10938,17274.58984,17117.90039,17117.90039,31800,204.43945300000001,0.0,204.43945300000001,67.46116093,16494.91992,17274.58984,94.42322093,-5.576779067,294.2010535,319.7492685,0.022441182,3295400,1,0.0
BSESN,10/15/2009,17195.19922,17350.39063,17092.83008,17274.07031,30200,-35.910156,35.910156,0.0,65.37663613,16494.91992,17350.39063,81.85894555,-18.14105445,297.8594742,315.3713097,0.00399136,3265200,-1,0.0
BSESN,10/16/2009,17322.82031,17347.84961,17126.55078,17196.80078,28200,127.621094,0.0,127.621094,69.27034931,16494.91992,17350.39063,96.77717637,-3.2228236339999996,307.5119484,313.7994374,0.010987713,3293400,1,0.4215
BSESN,10/20/2009,17223.00977,17457.25977,17185.03906,17414.80078,24600,-99.810547,99.810547,0.0,62.88821627,16606.94922,17457.25977,72.45124139,-27.54875861,303.60792349999997,311.76113460000005,0.021142591000000002,3268800,-1,-0.2263
BSESN,10/21/2009,17009.16992,17248.68945,16997.85938,17229.7207,25600,-213.839844,213.839844,0.0,51.22188875,16606.94922,17457.25977,47.30280066,-52.69719934,280.0308461,305.4150769,0.002985567,3243200,-1,-0.128
BSESN,10/22/2009,16789.74023,17031.53906,16721.25977,17031.53906,25600,-219.429688,219.429688,0.0,41.99740609,16606.94922,17457.25977,21.49697139,-78.50302861,240.8631797,292.5046975,-0.001006739,3217600,-1,-0.5859
BSESN,10/23/2009,16810.81055,17006.76953,16765.19922,16795.66016,24400,21.070313,0.0,21.070313,43.13209592,16606.94922,17457.25977,23.97492642,-76.02507358,209.11220469999998,275.82619889999995,-0.00194309,3242000,1,0.25
BSESN,10/26/2009,16740.5,16938.88086,16706.08008,16808.05078,22000,-70.310547,70.310547,0.0,40.11083105,16606.94922,17457.25977,15.70611837,-84.29388163,176.244221,255.90980330000002,0.005878858000000001,3220000,-1,-0.7351
BSESN,10/27/2009,16353.40039,16699.08984,16311.5,16699.08984,30800,-387.099609,387.099609,0.0,27.75878593,16311.5,17457.25977,3.656996191,-96.34300381,117.60472970000001,228.24878859999998,-0.039542056,3189200,-1,-0.128
BSESN,10/28/2009,16283.490230000001,16411.14063,16144.169919999998,16335.78027,29600,-69.910157,69.910157,0.0,26.08487835,16144.169919999998,17457.25977,10.61011268,-89.38988732,64.74500488,195.5480319,-0.054994668,3159600,-1,-0.5859
BSESN,10/29/2009,16052.71973,16264.08984,15993.830080000002,16191.38965,26200,-230.77050699999998,230.77050699999998,0.0,21.21277559,15993.830080000002,17457.25977,4.02408462,-95.97591538,4.183812437,157.27518799999999,-0.066441771,3133400,-1,-0.2584
BSESN,10/30/2009,15896.28027,16360.87988,15805.2002,16135.87012,38600,-156.439454,156.439454,0.0,18.50870757,15805.2002,17457.25977,5.51312311,-94.48687689,-55.79159464,114.66183149999999,-0.082350334,3094800,-1,0.34
BSESN,11/3/2009,15404.94043,15957.05957,15330.55957,15838.62988,32400,-491.339843,491.339843,0.0,12.66020716,15330.55957,17457.25977,3.49747746,-96.50252254,-141.34027319999998,63.46141053,-0.10556048900000001,3062400,-1,0.0
BSESN,11/4/2009,15912.12988,15929.08984,15487.96973,15487.96973,30400,507.189453,0.0,507.189453,36.54295979,15330.55957,17457.25977,27.3461353,-72.6538647,-166.29531830000002,17.51006477,-0.064496977,3092800,1,0.0
BSESN,11/5/2009,16063.90039,16092.37988,15564.88965,15926.12988,33800,151.770508,0.0,151.770508,42.01734554,15330.55957,17457.25977,34.48256705,-65.51743295,-171.8448394,-20.36091606,-0.043231154,3126600,1,-0.29600000000000004
BSESN,11/6/2009,16158.28027,16283.86035,16075.19043,16137.419919999998,28200,94.379882,0.0,94.379882,45.39729124,15330.55957,17457.25977,38.92042257,-61.07957743,-166.70552949999998,-49.62983875,-0.03881611,3154800,1,0.0
BSESN,11/9/2009,16498.7207,16517.41992,16147.20996,16190.79004,20400,340.44043,0.0,340.44043,56.05829586,15330.55957,17457.25977,54.92834087,-45.07165913,-133.6215855,-66.42818809,-0.014442776000000001,3175200,1,0.0
BSESN,11/10/2009,16440.56055,16677.5293,16371.66016,16552.42969,26600,-58.16015600000001,58.16015600000001,0.0,53.98072891,15330.55957,17248.68945,57.86891633,-42.13108367,-110.81792,-75.30613446,0.005329788,3148600,-1,0.3612
BSESN,11/11/2009,16849.59961,16887.80078,16405.18945,16444.43945,26600,409.039062,0.0,409.039062,64.62090816,15330.55957,17031.53906,89.30384201,-10.69615799,-59.0590213,-72.05671183,0.03476585,3175200,1,0.0
BSESN,11/12/2009,16696.0293,16896.61914,16605.00977,16822.17969,27200,-153.570312,153.570312,0.0,58.73767143,15330.55957,17006.76953,81.46173563,-18.53826437,-30.08476352,-63.66232217,0.040074802,3148000,-1,-0.0516
BSESN,11/13/2009,16848.83008,16909.74023,16666.69922,16693.15039,21400,152.800781,0.0,152.800781,62.64238045,15330.55957,16938.88086,94.40094578,-5.59905422,5.147948192,-49.90026809,0.059922811,3169400,1,0.0
BSESN,11/16/2009,17032.50977,17083.19922,16893.10938,16893.10938,19000,183.679688,0.0,183.679688,66.97685838,15330.55957,17083.19922,97.10782231,-2.892177695,47.34576925,-30.45106063,0.105652426,3188400,1,0.0
BSESN,11/17/2009,17050.65039,17080.16992,16882.98047,17036.23047,20400,18.140625,0.0,18.140625,67.40779202,15330.55957,17083.19922,98.14286821,-1.857131785,81.31430262,-8.097987975,0.071550479,3208800,1,0.0
BSESN,11/18/2009,16998.7793,17098.78906,16958.41016,17032.00977,18200,-51.871094,51.871094,0.0,64.62541223,15330.55957,17098.78906,94.34407319,-5.655926812000001,102.8633022,14.09427005,0.058197504000000004,3190600,-1,0.0
BSESN,11/19/2009,16785.65039,17004.98047,16712.33008,17004.98047,18200,-213.128906,213.128906,0.0,54.04858332,15330.55957,17098.78906,82.29083537,-17.70916463,101.57245400000001,31.58990684,0.03882654,3172400,-1,-0.7269
BSESN,11/20/2009,17021.84961,17041.78906,16635.75,16772.75,22400,236.19921800000003,0.0,236.19921800000003,62.00113929999999,15330.55957,17098.78906,95.64878573,-4.351214269,118.2456877,48.92106302,0.031707241000000004,3194800,1,0.0
BSESN,11/23/2009,17180.17969,17214.58008,17045.01953,17067.14063,22000,158.330079,0.0,158.330079,66.487075,15487.96973,17214.58008,98.00763444,-1.992365561,142.5915531,67.65516103,0.044987465,3216800,1,0.0
BSESN,11/24/2009,17131.08008,17230.85938,17027.51953,17230.85938,18200,-49.09961,49.09961,0.0,63.79235512,15564.88965,17230.85938,94.01073769,-5.989262312999999,156.12419609999998,85.34896804,0.016705469,3198600,-1,0.0
BSESN,11/25/2009,17198.94922,17290.48047,17124.15039,17149.08008,17000,67.869141,0.0,67.869141,65.99079739,16075.19043,17290.48047,92.4683617,-7.531638297000001,170.3615635,102.35148709999999,0.030122127000000002,3215600,1,0.0
BSESN,11/26/2009,16854.92969,17202.50977,16808.86914,17199.05078,24000,-344.01953100000003,344.01953100000003,0.0,48.6974325,16147.20996,17290.48047,61.90308611,-38.09691389,152.1316003,112.3075098,0.00036202,3191600,-1,0.3818
BSESN,11/27/2009,16632.00977,16718.80078,16210.44043,16718.80078,28400,-222.919922,222.919922,0.0,40.71916363,16210.44043,17290.48047,39.03275071,-60.96724929,118.3323864,113.5124851,-0.023513857000000003,3163200,-1,0.0
BSESN,11/30/2009,16926.2207,17026.91016,16655.75,16655.75,23200,294.210937,0.0,294.210937,52.55613294,16210.44043,17290.48047,66.27349424,-33.72650576,113.9728219,113.6045525,-0.007297651,3186400,1,0.0
BSESN,12/1/2009,17198.26953,17218.46094,16947.46094,16947.46094,20000,272.04882799999996,0.0,272.04882799999996,60.88847202,16210.44043,17290.48047,91.46226671,-8.537733294,130.9602739,117.07569679999999,0.011735562,3206400,1,-0.2263
BSESN,12/2/2009,17169.91016,17329.67969,17142.35938,17226.49023,22200,-28.359375,28.359375,0.0,59.62884787,16210.44043,17329.67969,85.72516726,-14.27483274,140.51482009999998,121.76352140000002,0.022892158,3184200,-1,-0.3818
BSESN,12/3/2009,17185.67969,17361.26953,17128.21094,17199.64063,18200,15.769532,0.0,15.769532,60.157683299999995,16210.44043,17361.26953,84.74231814,-15.25768186,147.65723559999998,126.94226429999999,0.009624693,3202400,1,-0.6597
BSESN,12/4/2009,17101.53906,17291.83008,17032.81055,17182.23047,18200,-84.140625,84.140625,0.0,55.66824735,16210.44043,17361.26953,77.43101319,-22.56898681,144.8583689,130.5254852,-0.004577404,3184200,-1,0.3374
BSESN,12/7/2009,16983.14063,17176.61914,16943.00977,17106.74023,21000,-118.39843799999998,118.39843799999998,0.0,49.65200141,16210.44043,17361.26953,67.14291412,-32.85708588,131.5698274,130.7343536,-0.008635734,3163200,-1,0.0
BSESN,12/8/2009,17227.67969,17237.78906,16964.10938,16984.53906,18600,244.539063,0.0,244.539063,59.96354774,16210.44043,17361.26953,88.39186089,-11.60813911,139.1665953,132.420802,0.001670478,3181800,1,0.0
BSESN,12/9/2009,17125.2207,17227.96094,17057.36914,17204.32031,21800,-102.458985,102.458985,0.0,54.5612829,16210.44043,17361.26953,79.48880266,-20.51119734,135.3591686,133.00847530000001,0.016036318,3160000,-1,0.1027
BSESN,12/10/2009,17189.31055,17231.05078,17032.30078,17107.0,19200,64.089844,0.0,64.089844,57.33551103,16210.44043,17361.26953,85.05781755,-14.94218245,135.9461674,133.59601370000001,0.033507722999999996,3179200,1,0.0
BSESN,12/11/2009,17119.0293,17351.71094,17056.11914,17199.74023,19200,-70.28125,70.28125,0.0,53.22382133,16210.44043,17361.26953,78.9508074,-21.0491926,129.2503413,132.7268792,0.011391119,3160000,-1,0.0516
BSESN,12/14/2009,17097.55078,17275.18945,17048.16992,17118.14063,17200,-21.478516,21.478516,0.0,51.91110874,16210.44043,17361.26953,77.08445591,-22.91554409,120.81799939999999,130.3451033,-0.00585633,3142800,-1,0.4939
BSESN,12/15/2009,16877.16016,17200.4707,16835.7793,17150.58984,18600,-220.390625,220.390625,0.0,40.17851085,16210.44043,17361.26953,57.9338605,-42.0661395,95.25360189,123.326803,-0.017050177,3124200,-1,0.0
BSESN,12/16/2009,16912.76953,16996.11914,16777.93945,16866.94922,19400,35.609375,0.0,35.609375,42.597232299999995,16210.44043,17361.26953,61.02809708,-38.97190292,76.97963831,114.05736999999999,-0.015880091000000002,3143600,1,0.0
BSESN,12/17/2009,16894.25,16979.51953,16826.0,16912.25,22000,-18.519531,18.519531,0.0,41.5881836,16655.75,17361.26953,33.80487563,-66.19512437,60.30782804,103.3074616,-0.012121076000000001,3121600,-1,0.0
BSESN,12/18/2009,16719.83008,16899.18945,16693.06055,16855.91016,18600,-174.41992199999999,174.41992199999999,0.0,33.0741798,16693.06055,17361.26953,4.0061614919999995,-95.99383851,32.6447598,89.17492128,-0.015504232,3103000,-1,-0.6597
BSESN,12/21/2009,16601.19922,16750.99023,16577.7793,16724.83984,17200,-118.63085900000002,118.63085900000002,0.0,28.4959597,16577.7793,17361.26953,2.989178548,-97.01082145,1.135965328,71.56713009,-0.036364762,3085800,-1,0.0
BSESN,12/22/2009,16692.0,16738.11914,16633.81055,16633.81055,14400,90.800781,0.0,90.800781,36.2850821,16577.7793,17361.26953,14.578446300000001,-85.4215537,-16.31999043,53.98970598,-0.025297233,3100200,1,-0.29600000000000004
BSESN,1/4/2010,17558.73047,17582.83984,17378.38086,17473.44922,28200,866.730469,0.0,866.730469,71.03573053,16577.7793,17582.83984,97.60120173,-2.3987982690000003,39.33056586,51.05787796,0.021491259,3128400,1,-0.7783
BSESN,1/5/2010,17686.24023,17729.7793,17555.76953,17555.76953,27000,127.50976499999999,0.0,127.50976499999999,73.49008564,16577.7793,17729.7793,96.22056745,-3.779432552,92.65493663,59.37728969,0.033133359,3155400,1,0.4019
BSESN,1/6/2010,17701.13086,17790.33008,17636.71094,17719.4707,21400,14.890625,0.0,14.890625,73.78936022,16577.7793,17790.33008,92.64367147,-7.356328526,134.56524919999998,74.41488159,0.035302137000000004,3176800,1,0.0
BSESN,1/7/2010,17615.7207,17733.33984,17566.53906,17701.9707,18000,-85.410156,85.410156,0.0,68.65948786,16577.7793,17790.33008,85.59982990000002,-14.4001701,159.05411130000002,91.34272753,0.043760949,3158800,-1,0.6539
BSESN,1/8/2010,17540.28906,17658.11914,17508.96094,17603.86914,17200,-75.43164,75.43164,0.0,64.11715458,16577.7793,17790.33008,79.37892425,-20.62107575,170.41062040000003,107.1563061,0.037103298,3141600,-1,0.0
BSESN,1/11/2010,17526.71094,17776.57031,17500.78906,17724.58984,18400,-13.578125,13.578125,0.0,63.24807429,16577.7793,17790.33008,78.25912579,-21.74087421,176.2830137,120.9816476,0.037436461000000004,3123200,-1,-0.7506
BSESN,1/12/2010,17422.50977,17612.0,17392.55078,17534.09961,18600,-104.201172,104.201172,0.0,56.47030888,16577.7793,17790.33008,69.66557461,-30.33442539,170.5626242,130.8978429,0.042026724,3104600,-1,-0.6808
BSESN,1/13/2010,17509.80078,17528.31055,17276.46094,17368.0293,26200,87.291015,0.0,87.291015,60.55599567,16577.7793,17790.33008,76.86453208,-23.13546792,171.1004897,138.93837230000003,0.05473108,3130800,1,-0.4019
BSESN,1/14/2010,17584.86914,17628.03906,17525.71094,17525.71094,23400,75.06836,0.0,75.06836,63.9166343,16577.7793,17790.33008,83.05547774,-16.94452226,175.56039040000002,146.2627759,0.053490842000000004,3154200,1,0.0
BSESN,1/15/2010,17554.30078,17639.84961,17529.10938,17604.31055,17600,-30.56836,30.56836,0.0,61.456429500000006,16577.7793,17790.33008,80.53448147,-19.46551853,174.6154247,151.93330569999998,-0.000252278,3136600,-1,0.0
BSESN,1/18/2010,17641.08008,17712.59961,17505.5,17538.7207,15400,86.779297,0.0,86.779297,65.7719344,16577.7793,17790.33008,87.69123716,-12.30876284,178.8077126,157.3081871,-0.0025534060000000003,3152000,1,0.0
BSESN,1/19/2010,17486.06055,17664.85938,17463.7793,17650.82031,13400,-155.019531,155.019531,0.0,53.43923604,16577.7793,17790.33008,74.90665663,-25.09334337,167.6883436,159.3842184,-0.012150089,3138600,-1,0.0
BSESN,1/20/2010,17474.49023,17590.58984,17425.05078,17486.68945,17000,-11.570313,11.570313,0.0,52.59000222,16633.81055,17790.33008,72.69048766,-27.30951234,156.142621,158.7358989,-0.008017297,3121600,-1,0.6124
BSESN,1/21/2010,17051.14063,17474.49023,17025.25977,17474.49023,17200,-423.349609,423.349609,0.0,31.47373107,17025.25977,17790.33008,3.382807906,-96.61719209,111.54594499999999,149.2979081,-0.027887137000000003,3104400,-1,-0.3612
BSESN,1/22/2010,16859.67969,17000.33008,16608.08984,16978.35938,23200,-191.460937,191.460937,0.0,26.02148921,16608.08984,17790.33008,21.2807716,-78.7192284,60.06111341,131.4505492,-0.038057982000000004,3081200,-1,-0.0258
BSESN,1/25/2010,16780.46094,16877.76953,16705.56055,16847.69922,16400,-79.21875,79.21875,0.0,24.03381455,16608.08984,17790.33008,14.58003958,-85.41996042,12.72009305,107.70445790000001,-0.036851683999999996,3064800,-1,0.0
BSESN,1/27/2010,16289.82031,16708.59961,16230.84961,16708.59961,25600,-490.640625,490.640625,0.0,15.547019400000002,16230.84961,17776.57031,3.815094399,-96.1849056,-63.65483137,73.43260008,-0.069674149,3039200,-1,0.0
BSESN,1/28/2010,16306.87012,16524.68945,16182.13965,16317.16016,21600,17.049804,0.0,17.049804,16.72607381,16182.13965,17776.57031,7.822884478,-92.17711552,-121.4072256,34.46463494,-0.072676061,3060800,1,0.0
BSESN,1/29/2010,16357.95996,16390.31055,15982.080080000002,16253.82031,25400,51.089844,0.0,51.089844,20.56065227,15982.080080000002,17776.57031,20.94633204,-79.05366796,-161.1957267,-4.667437385,-0.068150867,3086200,1,0.0
BSESN,2/1/2010,16356.03027,16422.40039,16160.799809999999,16339.32031,20000,-1.929688,1.929688,0.0,20.51947332,15982.080080000002,17712.59961,21.60912884,-78.39087116,-190.6860006,-41.87115004,-0.072844168,3066200,-1,0.0
BSESN,2/2/2010,16163.44043,16525.98047,16129.11035,16368.44043,20600,-192.589843,192.589843,0.0,16.67383797,15982.080080000002,17712.59961,10.48011009,-89.51988991,-226.9811486,-78.89314975,-0.075638542,3045600,-1,0.0
BSESN,2/3/2010,16496.05078,16552.99023,16210.25,16210.25,16400,332.610351,0.0,332.610351,39.33151303,15982.080080000002,17712.59961,29.70036996,-70.29963004,-226.29781890000004,-108.37408359999999,-0.055992445999999994,3062000,1,0.3818
BSESN,2/4/2010,16224.9502,16508.2207,16188.799809999999,16500.28906,15800,-271.10058599999996,271.10058599999996,0.0,31.32170713,15982.080080000002,17712.59961,14.03452042,-85.96547958,-244.8098117,-135.66122919999998,-0.048453675,3046200,-1,-0.3818
BSESN,2/5/2010,15790.92969,16222.55957,15725.42969,16222.55957,23000,-434.020507,434.020507,0.0,22.75970018,15725.42969,17712.59961,3.2961449000000003,-96.7038551,-291.1463728,-166.75825790000002,-0.06339088400000001,3023200,-1,0.0
BSESN,2/8/2010,15935.61035,16061.41016,15651.990230000001,15931.33984,26600,144.68066399999998,0.0,144.68066399999998,30.108289399999997,15651.990230000001,17664.85938,14.09034061,-85.90965939,-312.59056150000004,-195.9247186,-0.050347280999999994,3049800,1,-0.128
BSESN,2/9/2010,16042.17969,16094.12988,15862.90039,15940.730469999999,21200,106.569336,0.0,106.569336,35.33689907,15651.990230000001,17590.58984,20.12738742,-79.87261258,-317.3280208,-220.2053791,-0.01520217,3071000,1,-0.3818
BSESN,2/10/2010,15922.169919999998,16141.12988,15892.009769999999,16042.17969,19800,-120.00976599999998,120.00976599999998,0.0,32.20625946,15651.990230000001,17474.49023,14.82467424,-85.17532576,-326.9968604,-241.5636753,-0.023591296,3051200,-1,0.0
BSESN,2/11/2010,16152.58984,16202.87012,15928.28027,15928.28027,14400,230.419922,0.0,230.419922,43.32910815,15651.990230000001,17000.33008,37.12710948,-62.87289052,-312.4646257,-255.7438654,-0.012554751000000001,3065600,1,0.0
BSESN,2/15/2010,16038.34961,16227.04004,16011.82031,16186.90039,17000,-114.24023500000001,114.24023500000001,0.0,39.61125678,15651.990230000001,16877.76953,31.51948935,-68.48051065,-306.6313025,-265.92135279999997,-0.019422846,3048600,-1,-0.2263
BSESN,2/16/2010,16226.67969,16310.38965,16021.29004,16042.17969,20600,188.330079,0.0,188.330079,48.08463669,15651.990230000001,16708.59961,54.38996356,-45.61003644,-283.54317910000003,-269.4457181,0.003912487,3069200,1,0.0
BSESN,2/17/2010,16428.91016,16480.89063,16228.91016,16228.91016,19600,202.230468,0.0,202.230468,55.77343852,15651.990230000001,16552.99023,86.22862619,-13.77137381,-246.0905872,-264.77469190000005,-0.004070103,3088800,1,-0.128
BSESN,2/18/2010,16327.83984,16452.50977,16287.169919999998,16421.19922,14000,-101.070312,101.070312,0.0,51.3848693,15651.990230000001,16552.99023,75.01105549,-24.98894451,-222.00552620000002,-256.2208588,0.006341446,3074800,-1,0.0
BSESN,2/19/2010,16191.62988,16301.94043,16074.580080000002,16256.53027,19400,-136.20996100000002,136.20996100000002,0.0,45.78300027,15651.990230000001,16552.99023,59.89341276,-40.10658724,-211.4712386,-247.2709347,0.025375339,3055400,-1,0.0
BSESN,2/22/2010,16237.049809999999,16423.23047,16191.32031,16191.32031,14000,45.419922,0.0,45.419922,47.96559793,15651.990230000001,16552.99023,64.93446959,-35.06553041,-197.1847091,-237.25368959999997,0.018916091,3069400,1,0.0
BSESN,2/23/2010,16286.32031,16324.92969,16178.91016,16213.13965,13400,49.270508,0.0,49.270508,50.46173024,15651.990230000001,16552.99023,70.40289445,-29.59710555,-179.8140291,-225.7657575,0.015218668999999999,3082800,1,0.0
BSESN,2/24/2010,16255.96973,16328.44043,16187.44043,16218.67969,12400,-30.350586,30.350586,0.0,48.79791074,15651.990230000001,16508.2207,70.53936,-29.46064,-166.5764886,-213.9279037,0.020964467,3070400,-1,-0.204
BSESN,2/25/2010,16254.2002,16329.330080000002,16167.12988,16264.09961,12200,-1.7695319999999999,1.7695319999999999,0.0,48.68991111,15651.990230000001,16480.89063,72.65166811,-27.34833189,-154.4480479,-202.03193259999998,0.0062906540000000006,3058200,-1,-0.6597
BSESN,2/26/2010,16429.55078,16669.25,16249.669919999998,16255.330080000002,31000,175.35058600000002,0.0,175.35058600000002,59.05206016,15651.990230000001,16669.25,76.43677387,-23.56322613,-129.1975357,-187.4650532,0.02439161,3089200,1,0.0
BSESN,3/2/2010,16772.56055,16808.49023,16438.44922,16438.44922,22400,343.009766,0.0,343.009766,71.87295516,15862.90039,16808.49023,96.2002884,-3.799711605,-80.57943179,-166.0879289,0.033640946,3111600,1,-0.29600000000000004
BSESN,3/3/2010,17000.00977,17012.60938,16778.28906,16778.28906,20000,227.449219,0.0,227.449219,77.30882596,15892.009769999999,17012.60938,98.87563686,-1.1243631440000001,-23.42594341,-137.5555318,0.034761868,3131600,1,0.0
BSESN,3/4/2010,16971.69922,17024.96094,16888.05078,17013.67969,19000,-28.310546999999996,28.310546999999996,0.0,75.22099276,15928.28027,17024.96094,95.14337029,-4.85662971,19.36100179,-106.17222509999999,0.039433225,3112600,-1,0.0
BSESN,3/5/2010,16994.49023,17097.71094,16936.11914,16988.28906,19600,22.791014999999998,0.0,22.791014999999998,75.82738505,16011.82031,17097.71094,90.49437378,-9.505626223,54.48098566,-74.04158293,0.0495849,3132200,1,-0.2321
BSESN,3/8/2010,17102.59961,17187.55078,17034.91992,17034.91992,15200,108.109375,0.0,108.109375,78.68267414,16021.29004,17187.55078,92.71593659,-7.284063412,89.9998863,-41.23328909,0.053307086,3147400,1,0.0
BSESN,3/9/2010,17052.53906,17130.83008,17031.21094,17089.2207,56600,-50.060546,50.060546,0.0,74.01170505,16074.580080000002,17187.55078,87.8692478,-12.1307522,112.8090112,-10.42482903,0.047046769,3090800,-1,0.6486
BSESN,3/10/2010,17098.33008,17183.50977,17027.91992,17072.93945,16800,45.791015,0.0,45.791015,75.54401173,16074.580080000002,17187.55078,91.98355332,-8.016446683,133.04667990000002,18.26947276,0.051818524000000005,3107600,1,0.0
BSESN,3/11/2010,17167.96094,17215.07031,17054.2793,17087.63086,11400,69.63086,0.0,69.63086,77.83682783,16074.580080000002,17215.07031,95.86937498,-4.13062502,152.9408003,45.20373828,0.0562169,3119000,1,0.0772
BSESN,3/12/2010,17166.61914,17244.53906,17126.92969,17176.01953,24000,-1.341797,1.341797,0.0,77.67490886,16167.12988,17244.53906,92.76784313,-7.2321568670000005,166.67740890000002,69.49847240000001,0.044862356,3095000,-1,0.0
BSESN,3/15/2010,17164.99023,17195.49023,17061.14063,17166.9707,14200,-1.6289069999999999,1.6289069999999999,0.0,77.44923197,16167.12988,17244.53906,92.61665573,-7.383344274,175.41031,90.68083992,0.023397124,3080800,-1,0.0
BSESN,3/16/2010,17383.17969,17416.55078,17150.06055,17169.83984,12400,218.189454,0.0,218.189454,84.43751688,16167.12988,17416.55078,97.32907517,-2.67092483,197.6587753,112.076427,0.022539394,3093200,1,-0.4215
BSESN,3/17/2010,17490.08008,17576.7793,17389.4707,17389.4707,16800,106.90038999999999,0.0,106.90038999999999,86.75744482,16167.12988,17576.7793,93.84958997,-6.150410034,221.36505380000003,133.9341524,0.03054384,3110000,1,-0.2732
BSESN,3/18/2010,17519.25977,17548.13086,17417.60938,17492.81055,13600,29.179688,0.0,29.179688,87.35131333,16249.669919999998,17576.7793,95.66580328,-4.33419672,239.7433946,155.0960008,0.030878804,3123600,1,0.0
BSESN,3/19/2010,17578.23047,17600.86914,17502.14063,17531.4707,13800,58.970703,0.0,58.970703,88.54880596,16438.44922,17600.86914,98.0524532,-1.9475468009999999,256.11447680000003,175.29969599999998,0.027810442,3137400,1,0.0
BSESN,3/22/2010,17410.57031,17559.17969,17337.38086,17481.96094,12200,-167.660156,167.660156,0.0,67.56476399,16778.28906,17600.86914,76.86561672,-23.13438328,252.6475404,190.7692649,0.020995774,3125200,-1,0.4939
BSESN,3/23/2010,17451.01953,17530.78906,17356.64063,17422.50977,12600,40.449218,0.0,40.449218,69.57204151,16888.05078,17600.86914,78.97786892,-21.02213108,250.27882369999998,202.6711766,0.020627128999999998,3137800,1,0.0
BSESN,3/25/2010,17558.84961,17575.23047,17383.21094,17458.50977,13800,107.830078,0.0,107.830078,74.43794812,16936.11914,17600.86914,93.67889703,-6.321102971,254.17264069999996,212.97146949999998,0.022768497000000002,3151600,1,0.0
BSESN,3/26/2010,17644.75977,17682.93945,17558.84961,17558.84961,13000,85.910157,0.0,85.910157,77.71416316,17027.91992,17682.93945,94.17121396,-5.828786042999999,261.1800297,222.6131815,0.027852929,3164600,1,0.4767
BSESN,3/29/2010,17711.34961,17793.00977,17639.17969,17639.17969,14800,66.589843,0.0,66.589843,80.00601925,17027.91992,17793.00977,89.32672318,-10.67327682,269.00574889999996,231.89169500000003,0.031829868,3179400,1,0.6808
BSESN,3/30/2010,17590.16992,17783.34961,17558.2207,17703.66992,12600,-121.17968700000002,121.17968700000002,0.0,65.79780373,17027.91992,17793.00977,73.48810135,-26.51189865,262.4046622,237.99428840000002,0.011907501000000001,3166800,-1,0.0
BSESN,3/31/2010,17527.76953,17699.5,17488.55078,17602.39063,13600,-62.400391000000006,62.400391000000006,0.0,59.51767923,17054.2793,17793.00977,64.09512723,-35.90487277,249.26469509999998,240.24836980000003,0.002154905,3153200,-1,-0.3582
BSESN,4/1/2010,17692.61914,17706.56055,17555.03906,17555.03906,13000,164.84961,0.0,164.84961,68.64123818,17061.14063,17793.00977,86.28298156,-13.71701844,249.27962200000002,242.05462020000002,0.00989536,3166200,1,0.25
BSESN,4/5/2010,17935.67969,17948.53906,17693.66016,17693.66016,12800,243.060547,0.0,243.060547,77.33241502,17061.14063,17948.53906,98.55089051,-1.4491094919999998,265.8399688,246.81168990000003,0.020334767,3179000,1,0.0
BSESN,4/6/2010,17941.36914,17991.41016,17898.0,17940.32031,12400,5.689453,0.0,5.689453,77.50083362,17150.06055,17991.41016,94.05229236,-5.947707642999999,276.2389437,252.69714069999998,0.030487159,3191400,1,0.0
BSESN,4/7/2010,17970.01953,18047.85938,17878.31055,17915.59961,13200,28.65039,0.0,28.65039,78.43194928,17337.38086,18047.85938,89.04402565,-10.95597435,283.52376780000003,258.8624661,0.029740383,3204600,1,-0.4404
BSESN,4/8/2010,17714.40039,17960.91016,17679.33984,17950.56055,11800,-255.61914,255.61914,0.0,54.99991626,17337.38086,18047.85938,53.06557813,-46.93442187,265.60894049999996,260.21176099999997,0.008858825,3192800,-1,-0.1027
BSESN,4/9/2010,17933.14063,17971.4707,17715.16016,17715.16016,12200,218.740234,0.0,218.740234,65.25050244,17337.38086,18047.85938,83.85331190000001,-16.1466881,265.995588,261.3685264,0.016343711,3205000,1,0.0
BSESN,4/12/2010,17853.0,17995.25,17816.18945,17874.16016,9800,-80.140625,80.140625,0.0,59.51906641,17337.38086,18047.85938,72.57350214,-27.42649786,256.8742439,260.4696699,0.007997719,3195200,-1,0.0
BSESN,4/13/2010,17821.96094,17892.7793,17736.08984,17831.38086,12800,-31.039062,31.039062,0.0,57.27095523,17356.64063,18047.85938,67.318821,-32.681179,244.3244993,257.2406358,0.013177303999999999,3182400,-1,0.0258
BSESN,4/15/2010,17639.25977,17975.57031,17619.01953,17804.55078,12600,-182.70117199999999,182.70117199999999,0.0,45.578571999999994,17383.21094,18047.85938,38.52394947,-61.47605053,217.13330109999998,249.2191688,0.006360777,3169800,-1,0.0
BSESN,4/16/2010,17591.17969,17663.99023,17529.55078,17645.91016,11600,-48.080078,48.080078,0.0,42.91797225,17488.55078,18047.85938,18.3492455,-81.6507545,189.5197544,237.27928599999998,-0.0057334330000000005,3158200,-1,0.0
BSESN,4/19/2010,17400.67969,17584.85938,17276.80078,17584.85938,11800,-190.5,190.5,0.0,33.87722408,17276.80078,18047.85938,16.06608213,-83.93391787,150.52885880000002,219.92920049999998,-0.029828811,3146400,-1,0.0
BSESN,4/20/2010,17460.58008,17560.08984,17394.67969,17394.67969,14000,59.90039,0.0,59.90039,38.57199258,17276.80078,18047.85938,23.83467332,-76.16532668,123.0433864,200.5520377,-0.026797791,3160400,1,0.0
BSESN,4/21/2010,17472.56055,17565.55078,17446.50977,17458.75977,10000,11.980469,0.0,11.980469,39.56228447,17276.80078,18047.85938,25.38844227,-74.61155773,101.0626875,180.6541677,-0.027682718,3170400,1,0.0
BSESN,4/22/2010,17573.99023,17778.33984,17408.01953,17476.48047,17600,101.429687,0.0,101.429687,47.78526143,17276.80078,18047.85938,38.54304398,-61.45695602,90.78088774,162.67951169999998,-0.007926329000000001,3188000,1,0.0
BSESN,4/23/2010,17694.19922,17725.88086,17533.88086,17533.88086,17200,120.20898500000001,0.0,120.20898500000001,55.97611481,17276.80078,18047.85938,54.13316721,-45.86683279,91.28012732,148.39963480000003,-0.013324013000000001,3205200,1,0.0
BSESN,4/26/2010,17745.2793,17826.48047,17692.25977,17692.25977,14800,51.080078,0.0,51.080078,59.120287600000005,17276.80078,18047.85938,60.757836,-39.242164,94.70580413,137.66086869999998,-0.0060337590000000005,3220000,1,0.0
BSESN,4/27/2010,17690.61914,17769.25,17678.56055,17744.92969,12200,-54.66015600000001,54.66015600000001,0.0,54.32935756,17276.80078,18047.85938,53.66886035,-46.33113965,91.95011621,128.5187182,-0.00736966,3207800,-1,-0.29600000000000004
BSESN,4/28/2010,17380.08008,17643.58984,17344.58008,17643.58984,17000,-310.539063,310.539063,0.0,35.48103095,17276.80078,17995.25,14.37530925,-85.62469075,63.97088997,115.6091525,-0.014693343000000001,3190800,-1,0.34
BSESN,4/29/2010,17503.4707,17532.85938,17382.08984,17382.08984,10800,123.390625,0.0,123.390625,44.33493449,17276.80078,17995.25,31.54988773,-68.45011227,51.16395756,102.7201135,-0.004985964,3201600,1,-0.5106
BSESN,4/30/2010,17558.71094,17646.60938,17503.4707,17503.4707,12200,55.240235,0.0,55.240235,48.01968062,17276.80078,17995.25,39.23870324,-60.76129676,44.95359955,91.16681075,0.009081901,3213800,1,0.0
BSESN,5/3/2010,17386.08008,17536.85938,17345.91992,17536.85938,10400,-172.63086,172.63086,0.0,38.76647896,17276.80078,17975.57031,15.63881824,-84.36118176,25.80451998,78.09435259,-0.004266754,3203400,-1,0.2263
BSESN,5/4/2010,17137.14063,17464.82031,17101.96094,17371.75,19800,-248.939453,248.939453,0.0,29.35466897,17101.96094,17975.57031,4.0269356080000005,-95.97306439,-9.350806653,60.60532074,-0.019196953,3183600,-1,0.128
BSESN,5/5/2010,17087.96094,17121.66016,16858.23047,17103.94922,20000,-49.179687,49.179687,0.0,27.81530756,16858.23047,17826.48047,23.72635879,-76.27364121,-40.71075774,40.34210505,-0.027656172000000003,3163600,-1,0.0
BSESN,5/6/2010,16987.5293,17080.4707,16823.0,17080.4707,16400,-100.431641,100.431641,0.0,24.75629185,16823.0,17826.48047,16.3958644,-83.60413559999999,-72.82822061,17.70803991,-0.039937943,3147200,-1,0.0
BSESN,5/7/2010,16769.10938,16939.58008,16684.13086,16939.58008,19400,-218.419922,218.419922,0.0,19.40188504,16684.13086,17826.48047,7.438923711,-92.56107629,-114.58533519999999,-8.75063511,-0.055010119,3127800,-1,0.0
BSESN,5/10/2010,17330.55078,17356.53906,16799.49023,16799.49023,19800,561.4414059999999,0.0,561.4414059999999,50.89923988,16684.13086,17826.48047,56.58687291,-43.41312709,-101.2078589,-27.24207986,-0.020353632,3147600,1,-0.5423
BSESN,5/11/2010,17141.5293,17379.15039,17104.44922,17336.13086,20400,-189.02148400000002,189.02148400000002,0.0,44.19061001,16684.13086,17826.48047,40.0401448,-59.9598552,-104.6522011,-42.72410411,-0.013725528,3127200,-1,0.0
BSESN,5/12/2010,17195.81055,17252.51953,17028.08008,17141.5293,18400,54.28125,0.0,54.28125,46.52596069,16684.13086,17826.48047,44.79186438,-55.20813562,-101.8280139,-54.54488607,-0.017577093999999998,3145600,1,0.0
BSESN,5/13/2010,17265.86914,17389.15039,17240.34961,17323.63086,18000,70.058594,0.0,70.058594,49.66280745,16684.13086,17826.48047,50.9247149,-49.0752851,-92.86617874,-62.20914461,-0.016677864,3163600,1,0.0
BSESN,5/14/2010,16994.59961,17329.32031,16923.65039,17267.25,15200,-271.26953199999997,271.26953199999997,0.0,39.34989375,16684.13086,17769.25,28.61148958,-71.38851042,-106.42622859999999,-71.05256141,-0.022516891,3148400,-1,0.3612
BSESN,5/17/2010,16835.56055,16961.91992,16551.0,16961.91992,20400,-159.039062,159.039062,0.0,34.50305705,16551.0,17646.60938,25.97281052,-74.02718948,-128.52424150000002,-82.54689743,-0.01759804,3128000,-1,0.0
BSESN,5/18/2010,16875.75977,17000.33984,16744.13086,16840.58984,16800,40.199219,0.0,40.199219,36.77433329,16551.0,17646.60938,29.64193018,-70.35806982,-141.1660605,-94.27073004,-0.012418168,3144800,1,0.0516
BSESN,5/19/2010,16408.49023,16802.39063,16373.32031,16802.39063,22200,-467.269532,467.269532,0.0,25.10021436,16373.32031,17646.60938,2.762131715,-97.23786829,-186.7369518,-112.7639744,-0.034086126,3122600,-1,0.0
BSESN,5/20/2010,16519.67969,16617.80078,16419.09961,16419.09961,21600,111.189454,0.0,111.189454,31.10517223,16373.32031,17536.85938,12.57881061,-87.42118939,-211.44277119999998,-132.4997338,-0.014874355,3144200,1,0.0
BSESN,5/21/2010,16445.60938,16486.74023,16187.03027,16317.94043,24200,-74.070313,74.070313,0.0,29.29958158,16187.03027,17464.82031,20.23643117,-79.76356883,-234.2983211,-152.8594512,-0.051062509000000006,3120000,-1,0.0
BSESN,5/24/2010,16469.55078,16757.73047,16413.0293,16494.60938,22200,23.941406,0.0,23.941406,30.79774879,16187.03027,17389.15039,23.50185341,-76.49814659,-247.62516890000003,-171.8125948,-0.039201783,3142200,1,0.4404
BSESN,5/25/2010,16022.480469999999,16444.57031,15960.15039,16444.57031,21600,-447.070312,447.070312,0.0,21.14394587,15960.15039,17389.15039,4.361796921,-95.63820308,-290.9082207,-195.63172,-0.068233485,3120600,-1,0.0
BSESN,5/26/2010,16387.83984,16410.34961,16069.78027,16069.78027,18400,365.359375,0.0,365.359375,39.13445016,15960.15039,17389.15039,29.92928293,-70.07071707,-292.3587731,-214.97713059999998,-0.05085346599999999,3139000,1,0.0258
BSESN,5/27/2010,16666.40039,16694.55078,16331.09961,16410.88086,18800,278.56054700000004,0.0,278.56054700000004,49.30843825,15960.15039,17389.15039,49.4226732,-50.5773268,-267.9421676,-225.570138,-0.019311971,3157800,1,0.0
BSESN,5/28/2010,16863.06055,16891.16992,16692.66016,16692.66016,19000,196.660156,0.0,196.660156,55.38361273,15960.15039,17389.15039,63.18475549,-36.81524451,-230.0708869,-226.4702878,0.0016334470000000001,3176800,1,-0.5574
BSESN,5/31/2010,16944.63086,16971.15039,16806.5,16872.16992,15600,81.570312,0.0,81.570312,57.80385853,15960.15039,17389.15039,68.89296487,-31.10703513,-191.27073169999997,-219.43037650000002,0.0040810659999999995,3192400,1,-0.34
BSESN,6/1/2010,16572.0293,16942.82031,16318.38965,16942.82031,20600,-372.601562,372.601562,0.0,44.95180184,15960.15039,17389.15039,42.81867782,-57.18132218,-188.41522769999997,-213.22734680000002,0.009966734,3171800,-1,0.0
BSESN,6/2/2010,16741.83984,16774.15039,16571.44922,16574.78906,29000,169.81054699999999,0.0,169.81054699999999,50.71422669,15960.15039,17329.32031,57.09221627,-42.90778373,-170.484687,-204.6788148,0.013448212,3200800,1,-0.5423
BSESN,6/3/2010,17022.33008,17072.63086,16786.2793,16786.2793,21800,280.490234,0.0,280.490234,58.91172075,15960.15039,17072.63086,95.4785021,-4.521497900000001,-132.1184077,-190.1667334,0.035068369,3222600,1,0.0
BSESN,6/4/2010,17117.68945,17150.41992,16963.91992,17036.55078,22400,95.359375,0.0,95.359375,61.42836127,15960.15039,17150.41992,97.25016325,-2.749836751,-92.94671851,-170.7227304,0.039353755,3245000,1,0.0
BSESN,6/7/2010,16781.07031,17069.76953,16686.73047,17069.76953,26000,-336.61914,336.61914,0.0,49.16334856,15960.15039,17150.41992,68.96924609,-31.03075391,-88.05023563,-154.1882315,0.047345344000000004,3219000,-1,0.0
BSESN,6/8/2010,16617.09961,16895.73047,16560.64063,16760.59961,27400,-163.970704,163.970704,0.0,44.20285638,15960.15039,17150.41992,55.19331554,-44.80668446,-96.29082246,-142.6087497,0.013989627,3191600,-1,0.1779
BSESN,6/9/2010,16657.89063,16817.68945,16591.25977,16621.11914,36600,40.791016,0.0,40.791016,45.77337137,15960.15039,17150.41992,58.6203558,-41.3796442,-98.39580719,-133.7661612,-0.0005105940000000001,3228200,1,0.0
BSESN,6/10/2010,16922.08008,16942.59961,16668.91016,16668.91016,24800,264.18945299999996,0.0,264.18945299999996,55.19732112,15960.15039,17150.41992,80.81612290000001,-19.1838771,-77.84874989,-122.5826789,0.00349993,3253000,1,0.0
BSESN,6/11/2010,17064.94922,17131.56055,16994.07031,16994.07031,24600,142.86914099999998,0.0,142.86914099999998,59.58043593,15960.15039,17150.41992,92.81921441,-7.1807855929999995,-49.46649432,-107.959442,0.007100678000000001,3277600,1,0.2263
BSESN,6/14/2010,17338.16992,17351.17969,17118.74023,17118.74023,17400,273.22070299999996,0.0,273.22070299999996,66.7568041,16069.78027,17351.17969,98.98472203,-1.015277972,-4.870579955,-87.34166959,0.046230948,3295000,1,0.0
BSESN,6/15/2010,17412.83008,17442.5,17249.46094,17355.49023,22400,74.660156,0.0,74.660156,68.51911764,16318.38965,17442.5,97.36058636,-2.6394136440000002,36.0805401,-62.65722765,0.040078644,3317400,1,-0.29600000000000004
BSESN,6/16/2010,17462.86914,17530.38086,17407.30078,17500.30078,27400,50.039063,0.0,50.039063,69.75890198,16318.38965,17530.38086,94.42968584,-5.570314156,71.74529685,-35.77672275,0.025880068,3344800,1,0.0
BSESN,6/17/2010,17616.68945,17647.41992,17394.90039,17490.51953,25400,153.820312,0.0,153.820312,73.46540336,16318.38965,17647.41992,97.68775252,-2.3122474790000003,111.1407261,-6.393232987999999,0.029151131,3370200,1,-0.6705
BSESN,6/18/2010,17570.82031,17721.99023,17525.28906,17628.01953,24000,-45.86914,45.86914,0.0,70.49260806,16318.38965,17721.99023,89.22984769,-10.77015231,137.0804532,22.30150424,0.047061955999999995,3346200,-1,0.0
BSESN,6/21/2010,17876.55078,17919.61914,17654.81055,17654.81055,26200,305.73046800000003,0.0,305.73046800000003,77.49599331,16560.64063,17919.61914,96.83082849,-3.169171513,180.230186,53.8872406,0.07579247900000001,3372400,1,0.0
BSESN,6/22/2010,17749.68945,17868.11914,17725.63086,17868.11914,15200,-126.861328,126.861328,0.0,69.58826664,16560.64063,17919.61914,87.49577819,-12.50422181,201.86305959999999,83.48240440000001,0.065542442,3357200,-1,-0.34
BSESN,6/23/2010,17755.93945,17782.41016,17629.18945,17694.86914,17600,6.25,0.0,6.25,69.76365484,16560.64063,17919.61914,87.95568244,-12.04431756,217.01003390000002,110.1879303,0.049276411,3374800,1,0.4939
BSESN,6/24/2010,17730.24023,17845.65039,17632.80078,17750.50977,15600,-25.699219,25.699219,0.0,67.9056247,16560.64063,17919.61914,86.06461362,-13.93538638,224.35419249999998,133.0211827,0.038985819,3359200,-1,0.0
BSESN,6/25/2010,17574.5293,17714.73047,17546.73047,17705.10938,19200,-155.710937,155.710937,0.0,57.24654084,16560.64063,17919.61914,74.60667406,-25.39332594,215.1300347,149.44295309999998,0.013632314,3340000,-1,0.4767
BSESN,6/28/2010,17774.25977,17794.80078,17571.84961,17577.66016,19200,199.730469,0.0,199.730469,65.30653787,16591.25977,17919.61914,89.0572252,-10.9427748,221.384421,163.8312467,0.020756516000000003,3359200,1,0.0
BSESN,6/29/2010,17534.08984,17777.94922,17465.73047,17777.94922,19200,-240.169922,240.169922,0.0,51.76613551,16668.91016,17919.61914,69.17513973,-30.82486027,204.60282769999998,171.9855629,0.0040784079999999995,3340000,-1,0.0516
BSESN,6/30/2010,17700.90039,17725.03906,17373.7793,17476.84961,18200,166.81054699999999,0.0,166.81054699999999,58.63874155,16994.07031,17919.61914,76.36875079999999,-23.6312492,202.43002380000001,178.0744551,0.00478018,3358200,1,-0.128
BSESN,7/1/2010,17509.33008,17679.33984,17455.41016,17679.33984,16200,-191.570313,191.570313,0.0,49.32563297,17118.74023,17919.61914,48.77014997,-51.22985003,183.1388274,179.08732949999998,-0.003499565,3342000,-1,-0.0516
BSESN,7/2/2010,17460.94922,17598.93945,17426.7793,17523.4707,17200,-48.380859,48.380859,0.0,47.14376935,17249.46094,17919.61914,31.55796349,-68.44203651,162.0781483,175.68549330000002,-0.02324842,3324800,-1,0.0
BSESN,7/5/2010,17441.43945,17505.73047,17423.74023,17473.83008,7800,-19.509766,19.509766,0.0,46.19303792,17373.7793,17919.61914,12.39560592,-87.60439408,142.1742372,168.98324209999998,-0.017366501,3317000,-1,0.1531
BSESN,7/6/2010,17614.48047,17643.14063,17395.58008,17402.67969,15600,173.04101599999998,0.0,173.04101599999998,55.3981894,17373.7793,17919.61914,44.09739865,-55.90260135,138.7636274,162.93931909999998,-0.007966854,3332600,1,0.4019
BSESN,7/7/2010,17471.0293,17623.66016,17447.15039,17623.66016,15200,-143.45117199999999,143.45117199999999,0.0,47.60757856,17373.7793,17919.61914,17.81658138,-82.18341862,123.06674699999999,154.96480469999997,-0.014619708,3317400,-1,0.0
BSESN,7/8/2010,17651.73047,17728.36914,17536.48047,17536.48047,14200,180.70117199999999,0.0,180.70117199999999,56.49914892,17373.7793,17919.61914,50.92174473,-49.07825527,123.7810595,148.72805569999997,0.004392787,3331600,1,0.34
BSESN,7/9/2010,17833.53906,17857.58008,17667.84961,17667.84961,26000,181.808594,0.0,181.808594,63.65905824,17373.7793,17868.11914,93.00479651,-6.995203486,137.4333454,146.4691136,0.00333512,3357600,1,-0.6908
BSESN,7/12/2010,17937.19922,18010.07031,17874.94922,17875.9707,16200,103.660156,0.0,103.660156,67.20965321,17373.7793,18010.07031,88.54752116,-11.45247884,154.83257509999999,148.1418059,0.022990037,3373800,1,0.0
BSESN,7/13/2010,17985.90039,17998.03906,17855.84961,17908.30078,17000,48.701172,0.0,48.701172,68.85900358,17373.7793,18010.07031,96.20143592,-3.798564083,170.5849701,152.6304388,0.016100876,3390800,1,0.34
BSESN,7/14/2010,17938.16016,18167.2207,17897.25977,18024.94922,16800,-47.740235,47.740235,0.0,65.15228503,17373.7793,18167.2207,71.13075455,-28.86924545,177.1742641,157.53920380000002,0.024491517999999997,3374000,-1,0.0
BSESN,7/15/2010,17909.46094,17978.56055,17858.73047,17874.71094,11800,-28.699218,28.699218,0.0,62.80713164,17373.7793,18167.2207,67.5136988,-32.4863012,178.02834009999998,161.6370311,0.02568656,3362200,-1,-0.3182
BSESN,7/16/2010,17955.82031,17980.26953,17892.16016,17911.13086,13200,46.359375,0.0,46.359375,65.14551488,17373.7793,18167.2207,73.35652155,-26.64347845,180.36685880000002,165.3829966,0.029491881,3375400,1,0.0772
BSESN,7/19/2010,17928.41992,18005.07031,17856.40039,17914.11914,11800,-27.400391,27.400391,0.0,62.46712007,17373.7793,18167.2207,69.90316119,-30.09683881,177.9577825,167.8979538,0.017822805,3363600,-1,0.0
BSESN,7/20/2010,17878.14063,18040.16992,17848.07031,17918.42969,11600,-50.279297,50.279297,0.0,57.46479108,17395.58008,18167.2207,62.53695456,-37.46304544,170.03143669999997,168.3246504,0.02330208,3352000,-1,-0.8074
BSESN,7/21/2010,17977.23047,18012.19922,17873.91992,17873.91992,13000,99.089844,0.0,99.089844,64.01723297,17395.58008,18167.2207,75.37840442,-24.62159558,169.78825930000002,168.61737219999998,0.018440118000000002,3365000,1,0.0
BSESN,7/22/2010,18113.15039,18127.90039,17879.88086,17978.36914,16000,135.91992199999999,0.0,135.91992199999999,71.07059255,17395.58008,18167.2207,92.99281165,-7.007188352999999,178.50544169999998,170.5949861,0.015678959,3381000,1,-0.0516
BSESN,7/23/2010,18130.98047,18237.56055,18093.92969,18132.28906,17400,17.830078,0.0,17.830078,71.90419872,17395.58008,18237.56055,87.34173987,-12.65826013,184.7232354,173.4206359,0.010803317,3398400,1,0.4939
BSESN,7/26/2010,18020.05078,18194.08984,17993.88086,18056.24023,16800,-110.92968799999998,110.92968799999998,0.0,59.57986723,17447.15039,18237.56055,72.48140546,-27.51859454,178.6405261,174.46461399999998,0.001898731,3381600,-1,0.0
BSESN,7/27/2010,18077.60938,18149.56055,17998.74023,17998.74023,15800,57.55859399999999,0.0,57.55859399999999,63.34163910000001,17536.48047,18237.56055,77.18503534,-22.81496466,176.43065,174.8578212,0.007773886,3397400,1,0.0
BSESN,7/28/2010,17957.36914,18137.14063,17925.40039,18077.84961,15400,-120.24023400000002,120.24023400000002,0.0,51.73586798,17667.84961,18237.56055,50.81867184,-49.18132816,163.0968463,172.5056262,0.002675022,3382000,-1,0.0
BSESN,7/29/2010,17992.0,18013.09961,17902.83984,17961.58008,11600,34.630859,0.0,34.630859,54.50599831,17848.07031,18237.56055,36.95334939,-63.04665061,153.5540562,168.7153122,0.002014928,3393600,1,-0.34
BSESN,7/30/2010,17868.28906,18000.34961,17838.91992,17981.06055,14000,-123.71093700000002,123.71093700000002,0.0,44.07820643,17838.91992,18237.56055,7.367322636,-92.63267736,134.45892869999997,161.8640355,-0.0033539409999999996,3379600,-1,-0.3182
BSESN,8/2/2010,18081.21094,18104.24023,17911.31055,17911.31055,11000,212.921875,0.0,212.921875,59.47502274,17838.91992,18237.56055,60.77930868,-39.22069132,134.9512841,156.4814852,0.011358581000000001,3390600,1,0.0
BSESN,8/3/2010,18114.83008,18167.44922,18072.38086,18149.90039,13800,33.61914,0.0,33.61914,61.41069157,17838.91992,18237.56055,69.21275422,-30.78724578,136.4809949,152.4813872,0.007654105,3404400,1,-0.5574
BSESN,8/4/2010,18217.43945,18249.46094,18093.0293,18115.56055,11200,102.609375,0.0,102.609375,66.9672004,17838.91992,18249.46094,92.20017398,-7.799826023,144.30951059999998,150.8470118,0.005757643000000001,3415600,1,0.4019
BSESN,8/5/2010,18172.83008,18295.42969,18156.44922,18234.84961,10200,-44.609375,44.609375,0.0,62.45596064,17838.91992,18295.42969,73.14414299,-26.85585701,145.23982759999998,149.725575,0.002308182,3405400,-1,0.0
BSESN,8/6/2010,18143.99023,18244.56055,18118.18945,18165.49023,9800,-28.839844,28.839844,0.0,59.46762723,17838.91992,18295.42969,66.82667814,-33.17332186,142.01293930000003,148.18304780000003,0.006877864,3395600,-1,0.25
BSESN,8/9/2010,18287.5,18309.25,18139.90039,18141.10938,11000,143.50976599999998,0.0,143.50976599999998,68.20294191,17838.91992,18309.25,95.37558812,-4.62441188,149.31444199999999,148.4093267,0.01161053,3406600,1,0.0
BSESN,8/10/2010,18219.99023,18293.40039,18170.76953,18272.2793,17800,-67.509766,67.509766,0.0,61.06015812,17838.91992,18309.25,81.02188863,-18.97811137,147.948009,148.3170631,0.014624698,3388800,-1,0.0
BSESN,8/11/2010,18070.18945,18263.88086,18042.89063,18177.34961,20200,-149.800781,149.800781,0.0,48.14942549,17838.91992,18309.25,49.17175019,-50.82824981,133.2415047,145.3019514,0.00434579,3368600,-1,0.0
BSESN,8/12/2010,18073.90039,18113.61914,17914.7793,17972.65039,19600,3.7109379999999996,0.0,3.7109379999999996,48.46091769,17838.91992,18309.25,49.96075735,-50.03924265,120.4969223,140.3409456,0.011507052,3388200,1,-0.5423
BSESN,8/13/2010,18167.0293,18260.39063,18050.41992,18080.28906,18600,93.128906,0.0,93.128906,56.09798716,17838.91992,18309.25,69.76151225,-30.23848775,116.56775290000002,135.5863071,0.004746273,3406800,1,-0.4404
BSESN,8/16/2010,18050.7793,18203.91992,17997.46094,18169.80078,16000,-116.25,116.25,0.0,46.23109078,17838.91992,18309.25,45.04482807,-54.95517193,102.8874321,129.0465321,-0.00353582,3390800,-1,0.0
BSESN,8/17/2010,18048.84961,18140.15039,18026.0,18049.18945,12800,-1.929688,1.929688,0.0,46.07587035,17838.91992,18309.25,44.634544299999995,-55.365455700000005,90.84279041,121.4057837,-0.009254311,3378000,-1,0.0772
BSESN,8/18/2010,18257.11914,18286.0,18067.66992,18067.66992,14800,208.269532,0.0,208.269532,61.9749267,17838.91992,18309.25,88.91611202,-11.08388798,96.9849536,116.52161770000001,0.004638191,3392800,1,-0.4767
BSESN,8/19/2010,18454.93945,18475.26953,18276.5,18276.5,14600,197.820312,0.0,197.820312,71.2613361,17911.31055,18475.26953,96.39511408,-3.604885918,116.4724858,116.5117913,0.017137863,3407400,1,0.4404
BSESN,8/20/2010,18401.82031,18464.14063,18360.90039,18444.24023,14200,-53.11914,53.11914,0.0,66.24851749,17914.7793,18475.26953,86.89554009,-13.10445991,126.1757493,118.44458290000001,0.0062512819999999995,3393200,-1,0.34
BSESN,8/23/2010,18409.34961,18454.38086,18371.01953,18400.33008,11400,7.529296,0.0,7.529296,66.63240517,17914.7793,18475.26953,88.23888125,-11.76111875,132.9407486,121.34381609999998,0.010392946,3404600,1,0.0
BSESN,8/24/2010,18311.58984,18451.73047,18260.71094,18407.00977,14400,-97.759765,97.759765,0.0,56.93139746,17914.7793,18475.26953,70.79704925,-29.20295075,128.92746770000002,122.86054640000002,0.01335904,3390200,-1,-0.6808
BSESN,8/25/2010,18179.64063,18312.42969,18156.0,18308.50977,15800,-131.949219,131.949219,0.0,46.40873435,17914.7793,18475.26953,47.25529758,-52.74470242,113.7880367,121.04604450000001,0.005850438,3374400,-1,0.0
BSESN,8/26/2010,18226.34961,18261.06055,18159.13086,18194.7793,12800,46.708984,0.0,46.708984,50.17058149,17914.7793,18475.26953,55.58889221,-44.41110779,104.3560022,117.708036,0.003265273,3387200,1,0.0
BSESN,8/27/2010,17998.41016,18248.35938,17944.16016,18205.90039,13600,-227.939453,227.939453,0.0,35.95807789,17914.7793,18475.26953,14.92101984,-85.07898016,77.59378523,109.68518590000002,-0.0029012120000000002,3373600,-1,-0.0258
BSESN,8/30/2010,18032.10938,18216.5,17960.23047,18063.48047,11600,33.699219,0.0,33.699219,38.91022646,17914.7793,18475.26953,20.93347411,-79.06652589,58.430233400000006,99.43419536,-0.0009274960000000001,3385200,1,-0.5719
BSESN,8/31/2010,17971.11914,18015.66016,17819.99023,18015.66016,16400,-60.990233999999994,60.990233999999994,0.0,35.49349399,17819.99023,18475.26953,23.06328121,-76.93671879,37.8848652,87.12432933,-0.015665122,3368800,-1,-0.2263
BSESN,9/1/2010,18205.86914,18227.14063,18027.11914,18027.11914,14400,234.75,0.0,234.75,53.5917167,17819.99023,18475.26953,58.88770006,-41.11229994,40.08282613,77.71602869,-0.013496133,3383200,1,-0.2755
BSESN,9/2/2010,18238.31055,18355.83984,18215.2793,18215.2793,13400,32.441406,0.0,32.441406,55.57901284,17819.99023,18475.26953,63.83847543,-36.16152457,43.93600937,70.96002483,-0.008885521,3396600,1,0.3818
BSESN,9/3/2010,18221.42969,18316.32031,18206.5,18238.08008,9400,-16.880859,16.880859,0.0,54.18586916,17819.99023,18475.26953,61.26234353,-38.73765647,45.10756864,65.78953359,-0.010207852,3387200,-1,-0.0772
BSESN,9/6/2010,18560.05078,18600.30078,18124.28906,18124.28906,18200,338.62109300000003,0.0,338.62109300000003,71.00676517,17819.99023,18600.30078,94.84179726,-5.158202738,72.52391943,67.13641076,0.013568506999999999,3405400,1,-0.5574
BSESN,9/7/2010,18645.06055,18711.19922,18571.42969,18571.73047,14600,85.009766,0.0,85.009766,73.79388149,17819.99023,18711.19922,92.57876961,-7.421230386,99.95888877,73.70090636,0.025601162,3420000,1,0.0
BSESN,9/8/2010,18666.71094,18721.21094,18540.65039,18627.66992,20200,21.650391,0.0,21.650391,74.51384031,17819.99023,18721.21094,93.9526467,-6.047353302,122.0414869,83.36902248,0.024160697999999998,3440200,1,0.0
BSESN,9/9/2010,18799.66016,18823.16992,18669.11914,18669.11914,13200,132.949218,0.0,132.949218,78.6665694,17819.99023,18823.16992,97.65647508,-2.343524922,148.55751730000003,96.40672144,0.044517821,3453400,1,0.0
BSESN,9/13/2010,19208.33008,19243.43945,18845.31055,18845.31055,15800,408.66992200000004,0.0,408.66992200000004,86.47998777,17819.99023,19243.43945,97.5335,-2.466500001,200.23967140000002,117.1733114,0.065229235,3469200,1,0.5423
BSESN,9/14/2010,19346.96094,19487.01953,19218.13086,19218.13086,21000,138.63086,0.0,138.63086,88.17514967,17819.99023,19487.01953,91.59831244,-8.401687556,249.5083261,143.64031440000002,0.07655849299999999,3490200,1,-0.4767
BSESN,9/15/2010,19502.10938,19554.5,19340.99023,19343.74023,17400,155.148437,0.0,155.148437,89.82290694,17819.99023,19554.5,96.97951398,-3.02048602,297.64223760000004,174.440699,0.071199031,3507600,1,0.0
BSESN,9/16/2010,19417.49023,19636.66016,19383.46094,19476.92969,16200,-84.619141,84.619141,0.0,82.58109357,17819.99023,19636.66016,87.93562224,-12.06437776,325.2118125,204.5949217,0.064653998,3491400,-1,0.0
BSESN,9/17/2010,19594.75,19639.17969,19436.71094,19436.71094,16600,177.25976599999998,0.0,177.25976599999998,85.42194911,17819.99023,19639.17969,97.55772067,-2.44227933,357.2461694,235.12517119999998,0.07536841700000001,3508000,1,-0.2732
BSESN,9/20/2010,19906.09961,19927.30078,19445.41992,19445.41992,19600,311.349609,0.0,311.349609,89.0434472,17819.99023,19927.30078,98.99392275,-1.00607725,403.1101368,268.72216430000003,0.072523984,3527600,1,0.5719
BSESN,9/21/2010,20001.55078,20088.96094,19860.88086,19925.78906,15800,95.451172,0.0,95.451172,89.92848992,18027.11914,20088.96094,95.76057886,-4.239421139,442.0639353,303.3905185,0.07275333,3543400,1,0.0516
BSESN,9/22/2010,19941.7207,20105.53906,19804.01953,20039.42969,14400,-59.830078,59.830078,0.0,84.96468222,18124.28906,20105.53906,91.73156543,-8.268434574,462.77275769999994,335.2669664,0.068303933,3529000,-1,0.0
BSESN,9/23/2010,19861.00977,19998.32031,19771.63086,19944.30078,11800,-80.710937,80.710937,0.0,78.24234587,18124.28906,20105.53906,87.65782728,-12.34217272,467.28537570000003,361.67064819999996,0.056455787,3517200,-1,-0.624
BSESN,9/24/2010,20045.17969,20071.75,19833.51953,19836.42969,17400,184.16992199999999,0.0,184.16992199999999,81.99336003,18124.28906,20105.53906,96.95347003,-3.046529968,480.18733080000004,385.3739847,0.043567015,3534600,1,0.25
BSESN,9/27/2010,20117.38086,20267.98047,20082.25977,20082.25977,17400,72.201171,0.0,72.201171,83.29601714,18540.65039,20267.98047,91.2813647,-8.718635304,490.58311749999996,406.4158113,0.039821237,3552000,1,-0.1531
BSESN,9/28/2010,20104.85938,20157.50977,19981.96094,20114.36914,13400,-12.521484,12.521484,0.0,82.10740752,18540.65039,20267.98047,90.55646074,-9.443539256000001,492.13840899999997,423.56033080000003,0.030906912999999998,3538600,-1,-0.3818
BSESN,9/29/2010,19956.33984,20234.05078,19923.10938,20086.89063,18800,-148.519531,148.519531,0.0,68.69218168,18669.11914,20267.98047,80.50858949,-19.49141051,475.9008154,434.02842769999995,0.027750734,3519800,-1,0.0
BSESN,9/30/2010,20069.11914,20114.73047,19864.46094,19931.49023,15800,112.779297,0.0,112.779297,72.61281925,18845.31055,20267.98047,86.02196301,-13.97803699,466.752322,440.57320660000005,0.024208992000000002,3535600,1,0.6249
BSESN,10/1/2010,20445.03906,20475.4707,20094.09961,20094.09961,19200,375.91992200000004,0.0,375.91992200000004,81.51556455,19218.13086,20475.4707,97.57968061,-2.4203193869999997,484.25349819999997,449.3092649,0.027074086,3554800,1,-0.25
BSESN,10/4/2010,20475.73047,20706.74023,20437.35938,20501.21094,15000,30.691406,0.0,30.691406,82.06479219,19340.99023,20706.74023,83.08550137,-16.91449863,494.89500489999995,458.42641289999995,0.023707146000000002,3569800,1,0.0
BSESN,10/5/2010,20407.71094,20560.53906,20383.16016,20461.98047,17800,-68.019531,68.019531,0.0,76.2696673,19383.46094,20706.74023,77.402405,-22.597595000000002,492.1664791,465.1744261,0.023367604,3552000,-1,0.128
BSESN,10/6/2010,20543.08008,20669.94922,20447.05078,20448.68945,16200,135.36914,0.0,135.36914,79.58081316,19436.71094,20706.74023,87.1136708,-12.886329199999999,495.21868820000003,471.18327860000005,0.034342177,3568200,1,0.0
BSESN,10/7/2010,20315.32031,20581.28906,20272.76953,20544.30078,19200,-227.759765,227.759765,0.0,62.61858263,19445.41992,20706.74023,68.96744488,-31.03255512,473.79763219999995,471.7061493,0.013476588000000001,3549000,-1,-0.4767
BSESN,10/8/2010,20250.25977,20409.18945,20145.74023,20297.58008,15400,-65.060547,65.060547,0.0,58.50822047,19771.63086,20706.74023,51.18426997,-48.81573003,446.4253352,466.6499865,0.006605179,3533600,-1,0.7351
BSESN,10/11/2010,20339.89063,20461.26953,20250.25977,20250.25977,11600,89.630859,0.0,89.630859,62.42854995,19771.63086,20706.74023,60.76933685,-39.23066315,427.0423751,458.7284642,0.011690271,3545200,1,0.0
BSESN,10/12/2010,20203.33984,20368.40039,20107.25,20357.78906,13400,-136.550781,136.550781,0.0,53.53662072,19771.63086,20706.74023,46.16668344,-53.83331656,396.0967758,446.20212649999996,0.012377019,3531800,-1,0.0
BSESN,10/13/2010,20687.88086,20703.9707,20211.66016,20223.44922,14400,484.541015,0.0,484.541015,70.65172607,19833.51953,20706.74023,97.84025105,-2.159748954,405.9905692,438.15981510000006,0.030831532999999998,3546200,1,0.0
BSESN,10/14/2010,20497.64063,20854.55078,20442.82031,20700.41992,15200,-190.24023400000002,190.24023400000002,0.0,60.54786529,19864.46094,20854.55078,63.95174049,-36.04825951,393.9395845,429.3157688999999,0.002572828,3531000,-1,-0.34
BSESN,10/15/2010,20125.05078,20578.44922,20090.17969,20518.5,9400,-372.58984399999997,372.58984399999997,0.0,45.75944272,19864.46094,20854.55078,26.31981783,-73.68018217,350.2863231,413.5098798,-0.017126602,3521600,-1,0.0
BSESN,10/18/2010,20168.89063,20229.39063,19870.50977,20160.55078,12600,43.839844,0.0,43.839844,47.50030994,19864.46094,20854.55078,30.74768307,-69.25231693,315.59037850000004,393.9259795,-0.011702455,3534200,1,0.4404
BSESN,10/19/2010,19983.13086,20332.01953,19923.96094,20298.55078,12000,-185.75976599999998,185.75976599999998,0.0,41.05763785,19864.46094,20854.55078,11.98577299,-88.01422701,269.9920317,369.13918989999996,-0.027257316,3522200,-1,0.0
BSESN,10/20/2010,19872.15039,20043.82031,19822.66016,19924.01953,10600,-110.98046799999999,110.98046799999999,0.0,37.54698817,19822.66016,20854.55078,4.796073712,-95.20392629,222.3368562,339.7787232,-0.021814567000000003,3511600,-1,0.4019
BSESN,10/21/2010,20260.58008,20293.09961,19886.11914,19951.33984,12800,388.429687,0.0,388.429687,53.57718283,19822.66016,20854.55078,42.43859876,-57.56140124,213.4522708,314.5134327,0.0005096380000000001,3524400,1,-0.2755
BSESN,10/22/2010,20165.85938,20351.74023,20088.66992,20334.14063,13200,-94.720703,94.720703,0.0,49.96839605,19822.66016,20854.55078,33.25926321,-66.74073679,196.50284140000002,290.9113144,-0.008556155,3511200,-1,0.0
BSESN,10/25/2010,20303.11914,20452.30078,20199.73047,20199.73047,12200,137.25976599999998,0.0,137.25976599999998,55.03274869,19822.66016,20854.55078,46.561037899999995,-53.438962100000005,191.93352219999997,271.11575600000003,0.004938753,3523400,1,0.4767
BSESN,10/26/2010,20221.39063,20344.67969,20189.30078,20325.43945,10200,-81.728516,81.728516,0.0,51.45441819,19822.66016,20854.55078,38.64076864,-61.35923136,179.64664109999998,252.821933,-0.022548962000000002,3513200,-1,0.0
BSESN,10/27/2010,20005.36914,20220.58008,19923.71094,20220.58008,12000,-216.021484,216.021484,0.0,42.93938568,19822.66016,20854.55078,17.70623558,-82.29376442,150.740429,232.40563219999996,-0.024016007000000002,3501200,-1,-0.2263
BSESN,10/28/2010,19941.03906,20185.46094,19869.32031,20116.49023,11600,-64.330078,64.330078,0.0,40.62909902,19822.66016,20854.55078,11.47204017,-88.52795983,121.243528,210.1732114,-0.009143416,3489600,-1,0.0
BSESN,10/29/2010,20032.33984,20080.33008,19768.96094,19986.32031,14400,91.300781,0.0,91.300781,45.43660415,19768.96094,20854.55078,24.26136424,-75.73863576,104.034981,188.94556530000003,-0.006770366,3504000,1,0.0
BSESN,11/1/2010,20355.63086,20609.65039,20267.09961,20272.49023,5400,323.291015,0.0,323.291015,59.00067083,19768.96094,20854.55078,54.04158161,-45.95841839,115.15651399999999,174.187755,0.018640723,3509400,1,0.0
BSESN,11/2/2010,20345.68945,20418.34961,20281.73047,20407.17969,13200,-9.941406,9.941406,0.0,58.48480866,19768.96094,20854.55078,53.12582084,-46.87417916,121.7645942,163.7031229,0.023829281,3496200,-1,-0.29600000000000004
BSESN,11/3/2010,20465.74023,20538.80078,20426.17969,20472.85938,10000,120.050781,0.0,120.050781,62.99321613,19768.96094,20609.65039,82.88188861,-17.11811139,135.13093469999998,157.9886852,0.010126075,3506200,1,0.0
BSESN,11/4/2010,20893.57031,20917.0293,20605.63086,20605.63086,12800,427.830079,0.0,427.830079,74.41721533,19768.96094,20917.0293,97.95665617,-2.0433438319999997,178.1920804,162.02936430000003,0.036086283999999996,3519000,1,0.0
BSESN,11/8/2010,20852.38086,21075.71094,20822.36914,21041.9707,13800,-41.189454,41.189454,0.0,71.94987262,19768.96094,21075.71094,82.90950228,-17.09049772,206.6129979,170.946091,0.027053071,3505200,-1,-0.29600000000000004
BSESN,11/9/2010,20932.48047,20984.08008,20762.81055,20851.91016,11800,80.09961,0.0,80.09961,73.8921841,19768.96094,21075.71094,89.03918355,-10.96081645,232.91524680000003,183.3399222,0.03516523,3517000,1,-0.29600000000000004
BSESN,11/10/2010,20875.71094,20970.91016,20849.91992,20917.53906,15200,-56.76953100000001,56.76953100000001,0.0,69.93219483,19768.96094,21075.71094,84.69485364,-15.30514636,246.33949359999997,195.93983640000002,0.043505410999999994,3501800,-1,0.0
BSESN,11/11/2010,20589.08984,20937.38086,20544.2207,20930.44922,12600,-286.62109399999997,286.62109399999997,0.0,53.293755700000006,19768.96094,21075.71094,62.76096468,-37.23903532,231.1854174,202.98895259999998,0.032498346000000004,3489200,-1,0.1531
BSESN,11/12/2010,20156.89063,20593.91016,20108.40039,20529.74023,14600,-432.199219,432.199219,0.0,37.69111408,19768.96094,21075.71094,29.68660318,-70.31339682,182.20054340000002,198.8312708,0.006217485,3474600,-1,-0.4019
BSESN,11/15/2010,20309.68945,20335.50977,20046.59961,20167.61914,14200,152.79882800000001,0.0,152.79882800000001,44.33863361,19768.96094,21075.71094,41.3796453,-58.6203547,153.9348017,189.851977,-0.002256938,3488800,1,0.0772
BSESN,11/16/2010,19865.14063,20380.09961,19832.2207,20371.73047,15200,-444.548828,444.548828,0.0,32.64650303,19768.96094,21075.71094,7.36022093,-92.63977907,94.57245031,170.7960716,-0.023619196000000002,3473600,-1,0.0
BSESN,11/18/2010,19930.64063,20056.43945,19615.50977,19997.83008,21800,65.5,0.0,65.5,35.5364846,19615.50977,21075.71094,21.58133174,-78.41866826,52.21080802,147.0790189,-0.026146116,3495400,1,-0.3818
BSESN,11/19/2010,19585.43945,19983.89063,19504.86914,19982.75,16400,-345.20117200000004,345.20117200000004,0.0,28.182894899999997,19504.86914,21075.71094,5.129116895,-94.87088311,-9.110923261,115.84103049999999,-0.062609254,3479000,-1,0.0
BSESN,11/22/2010,19957.58984,19989.01953,19641.41992,19713.83984,11000,372.150391,0.0,372.150391,42.88472307,19504.86914,21075.71094,28.82026082,-71.17973918,-27.36397585,87.20002921,-0.042910736,3490000,1,0.2023
BSESN,11/23/2010,19691.83984,19841.41992,19342.68945,19841.41992,14200,-265.75,265.75,0.0,36.6952217,19342.68945,21075.71094,20.14691647,-79.85308353,-62.55239055,57.24954526,-0.059268687,3475800,-1,-0.7269
BSESN,11/24/2010,19459.84961,19835.57031,19375.91992,19735.2793,12200,-231.990235,231.990235,0.0,32.03766409,19342.68945,21075.71094,6.76045606,-93.23954394,-107.9151571,24.21660479,-0.067823383,3463600,-1,0.0
BSESN,11/25/2010,19318.16016,19628.26953,19257.36914,19560.25,13800,-141.68945300000001,141.68945300000001,0.0,29.40727926,19257.36914,21075.71094,3.3432116610000002,-96.65678834,-153.52884619999998,-11.332485400000001,-0.061728307999999996,3449800,-1,-0.4215
BSESN,11/26/2010,19136.60938,19417.60938,18954.82031,19391.96094,25200,-181.550781,181.550781,0.0,26.22405785,18954.82031,21075.71094,8.571354876000001,-91.42864512,-201.9991338,-49.46581509,-0.050616996,3424600,-1,0.0
BSESN,11/29/2010,19405.09961,19450.08984,19167.18945,19230.33984,12400,268.490234,0.0,268.490234,37.72657818,18954.82031,20984.08008,22.1893374,-77.81066259999999,-216.2544216,-82.82353640000001,-0.044539817,3437000,1,0.0
BSESN,11/30/2010,19521.25,19610.46094,19218.01953,19373.23047,18800,116.15039099999998,0.0,116.15039099999998,42.22306029,18954.82031,20970.91016,28.09545859,-71.90454141,-215.6930983,-109.39744879999999,-0.017311261,3455800,1,-0.4404
BSESN,12/1/2010,19850.0,19887.25977,19525.15039,19529.99023,15000,328.75,0.0,328.75,53.24773506,18954.82031,20937.38086,45.1527036,-54.847296400000005,-186.5702029,-124.8319996,-0.004046063,3470800,1,0.0
BSESN,12/2/2010,19992.69922,20084.25,19917.76953,20038.66016,16600,142.699219,0.0,142.699219,57.32602495,18954.82031,20593.91016,63.32044033,-36.67955967,-150.2435499,-129.91430970000002,0.020794007,3487400,1,0.1027
BSESN,12/3/2010,19966.92969,20067.81055,19877.11914,20007.89063,13800,-25.769531,25.769531,0.0,56.30264464,18954.82031,20380.09961,71.01130128,-28.98869872,-122.12600890000002,-128.3566495,0.000467985,3473600,-1,0.0
BSESN,12/6/2010,19981.31055,20217.85938,19944.71094,20038.25,14000,14.380859,0.0,14.380859,56.7992402,18954.82031,20380.09961,72.02028661,-27.97971339,-97.55765595,-122.19685079999999,0.014700033000000001,3487600,1,-0.4404
BSESN,12/7/2010,19934.64063,20008.35938,19824.43945,19982.90039,13400,-46.669922,46.669922,0.0,54.48082349,18954.82031,20217.85938,77.5764061,-22.423593899999997,-80.92013499,-113.9415076,0.024398494,3474200,-1,0.3182
BSESN,12/8/2010,19696.48047,19875.50977,19611.34961,19874.30078,12600,-238.160156,238.160156,0.0,43.92404837,18954.82031,20217.85938,58.72028651,-41.27971349,-85.96140441,-108.345487,0.019583661999999998,3461600,-1,0.0
BSESN,12/9/2010,19242.35938,19771.08984,19160.86914,19746.15039,17200,-454.121094,454.121094,0.0,30.795316999999997,18954.82031,20217.85938,22.76565077,-77.23434923,-125.15768390000001,-111.70792639999999,0.005526056999999999,3444400,-1,0.1027
BSESN,12/10/2010,19508.89063,19537.40039,19074.57031,19201.89063,16000,266.53125,0.0,266.53125,42.44530605,18954.82031,20217.85938,43.86802662,-56.13197338,-133.1789692,-116.00213490000002,0.0053486459999999994,3460400,1,0.0
BSESN,12/13/2010,19691.7793,19710.57031,19321.41016,19600.2793,15400,182.88867199999999,0.0,182.88867199999999,49.21421649,18954.82031,20217.85938,58.34807538,-41.65192462,-123.3563331,-117.4729746,0.008735573,3475800,1,0.0
BSESN,12/14/2010,19799.18945,19836.82031,19621.41016,19746.75,13400,107.410156,0.0,107.410156,52.962949800000004,18954.82031,20217.85938,66.85217943,-33.14782057,-105.686434,-115.11566640000001,-0.002559725,3489200,1,0.7096
BSESN,12/15/2010,19647.76953,19817.60938,19571.42969,19791.2207,14000,-151.41992199999999,151.41992199999999,0.0,47.28546909,18954.82031,20217.85938,54.86364111,-45.13635889,-102.7171742,-112.63596799999999,-0.017252782,3475200,-1,0.0
BSESN,12/16/2010,19864.84961,19897.2207,19554.34961,19698.58008,15400,217.080078,0.0,217.080078,55.22514146,19074.57031,20217.85938,69.12331468,-30.87668532,-81.90333562,-106.4894415,-0.005112457,3490600,1,0.0
BSESN,12/20/2010,19888.88086,20006.16016,19711.11914,19770.01953,11200,24.03125,0.0,24.03125,56.07029349,19074.57031,20217.85938,71.22525467,-28.77474533,-62.74580302,-97.74071382,-0.004625807,3501800,1,-0.4767
BSESN,12/21/2010,20060.32031,20090.83984,19925.75977,19925.75977,14200,171.439454,0.0,171.439454,61.97798799,19074.57031,20217.85938,86.22053974,-13.77946026,-33.34520648,-84.86161235,0.006304588000000001,3516000,1,-0.4215
BSESN,12/22/2010,20015.80078,20151.25,19931.31055,20118.82031,12000,-44.519532,44.519532,0.0,59.57733960000001,19074.57031,20217.85938,82.32655234,-17.67344766,-13.48196437,-70.58568275,0.016212049,3504000,-1,0.0
BSESN,12/23/2010,19982.88086,20076.08008,19939.30078,20038.83008,7600,-32.919922,32.919922,0.0,57.67140613,19074.57031,20217.85938,79.44714737,-20.55285263,-0.392045221,-56.54695525,0.038483922999999996,3496400,-1,0.4767
BSESN,12/24/2010,20073.66016,20086.41992,19880.35938,19911.46094,16400,90.779297,0.0,90.779297,61.58195581,19074.57031,20217.85938,87.38733503,-12.61266497,17.10971051,-41.81562209,0.028949341,3512800,1,0.4215
BSESN,12/27/2010,20028.92969,20190.13086,20010.33008,20062.59961,9800,-44.730468,44.730468,0.0,58.50876564,19074.57031,20190.13086,85.54976047,-14.45023953,27.05868738,-28.0407602,0.017121378,3503000,-1,0.0
BSESN,12/28/2010,20025.41992,20090.41016,19981.75977,20056.4707,10600,-3.5097660000000004,3.5097660000000004,0.0,58.24560451,19074.57031,20190.13086,85.23514142,-14.76485858,34.26512739,-15.57958268,0.011426249,3492400,-1,-0.2732
BSESN,12/29/2010,20256.0293,20274.19922,20054.64063,20060.88086,10000,230.609375,0.0,230.609375,68.86311449,19074.57031,20274.19922,98.48537144,-1.514628558,57.91690229,-0.880285687,0.03095821,3502400,1,-0.2755
BSESN,12/30/2010,20389.07031,20410.91016,20274.11914,20274.11914,10600,133.04101599999998,0.0,133.04101599999998,73.37063569,19074.57031,20410.91016,98.36569694,-1.634303064,86.40043203,16.57585786,0.026389362000000003,3513000,1,0.6486
BSESN,12/31/2010,20509.08984,20552.0293,20412.75977,20412.75977,12600,120.019531,0.0,120.019531,76.85786362,19321.41016,20552.0293,96.51074394,-3.4892560639999997,117.30617509999999,36.7219213,0.031183705,3525600,1,0.0
BSESN,1/3/2011,20561.05078,20664.80078,20531.0,20621.60938,12000,51.960937,0.0,51.960937,78.27880514,19554.34961,20664.80078,90.65695074,-9.343049258999999,144.32828590000003,58.24319422,0.02496124,3537600,1,-0.0762
BSESN,1/4/2011,20498.7207,20651.21094,20449.00977,20617.38086,15200,-62.330078,62.330078,0.0,72.1473736,19554.34961,20664.80078,85.04390988,-14.95609012,158.8824885,78.37105308,0.024126935,3522400,-1,-0.5859
BSESN,1/5/2011,20301.09961,20509.94922,20243.94922,20509.94922,14400,-197.621094,197.621094,0.0,56.07814955,19554.34961,20664.80078,67.24744129,-32.75255871,152.7100815,93.23885877,0.015924568,3508000,-1,0.0
BSESN,1/6/2011,20184.74023,20425.84961,20107.16992,20395.5,16600,-116.359375,116.359375,0.0,48.70778827,19711.11914,20664.80078,49.66238975,-50.33761025,136.85163500000002,101.961414,0.005533624,3491400,-1,0.0
BSESN,1/7/2011,19691.81055,20210.61914,19629.2207,20163.84961,15800,-492.929687,492.929687,0.0,29.65590837,19629.2207,20664.80078,6.043940525,-93.95605948,83.54533699,98.2781986,-0.01683161,3475600,-1,-0.5106
BSESN,1/10/2011,19224.11914,19720.42969,19158.42969,19714.41992,17200,-467.691406,467.691406,0.0,20.764318399999997,19158.42969,20664.80078,4.360774932,-95.63922507,3.520343672,79.32662762,-0.040014181,3458400,-1,0.2942
BSESN,1/11/2011,19196.33984,19431.56055,19003.59961,19279.76953,20000,-27.779296999999996,27.779296999999996,0.0,20.34623585,19003.59961,20664.80078,11.60246202,-88.39753798,-61.43343084,51.17461593,-0.052314767000000005,3438400,-1,0.0
BSESN,1/12/2011,19534.09961,19574.63086,19048.56055,19353.33984,19400,337.759765,0.0,337.759765,37.89055683,19003.59961,20664.80078,31.93472344,-68.06527656,-84.67924522,24.0038437,-0.041932795,3457800,1,-0.0772
BSESN,1/13/2011,19182.82031,19522.38086,19136.26953,19492.30078,16800,-351.279296,351.279296,0.0,29.96922337,19003.59961,20664.80078,10.78862133,-89.21137867,-129.9490522,-6.78673549,-0.064667401,3441000,-1,-0.1027
BSESN,1/14/2011,18860.43945,19447.82031,18811.96094,19198.03906,15800,-322.38086,322.38086,0.0,24.5372483,18811.96094,20664.80078,2.616443897,-97.38355609999999,-189.6529406,-43.3599765,-0.082710332,3425200,-1,-0.34
BSESN,1/17/2011,18882.25,19018.93945,18779.38086,18911.42969,17800,21.810547,0.0,21.810547,25.59007851,18779.38086,20664.80078,5.456033417,-94.54396658,-232.5283315,-81.1936475,-0.07885715,3443000,1,0.0
BSESN,1/18/2011,19092.05078,19120.61914,18933.4707,18983.19922,14400,209.800781,0.0,209.800781,35.56751624,18779.38086,20664.80078,16.58356944,-83.41643056,-246.73402180000002,-114.30172240000002,-0.05955583,3457400,1,-0.0772
BSESN,1/19/2011,18978.32031,19167.06055,18898.56055,19153.31055,16200,-113.73046799999999,113.73046799999999,0.0,32.81530212,18779.38086,20664.80078,10.55146664,-89.44853336,-264.1245684,-144.2662916,-0.05976891,3441200,-1,0.0
BSESN,1/20/2011,19046.53906,19100.25977,18794.73047,18892.42969,12800,68.21875,0.0,68.21875,36.23050491,18779.38086,20664.80078,14.16969243,-85.83030757,-269.2977224,-169.27257769999997,-0.03276852,3454000,1,-0.128
BSESN,1/21/2011,19007.5293,19065.33984,18932.40039,19007.08008,11000,-39.009766,39.009766,0.0,35.05476652,18779.38086,20651.21094,12.18852291,-87.81147709,-273.3937335,-190.0968089,-0.011266568000000001,3443000,-1,0.0
BSESN,1/24/2011,19151.2793,19194.46094,18998.38086,19095.68945,11600,143.75,0.0,143.75,42.92941306,18779.38086,20509.94922,21.4899594,-78.5100406,-262.0200244,-204.481452,-0.002347351,3454600,1,-0.34
BSESN,1/25/2011,18969.44922,19340.99023,18949.43945,19227.41992,13400,-181.83007800000001,181.83007800000001,0.0,36.47464503,18779.38086,20425.84961,11.54400046,-88.45599954,-264.62797909999995,-216.5107574,-0.028905882999999997,3441200,-1,0.0
BSESN,1/27/2011,18684.42969,19086.68945,18656.05078,19086.68945,13800,-285.01953100000003,285.01953100000003,0.0,28.67625538,18656.05078,20210.61914,1.825516827,-98.17448317,-286.39214580000004,-230.48703509999999,-0.025981092,3427400,-1,0.0
BSESN,1/28/2011,18395.9707,18723.11914,18235.44922,18708.61914,18600,-288.458985,288.458985,0.0,22.94701111,18235.44922,19720.42969,10.80966971,-89.19033029,-323.1910883,-249.0278457,-0.024626613,3408800,-1,0.0
BSESN,1/31/2011,18327.75977,18395.08984,18038.48047,18226.21094,19800,-68.210937,68.210937,0.0,21.76078544,18038.48047,19574.63086,18.83144378,-81.16855622,-353.78040760000005,-269.97835810000004,-0.029365687,3389000,-1,-0.802
BSESN,2/1/2011,18022.2207,18452.06055,17982.16992,18425.17969,20200,-305.539063,305.539063,0.0,17.172625699999998,17982.16992,19574.63086,2.515024392,-97.48497561,-398.0881994,-295.6003264,-0.056035367,3368800,-1,-0.29600000000000004
BSESN,2/2/2011,18090.61914,18306.0,18042.60938,18216.91016,22800,68.398438,0.0,68.398438,21.45056275,17982.16992,19522.38086,7.041192631,-92.95880737,-422.80937810000006,-321.0421367,-0.046774486,3391600,1,0.0
BSESN,2/3/2011,18449.31055,18466.21094,18064.60938,18113.73047,21600,358.69140600000003,0.0,358.69140600000003,40.15389797,17982.16992,19447.82031,31.87258216,-68.12741784,-408.7459229,-338.5828939,-0.031356275,3413200,1,0.5423
BSESN,2/4/2011,18008.15039,18542.19922,17926.98047,18450.07031,23000,-441.160156,441.160156,0.0,30.01243814,17926.98047,19340.99023,5.740407458,-94.25959254,-428.2617363,-356.5186624,-0.052578054000000006,3390200,-1,0.0
BSESN,2/7/2011,18037.18945,18180.93945,17977.00977,18135.01953,13000,29.039062,0.0,29.039062,31.32971131,17926.98047,19340.99023,7.79407517,-92.20592483,-436.3549215,-372.4859142,-0.058173129000000004,3403200,1,-0.5574
BSESN,2/8/2011,17775.69922,18141.50977,17742.17969,18141.50977,14200,-261.490234,261.490234,0.0,26.2050934,17742.17969,19340.99023,2.096529266,-97.90347073,-458.58265030000007,-389.7052615,-0.062930135,3389000,-1,-0.5719
BSESN,2/9/2011,17592.76953,17864.32031,17508.34961,17723.99023,30200,-182.929688,182.929688,0.0,23.14870574,17508.34961,19340.99023,4.606463529,-95.39353647,-485.36420610000005,-408.83705039999995,-0.058426196,3358800,-1,0.0
BSESN,2/10/2011,17463.03906,17636.88086,17362.58984,17603.28906,25200,-129.730468,129.730468,0.0,21.13188769,17362.58984,19340.99023,5.077294743,-94.92270526,-511.1645597,-429.3025522,-0.050713912,3333600,-1,0.0
BSESN,2/11/2011,17728.60938,17752.56055,17295.61914,17519.13086,25400,265.570312,0.0,265.570312,34.59219627,17295.61914,19340.99023,21.16927512,-78.83072488,-504.36817869999993,-444.31567750000005,-0.032690869,3359000,1,-0.29600000000000004
BSESN,2/14/2011,18202.19922,18227.61914,17857.11914,17940.16016,21800,473.589844,0.0,473.589844,51.59192948,17295.61914,19340.99023,44.32350106,-55.67649894,-455.5163464,-446.5558113,0.009986478,3380800,1,-0.4404
BSESN,2/15/2011,18273.80078,18361.66016,18050.48047,18260.08008,23600,71.601562,0.0,71.601562,53.69154999,17295.61914,19086.68945,54.614362899999996,-45.385637100000004,-406.3392439,-438.5124978,0.010125781,3404400,1,0.0
BSESN,2/16/2011,18300.90039,18358.83984,18216.11914,18273.06055,18800,27.09961,0.0,27.09961,54.55239018,17295.61914,18723.11914,70.42250438,-29.57749562,-361.017736,-423.0135455,-0.008044210999999999,3423200,1,0.0
BSESN,2/17/2011,18506.82031,18532.60938,18233.78906,18345.11914,16600,205.91992199999999,0.0,205.91992199999999,60.92155885,17295.61914,18542.19922,97.16192272,-2.838077282,-304.9686095,-399.4045583,0.027691346000000002,3439800,1,-0.0772
BSESN,2/18/2011,18211.51953,18690.9707,18159.82031,18564.08008,22000,-295.30078199999997,295.30078199999997,0.0,49.45365086,17295.61914,18690.9707,65.63939977,-34.36060023,-281.1368079,-375.7510082,0.009665036,3417800,-1,-0.25
BSESN,2/21/2011,18438.31055,18457.49023,18082.66016,18238.53906,19200,226.791016,0.0,226.791016,56.67988387,17295.61914,18690.9707,81.89272418,-18.10727582,-241.1697393,-348.83475439999995,0.037276245,3437000,1,0.0
BSESN,2/22/2011,18296.16016,18457.90039,18187.33008,18390.7207,19800,-142.15039099999998,142.15039099999998,0.0,51.36870526,17295.61914,18690.9707,71.70529938,-28.29470062,-218.44776800000002,-322.75735710000004,0.039981802000000004,3417200,-1,-0.25
BSESN,2/23/2011,18178.33008,18377.48047,18150.00977,18233.76953,22200,-117.830078,117.830078,0.0,47.14357162,17295.61914,18690.9707,63.26082695,-36.73917305,-207.555771,-299.7170399,0.040960283,3395000,-1,-0.4019
BSESN,2/24/2011,17632.41016,18135.11914,17559.69922,18135.11914,23000,-545.9199219999999,545.9199219999999,0.0,32.74527407,17295.61914,18690.9707,24.13664228,-75.86335772,-240.2060147,-287.8148349,-0.005426213,3372000,-1,0.0
BSESN,2/25/2011,17700.91016,17812.43945,17469.9707,17775.08008,21800,68.5,0.0,68.5,35.59320772,17295.61914,18690.9707,29.04579936,-70.95420064,-257.58491200000003,-281.7688503,-0.027540027,3393800,1,0.4019
BSESN,2/28/2011,17823.40039,18296.5293,17718.88086,17811.08008,30000,122.49023500000001,0.0,122.49023500000001,40.76832151,17295.61914,18690.9707,37.82424905,-62.17575095,-258.49411580000003,-277.1139034,-0.02464733,3423800,1,-0.5267
BSESN,3/1/2011,18446.5,18478.67969,17964.39063,17982.2793,24800,623.099609,0.0,623.099609,59.75069567,17295.61914,18690.9707,82.47963383,-17.52036617,-206.5547014,-263.00206299999996,0.007955871,3448600,1,-0.6705
BSESN,3/3/2011,18489.75977,18603.57031,18253.61914,18318.32031,28600,43.259766,0.0,43.259766,60.75813912,17295.61914,18690.9707,85.57991101,-14.42008899,-160.05660669999997,-242.41297169999996,-0.000921852,3477200,1,0.4404
BSESN,3/4/2011,18486.44922,18736.9707,18448.68945,18622.69922,19800,-3.310547,3.310547,0.0,60.62414941,17469.9707,18736.9707,80.22719148,-19.77280852,-122.06655790000002,-218.343689,0.015096472,3457400,-1,0.5574
BSESN,3/7/2011,18222.66992,18363.44922,18058.71094,18361.65039,15200,-263.77929700000004,263.77929700000004,0.0,50.40471206,17469.9707,18736.9707,59.40798887,-40.59201113,-111.95342579999999,-197.06563630000002,-0.011695249,3442200,-1,-0.6908
BSESN,3/8/2011,18439.65039,18466.81055,18266.61914,18277.33984,13800,216.980469,0.0,216.980469,57.24529462,17469.9707,18736.9707,76.53351918,-23.46648082,-85.44522597,-174.74155430000002,0.007842642,3456000,1,0.0
BSESN,3/9/2011,18469.94922,18583.30078,18303.80078,18522.80078,22600,30.298828000000004,0.0,30.298828000000004,58.17478301,17469.9707,18736.9707,78.9249026,-21.075097399999997,-61.28595803,-152.05043500000002,0.01604213,3478600,1,-0.5423
BSESN,3/10/2011,18327.98047,18430.83984,18261.25977,18430.83984,18600,-141.96875,141.96875,0.0,52.05624422,17469.9707,18736.9707,67.71979211,-32.28020789,-52.98448363,-132.2372447,0.039448397,3460000,-1,-0.5719
BSESN,3/11/2011,18174.08984,18368.42969,18063.28906,18248.10938,20600,-153.890625,153.890625,0.0,46.00449991,17469.9707,18736.9707,55.57372857,-44.42627143,-58.15284291,-117.42036440000001,0.026731941000000002,3439400,-1,0.0
BSESN,3/14/2011,18439.48047,18463.83984,18155.42969,18167.09961,15400,265.390625,0.0,265.390625,56.14858099,17469.9707,18736.9707,76.52010781,-23.47989219,-40.36865467,-102.01002240000001,0.034565799,3454800,1,0.0
BSESN,3/15/2011,18167.64063,18326.33008,17920.55078,18113.78906,22400,-271.83984399999997,271.83984399999997,0.0,45.94661047,17469.9707,18736.9707,55.06471365,-44.93528635,-47.66036193,-91.14009033,-0.015117196999999999,3432400,-1,0.0
BSESN,3/16/2011,18358.68945,18444.4707,18263.67969,18263.67969,16200,191.04882800000001,0.0,191.04882800000001,52.8881334,17469.9707,18736.9707,70.14354775,-29.85645225,-37.58973761,-80.43001979,-0.007088806,3448600,1,-0.0258
BSESN,3/17/2011,18149.86914,18354.26953,18104.01953,18227.16016,18200,-208.820312,208.820312,0.0,45.51630673,17469.9707,18736.9707,53.66207088,-46.33792912,-45.92930485,-73.5298768,-0.018206853999999998,3430400,-1,0.0
BSESN,3/18/2011,17878.81055,18259.60938,17849.5293,18251.17969,16400,-271.05859399999997,271.05859399999997,0.0,37.65525257,17718.88086,18736.9707,15.70879908,-84.29120092,-73.56265072,-73.53643158,-0.018869868,3414000,-1,0.0
BSESN,3/21/2011,17839.05078,18007.73047,17792.16992,17984.7207,12400,-39.759766,39.759766,0.0,36.58581592,17792.16992,18736.9707,4.961983515,-95.03801649,-97.54610644,-78.33836655,-0.032571095,3401600,-1,0.0
BSESN,3/22/2011,17988.30078,18041.38086,17878.80078,17929.08984,11800,149.25,0.0,149.25,43.53205758,17792.16992,18736.9707,20.75896453,-79.24103547,-103.3189438,-83.334482,-0.02607741,3413400,1,0.0
BSESN,3/23/2011,18206.16016,18218.2793,17950.16992,17972.03906,13400,217.859375,0.0,217.859375,52.32721853,17792.16992,18736.9707,43.81772775,-56.18227225,-89.2853027,-84.52464614,-0.006646685,3426800,1,-0.7783
BSESN,3/24/2011,18350.74023,18373.9707,18269.32031,18286.41992,11200,144.58007800000001,0.0,144.58007800000001,57.40715818,17792.16992,18583.30078,70.60403543,-29.39596457,-65.73933494,-80.7675839,0.009719903,3438000,1,-0.4019
BSESN,3/25/2011,18815.64063,18858.30078,18480.68945,18480.68945,15200,464.900391,0.0,464.900391,69.47526863,17792.16992,18858.30078,95.99860039,-4.001399607,-9.456402105,-66.50534754,0.020399716000000002,3453200,1,-0.4767
BSESN,3/28/2011,18943.14063,19024.17969,18799.57031,18799.71094,12800,127.5,0.0,127.5,71.98693243,17792.16992,19024.17969,93.42220612,-6.577793881,44.91861823,-44.22055439,0.042685785,3466000,1,-0.3182
BSESN,3/29/2011,19120.80078,19226.21094,18944.82031,18949.57031,17200,177.660156,0.0,177.660156,75.25988114,17792.16992,19226.21094,92.64943221,-7.350567788999999,101.1805569,-15.14033212,0.041512295,3483200,1,-0.5106
BSESN,3/30/2011,19290.17969,19357.09961,19178.76953,19178.76953,12200,169.378907,0.0,169.378907,78.07752046,17792.16992,19357.09961,95.72377459,-4.276225415,157.61907630000002,19.41154957,0.06282748,3495400,1,0.0
BSESN,3/31/2011,19445.2207,19575.16016,19284.34961,19339.75,16200,155.041015,0.0,155.041015,80.43137253,17792.16992,19575.16016,92.71227343,-7.287726569,212.40900499999998,58.01104066,0.08761266,3511600,1,0.0
BSESN,4/1/2011,19420.39063,19562.55078,19382.34961,19463.10938,12400,-24.830078,24.830078,0.0,78.86656189,17792.16992,19575.16016,91.31966468,-8.680335318,250.93422489999998,96.59567750000001,0.08864484199999999,3499200,-1,-0.7783
BSESN,4/4/2011,19701.73047,19729.59961,19449.35938,19473.92969,10600,281.33984399999997,0.0,281.33984399999997,83.15192527,17792.16992,19729.59961,98.56154057,-1.438459428,300.70121689999996,137.4167854,0.095252448,3509800,1,-0.5719
BSESN,4/5/2011,19686.82031,19770.21094,19523.53906,19731.38086,12600,-14.910156,14.910156,0.0,82.1334826,17792.16992,19770.21094,95.7841812,-4.215818799,335.0762413,176.94867649999998,0.08132742700000001,3497200,-1,-0.6369
BSESN,4/6/2011,19612.19922,19811.14063,19550.55078,19698.60938,14400,-74.621094,74.621094,0.0,76.70807124,17792.16992,19811.14063,90.14639461,-9.853605389,352.2370279,212.00634680000005,0.068741586,3482800,-1,-0.3818
BSESN,4/7/2011,19591.17969,19665.08984,19537.01953,19620.88086,9600,-21.019531,21.019531,0.0,75.09580257,17792.16992,19811.14063,89.10529327,-10.89470673,359.9912198,241.60332140000003,0.041217787,3473200,-1,0.4019
BSESN,4/8/2011,19451.44922,19697.21094,19388.41992,19602.81055,10400,-139.730469,139.730469,0.0,64.6698818,17878.80078,19811.14063,81.38570671,-18.61429329,350.8173872,263.4461346,0.026833385,3462800,-1,0.34
BSESN,4/11/2011,19262.53906,19426.30078,19242.58984,19382.91016,9400,-188.910156,188.910156,0.0,53.15727737,17950.16992,19811.14063,70.52067713,-29.47932287,324.56223650000004,275.669355,0.00741278,3453400,-1,0.0
BSESN,4/13/2011,19696.85938,19737.33008,19101.63086,19187.00977,17800,434.320312,0.0,434.320312,68.18295574,18269.32031,19811.14063,92.58790087,-7.412099134,334.9398814,287.5234603,0.021082214,3471200,1,0.4019
BSESN,4/15/2011,19386.82031,19700.96094,19337.11914,19670.07031,17000,-310.039062,310.039062,0.0,53.93333215,18480.68945,19811.14063,68.10703609999999,-31.892963899999998,314.5210754,292.9229833,-0.0030033290000000003,3454200,-1,0.1779
BSESN,4/18/2011,19091.16992,19649.2207,19071.4707,19389.74023,13800,-295.650391,295.650391,0.0,43.84994256,18799.57031,19811.14063,28.82643011,-71.17356989,271.35450299999997,288.6092872,-0.016952321,3440400,-1,0.0
BSESN,4/19/2011,19121.83008,19201.91992,18976.18945,19091.7793,11400,30.660156,0.0,30.660156,45.07861076,18944.82031,19811.14063,20.43236925,-79.56763075,236.8880043,278.26503060000005,-0.029433982999999997,3451800,1,0.0
BSESN,4/20/2011,19470.98047,19484.76953,19171.0293,19274.21094,15400,349.150391,0.0,349.150391,57.34332628,18976.18945,19811.14063,59.25987442,-40.74012558,235.0372116,269.6194668,-0.010963671999999999,3467200,1,0.4215
BSESN,4/21/2011,19602.23047,19695.98047,19530.5,19582.5,15200,131.25,0.0,131.25,61.11024191,18976.18945,19811.14063,74.97935652,-25.02064348,241.37875919999996,263.9713253,-0.000508293,3482400,1,0.2755
BSESN,4/25/2011,19584.31055,19697.49023,19531.33984,19538.51953,11400,-17.919922,17.919922,0.0,60.27175278,18976.18945,19811.14063,72.83313257,-27.16686743,242.1669435,259.6104489,-0.000350624,3471000,-1,-0.29600000000000004
BSESN,4/26/2011,19545.34961,19626.13086,19306.91992,19596.32031,11600,-38.960938,38.960938,0.0,58.26616772,18976.18945,19811.14063,68.1668791,-31.833120899999997,236.91673459999998,255.07170609999997,0.004827424,3459400,-1,0.0
BSESN,4/27/2011,19448.68945,19633.63086,19412.78906,19610.71094,13400,-96.660156,96.660156,0.0,53.19866499,18976.18945,19811.14063,56.59013555,-43.40986445,222.3926356,248.535892,0.009663855,3446000,-1,0.0
BSESN,4/28/2011,19292.01953,19542.05078,19265.91992,19532.84961,14000,-156.66992199999999,156.66992199999999,0.0,45.75624823,18976.18945,19811.14063,37.82617338,-62.17382662,195.9810811,238.0249298,-0.020553523,3432000,-1,-0.29600000000000004
BSESN,4/29/2011,19135.96094,19356.5,19015.05078,19292.57031,10600,-156.058593,156.058593,0.0,39.41814383,18976.18945,19737.33008,20.99105996,-79.00894004,160.6057467,222.5410932,-0.012939686,3421400,-1,0.0
BSESN,5/2/2011,18998.01953,19253.86914,18954.75977,19224.05078,9400,-137.941407,137.941407,0.0,34.53870475,18954.75977,19737.33008,5.527907759,-94.47209224,120.05589099999999,202.0440528,-0.00487924,3412000,-1,-0.128
BSESN,5/3/2011,18534.68945,19024.94922,18502.41992,18979.31055,13400,-463.330078,463.330078,0.0,23.34086191,18502.41992,19737.33008,2.613107589,-97.38689241,49.95709878,171.626662,-0.030705253,3398600,-1,0.0
BSESN,5/4/2011,18469.35938,18604.35938,18339.5293,18558.33008,13000,-65.330078,65.330078,0.0,22.17138479,18339.5293,19737.33008,9.28816751,-90.71183249,-10.74443523,135.1524425,-0.05144173900000001,3385600,-1,0.0498
BSESN,5/5/2011,18210.58008,18569.21094,18160.65039,18484.71094,14800,-258.77929700000004,258.77929700000004,0.0,18.0401549,18160.65039,19700.96094,3.2415338,-96.7584662,-78.82353617,92.35724678,-0.070994492,3370800,-1,0.0
BSESN,5/6/2011,18518.81055,18568.48047,18271.67969,18289.7793,30200,308.23046899999997,0.0,308.23046899999997,34.74965019,18160.65039,19697.49023,23.30497596,-76.69502404,-106.67540359999998,52.5507167,-0.054405796,3401000,1,0.0
BSESN,5/9/2011,18528.96094,18643.58008,18367.21094,18628.63086,9200,10.150391,0.0,10.150391,35.25124007,18160.65039,19697.49023,23.96544758,-76.03455242,-126.4712754,16.74631828,-0.05200156,3410200,1,-0.34
BSESN,5/10/2011,18512.76953,18689.36914,18429.06055,18564.94922,13200,-16.191407,16.191407,0.0,34.75944018,18160.65039,19697.49023,22.91189558,-77.08810442,-141.8312157,-14.96918851,-0.048122519,3397000,-1,-0.4767
BSESN,5/11/2011,18584.96094,18622.43945,18454.92969,18572.60938,10000,72.191407,0.0,72.191407,39.12839544,18160.65039,19697.49023,27.60928856,-72.39071144,-146.4901881,-41.27338842,-0.036650315,3407000,1,0.0
BSESN,5/12/2011,18335.78906,18610.01953,18314.33984,18525.32031,10200,-249.171875,249.171875,0.0,30.89005072,18160.65039,19697.49023,11.39602625,-88.60397375,-168.347935,-66.68829773,-0.041815087,3396800,-1,0.1245
BSESN,5/13/2011,18531.2793,18724.53906,18280.69922,18362.44922,12600,195.49023400000002,0.0,195.49023400000002,41.95365756,18160.65039,19633.63086,25.16183439,-74.83816561,-167.9597928,-86.94259674,-0.024567836000000003,3409400,1,0.2023
BSESN,5/16/2011,18345.0293,18492.67969,18319.88086,18492.67969,9400,-186.25,186.25,0.0,35.67533848,18160.65039,19633.63086,12.51740332,-87.48259668,-180.59917099999998,-105.6739116,-0.010232713000000001,3400000,-1,-0.29600000000000004
BSESN,5/17/2011,18137.34961,18435.80078,18084.66992,18374.44922,14200,-207.679688,207.679688,0.0,29.91544257,18084.66992,19542.05078,3.614682235,-96.38531777,-205.0107481,-125.54127890000001,-0.017976247,3385800,-1,0.0
BSESN,5/18/2011,18086.19922,18218.19922,18020.78906,18177.32031,12400,-51.15039,51.15039,0.0,28.60305593,18020.78906,19356.5,4.897029304,-95.1029707,-225.8806958,-145.6091623,-0.006830143,3373400,-1,-0.6597
BSESN,5/19/2011,18141.40039,18198.44922,18057.82031,18166.64063,13400,55.201172,0.0,55.201172,32.30128696,18020.78906,19253.86914,9.781305378999999,-90.21869462,-235.2541431,-163.53815840000001,-0.020379827,3386800,1,0.0
BSESN,5/20/2011,18326.08984,18429.4707,18161.38086,18199.96094,17000,184.68945300000001,0.0,184.68945300000001,43.58280641,18020.78906,19024.94922,30.403594399999996,-69.5964056,-225.1839915,-175.867325,-0.010948865,3403800,1,-0.5574
BSESN,5/23/2011,17993.33008,18269.06055,17971.01953,18269.06055,10400,-332.759766,332.759766,0.0,32.36899935,17971.01953,18724.53906,2.960845214,-97.03915479,-241.2730107,-188.9484622,-0.028058441,3393400,-1,0.0
BSESN,5/24/2011,18011.9707,18110.39063,17933.93945,18016.42969,12600,18.640625,0.0,18.640625,33.47536317,17933.93945,18724.53906,9.869882177000001,-90.13011782,-249.64181630000002,-201.087133,-0.030830855,3406000,1,0.1779
BSESN,5/25/2011,17847.24023,17976.35938,17786.13086,17976.35938,10200,-164.730469,164.730469,0.0,28.68972452,17786.13086,18724.53906,6.512024802999999,-93.4879752,-266.494544,-214.16861519999998,-0.026644549,3395800,-1,0.0
BSESN,5/26/2011,18044.64063,18072.60938,17862.88086,17917.10938,12600,197.40039099999998,0.0,197.40039099999998,40.45906748,17786.13086,18724.53906,27.54768819,-72.45231181,-260.9142334,-223.51773880000002,-0.026260392999999996,3408400,1,0.0
BSESN,5/27/2011,18266.09961,18298.64063,18087.16016,18105.60938,12800,221.458984,0.0,221.458984,50.94041609,17786.13086,18724.53906,51.14711785,-48.85288215,-235.90256980000004,-225.99470499999998,-0.004302511,3421200,1,-0.6486
BSESN,5/30/2011,18232.06055,18380.16992,18199.51953,18319.74023,11600,-34.039062,34.039062,0.0,49.39820132,17786.13086,18724.53906,47.51979854,-52.48020146,-216.33355559999998,-224.06247510000003,0.005221873,3409600,-1,-0.4767
BSESN,5/31/2011,18503.2793,18526.80078,18266.60938,18266.60938,14600,271.21875,0.0,271.21875,60.41594537,17786.13086,18724.53906,76.4217997,-23.5782003,-176.9006833,-214.6301168,0.023060681,3424200,1,0.0
BSESN,6/1/2011,18608.81055,18636.11914,18514.66016,18527.11914,12600,105.53125,0.0,105.53125,63.94088045,17786.13086,18724.53906,87.66757201,-12.33242799,-135.5715734,-198.8184081,0.025764832999999997,3436800,1,-0.4404
BSESN,6/2/2011,18494.17969,18540.66992,18390.57031,18425.84961,15400,-114.63085900000002,114.63085900000002,0.0,57.52101724,17786.13086,18636.11914,83.30101061,-16.69898939,-110.7905834,-181.21284319999998,0.009172161,3421400,-1,0.0
BSESN,6/3/2011,18376.48047,18672.65039,18345.84961,18554.40039,14400,-117.699219,117.699219,0.0,51.40621104,17786.13086,18672.65039,66.59183342,-33.40816658,-99.5018186,-164.8706382,0.021294023,3407000,-1,0.0
BSESN,6/6/2011,18420.10938,18458.63086,18258.41992,18344.26953,8800,43.628906,0.0,43.628906,53.51957771,17786.13086,18672.65039,71.51320339,-28.48679661,-86.04305233,-149.1051211,0.022659301,3415800,1,0.4939
BSESN,6/7/2011,18495.61914,18545.94922,18351.24023,18355.30078,10000,75.509766,0.0,75.509766,57.23382808,17786.13086,18672.65039,80.03075583,-19.96924417,-68.4943162,-132.9829601,0.036329365,3425800,1,-0.3818
BSESN,6/8/2011,18394.28906,18505.09961,18365.93945,18448.40039,10800,-101.330078,101.330078,0.0,50.9318909,17786.13086,18672.65039,68.60065481,-31.39934519,-62.04805546,-118.79597920000002,0.019376858,3415000,-1,0.0
BSESN,6/9/2011,18384.90039,18449.64063,18327.00977,18394.57031,10000,-9.388672,9.388672,0.0,50.3393173,17786.13086,18672.65039,67.54160629,-32.45839371,-57.03941983,-106.44466729999999,0.0065038940000000005,3405000,-1,0.0
BSESN,6/10/2011,18268.53906,18399.01953,18182.90039,18390.41016,9600,-116.361328,116.361328,0.0,43.15853732,17786.13086,18672.65039,54.41597016,-45.58402984,-61.74763836,-97.50526151,0.00200079,3395400,-1,-0.8859999999999999
BSESN,6/13/2011,18266.0293,18313.21094,18120.75977,18242.25,10400,-2.509766,2.509766,0.0,43.00586355,17786.13086,18672.65039,54.13286687,-45.86713313,-64.93294603,-90.99079842,-0.012822051000000001,3385000,-1,-0.6124
BSESN,6/14/2011,18308.66016,18380.18945,18261.10938,18276.7793,26800,42.630859,0.0,42.630859,46.70119942,17862.88086,18672.65039,55.05014444,-44.94985556,-63.28782857,-85.45020445,-0.016129477,3411800,1,0.3818
BSESN,6/15/2011,18132.24023,18308.68945,18111.21094,18298.58984,9600,-176.41992199999999,176.41992199999999,0.0,35.66077117,18087.16016,18672.65039,7.699543956,-92.30045604,-75.35107416,-83.43037839,-0.019570452,3402200,-1,0.4939
BSESN,6/16/2011,17985.88086,18155.09961,17958.93945,18060.10938,10600,-146.359375,146.359375,0.0,29.08004542,17958.93945,18672.65039,3.774834399,-96.2251656,-95.61902499,-85.86810771,-0.021255409,3391600,-1,-0.29600000000000004
BSESN,6/17/2011,17870.5293,18064.75977,17844.08984,18060.16992,10800,-115.35156200000002,115.35156200000002,0.0,24.90121753,17844.08984,18672.65039,3.191010373,-96.80898963,-119.6106321,-92.6166126,-0.029835875,3380800,-1,0.0
BSESN,6/20/2011,17506.63086,17925.16992,17314.38086,17925.16992,12800,-363.898438,363.898438,0.0,16.34930412,17314.38086,18672.65039,14.15403905,-85.84596095,-166.07332649999998,-107.3079554,-0.053471488,3368000,-1,0.0
BSESN,6/21/2011,17560.30078,17714.88086,17504.26953,17574.36914,11400,53.669922,0.0,53.669922,20.96825118,17314.38086,18672.65039,18.10538455,-81.89461545,-196.3017875,-125.10672179999999,-0.045339522,3379400,1,0.1531
BSESN,6/22/2011,17550.63086,17678.85938,17492.18945,17659.36914,9600,-9.669922,9.669922,0.0,20.73028317,17314.38086,18672.65039,17.39345501,-82.60654499,-218.51938700000002,-143.7892548,-0.045377974,3369800,-1,0.0
BSESN,6/23/2011,17727.49023,17754.55078,17482.21094,17526.91992,11400,176.859375,0.0,176.859375,36.04713157,17314.38086,18545.94922,33.54335727,-66.45664273,-219.3276486,-158.89693359999998,-0.029616426,3381200,1,0.0
BSESN,6/24/2011,18240.67969,18268.94922,17804.93945,17804.93945,14800,513.189454,0.0,513.189454,61.16851844,17314.38086,18545.94922,75.21294466,-24.78705534,-176.52325159999998,-162.42219719999997,-0.0013878010000000001,3396000,1,0.0
BSESN,6/27/2011,18412.41016,18494.10938,18132.69922,18132.69922,13400,171.730468,0.0,171.730468,66.28247269,17314.38086,18505.09961,92.215672,-7.784327995,-127.2760855,-155.3929749,0.005666717,3409400,1,0.4449
BSESN,6/28/2011,18492.44922,18527.44922,18323.43945,18493.58984,11400,80.039063,0.0,80.039063,68.51251642,17314.38086,18527.44922,97.11475452,-2.8852454780000003,-80.85680125,-140.4857401,0.019865663999999998,3420800,1,-0.3818
BSESN,6/29/2011,18693.85938,18715.39063,18552.18945,18552.18945,13800,201.410156,0.0,201.410156,73.58514604,17314.38086,18715.39063,98.46316203,-1.5368379669999999,-27.50006408,-117.88860490000002,0.039363016,3434600,1,0.0
BSESN,6/30/2011,18845.86914,18873.39063,18723.14063,18741.09961,11400,152.00976599999998,0.0,152.00976599999998,76.83501109,17314.38086,18873.39063,98.23468174,-1.765318255,26.743173600000002,-88.96224923,0.054578117,3446000,1,-0.4019
BSESN,7/1/2011,18762.80078,19031.38086,18713.07031,18974.96094,14000,-83.06836,83.06836,0.0,71.3035446,17314.38086,19031.38086,84.35759592,-15.64240408,62.31013539,-58.7077723,0.07175395,3432000,-1,0.0
BSESN,7/4/2011,18814.48047,18942.41992,18781.88086,18896.24023,12200,51.679688,0.0,51.679688,72.71367208,17314.38086,19031.38086,87.36747874,-12.63252126,93.58849783,-28.24851828,0.07142131,3444200,1,-0.7269
BSESN,7/5/2011,18744.56055,18837.88086,18694.05078,18837.88086,12200,-69.919922,69.919922,0.0,67.53312168,17314.38086,19031.38086,83.29526429999999,-16.7047357,111.4501442,-0.308785788,0.06802773599999999,3432000,-1,0.0
BSESN,7/6/2011,18726.9707,18823.44922,18682.59961,18730.28906,8400,-17.589844,17.589844,0.0,66.16477659,17314.38086,19031.38086,82.27081211,-17.72918789,122.771046,24.30718056,0.056380257999999996,3423600,-1,-0.5423
BSESN,7/7/2011,19078.30078,19097.7793,18767.25,18776.61914,11400,351.33007799999996,0.0,351.33007799999996,76.93514892,17314.38086,19097.7793,98.90778664,-1.09221336,158.2679291,51.09933028,0.045920498,3435000,1,0.8779
BSESN,7/8/2011,18858.03906,19131.69922,18817.71094,19084.06055,12200,-220.26171800000003,220.26171800000003,0.0,62.53528471,17482.21094,19131.69922,83.40939071,-16.59060929,166.704519,74.22036803,0.024202638999999998,3422800,-1,-0.0772
BSESN,7/11/2011,18721.39063,18843.9707,18679.49023,18823.18945,9200,-136.648438,136.648438,0.0,55.14661858,17482.21094,19131.69922,75.12509796,-24.87490204,160.5138862,91.47907167,0.012380263999999998,3413600,-1,0.0
BSESN,7/12/2011,18411.61914,18589.18945,18326.41992,18534.10938,10600,-309.771484,309.771484,0.0,42.12727817,17482.21094,19131.69922,56.34524438,-43.65475562,129.12334170000003,99.00792568,-0.015098018000000001,3403000,-1,0.0
BSESN,7/13/2011,18596.01953,18626.41016,18465.40039,18468.82031,9800,184.40039,0.0,184.40039,50.20236367,17804.93945,19131.69922,59.6249674,-40.3750326,117.76812179999999,102.75996490000001,-0.013257527,3412800,1,0.0
BSESN,7/14/2011,18618.19922,18803.05078,18449.23047,18563.68945,11800,22.179688,0.0,22.179688,51.14836945,18132.69922,19131.69922,48.5985986,-51.4014014,109.29881499999999,104.0677349,-0.0077068219999999995,3424600,1,-0.5267
BSESN,7/15/2011,18561.91992,18936.42969,18513.2207,18694.18945,6800,-56.279297,56.279297,0.0,48.45341993,18323.43945,19131.69922,29.50542376,-70.49457624,96.92823107,102.63983420000001,-0.013423731999999999,3417800,-1,-0.3612
BSESN,7/18/2011,18507.03906,18622.56055,18469.5293,18592.18945,9000,-54.880858999999994,54.880858999999994,0.0,45.74166197,18326.41992,19131.69922,22.42937844,-77.57062156,81.75362266,98.46259185,-0.012671489,3408800,-1,-0.4404
BSESN,7/19/2011,18653.86914,18690.41992,18481.83008,18521.38086,8400,146.83007800000001,0.0,146.83007800000001,53.73488875,18326.41992,19131.69922,40.66281354,-59.33718646,80.64595993,94.89926547,-0.003903544,3417200,1,-0.7964
BSESN,7/20/2011,18502.38086,18765.59961,18473.90039,18756.31055,9800,-151.488282,151.488282,0.0,45.71723147,18326.41992,19131.69922,21.85092025,-78.14907975,66.7745554,89.27432346,-0.030187171000000002,3407400,-1,0.2023
BSESN,7/21/2011,18436.18945,18566.99023,18415.35938,18514.65039,8000,-66.191406,66.191406,0.0,42.51876195,18326.41992,19131.69922,13.63123719,-86.36876281,49.86545616,81.39255,-0.02236975,3399400,-1,0.4939
BSESN,7/22/2011,18722.30078,18747.06055,18533.42969,18565.03906,14800,286.11132799999996,0.0,286.11132799999996,57.38766629,18326.41992,19131.69922,49.16069002,-50.83930998,58.87301476,76.88864295,4.8599999999999995e-05,3414200,1,-0.3612
BSESN,7/25/2011,18871.28906,18932.26953,18670.83984,18753.34961,22800,148.988282,0.0,148.988282,63.11974031,18326.41992,19131.69922,67.66213201,-32.33786799,77.14440636,76.93979563,0.024966295,3437000,1,0.128
BSESN,7/26/2011,18518.2207,18944.59961,18481.63086,18898.18945,15600,-353.06836,353.06836,0.0,46.14635506,18326.41992,19131.69922,23.81792028,-76.18207972,62.41546329999999,74.03492916,-0.004183628,3421400,-1,0.0
BSESN,7/27/2011,18432.25,18578.55078,18358.75977,18571.15039,14200,-85.970703,85.970703,0.0,42.90483241,18326.41992,19131.69922,13.14203387,-86.85796613,43.30634398,67.88921213,-0.009987498000000001,3407200,-1,-0.34
BSESN,7/28/2011,18209.51953,18327.84961,18188.88086,18300.55078,12200,-222.730469,222.730469,0.0,35.45897247,18188.88086,18944.59961,2.730999065,-97.26900093,10.07361942,56.32609359,-0.018985126,3395000,-1,0.3818
BSESN,7/29/2011,18197.19922,18334.26953,18131.85938,18194.15039,16200,-12.320312,12.320312,0.0,35.07051738,18131.85938,18944.59961,8.039449909,-91.96055009,-17.06103148,41.64866857,-0.01674173,3378800,-1,-0.6908
BSESN,8/1/2011,18314.33008,18440.07031,18219.25,18352.23047,9600,117.13085900000002,0.0,117.13085900000002,42.0362767,18131.85938,18944.59961,22.45129444,-77.54870556,-28.78217342,27.56250018,-0.018202072,3388400,1,0.2263
BSESN,8/2/2011,18109.89063,18283.55078,18037.86914,18283.55078,11000,-204.43945300000001,204.43945300000001,0.0,34.56769364,18037.86914,18944.59961,7.942987088,-92.05701291,-53.94596266,11.26080761,-0.021212957999999997,3377400,-1,0.0
BSESN,8/3/2011,17940.55078,18005.75977,17859.5,17970.18945,13400,-169.339844,169.339844,0.0,29.549904499999997,17859.5,18944.59961,7.469432329,-92.53056767,-86.55500489,-8.302354891,-0.026884007999999997,3364000,-1,-0.5093
BSESN,8/4/2011,17693.17969,18032.55078,17664.73047,17983.85938,11000,-247.37109300000003,247.37109300000003,0.0,23.74116685,17664.73047,18944.59961,2.2228224830000003,-97.77717752,-130.8503245,-32.81194882,-0.054967662,3353000,-1,0.0
BSESN,8/5/2011,17305.86914,17358.17969,16990.91016,17350.36914,20400,-387.31054700000004,387.31054700000004,0.0,17.51951144,16990.91016,18944.59961,16.12124099,-83.87875901,-194.96003090000002,-65.24156523,-0.082952464,3332600,-1,0.0
BSESN,8/8/2011,16990.17969,17247.86914,16759.44922,16907.57031,20000,-315.68945299999996,315.68945299999996,0.0,14.05537502,16759.44922,18944.59961,10.5590201,-89.44097990000002,-268.14987080000003,-105.8232263,-0.082515542,3312600,-1,0.5106
BSESN,8/9/2011,16857.91016,17135.03906,16432.0,16517.86914,23800,-132.269532,132.269532,0.0,12.82902537,16432.0,18944.59961,16.95097597,-83.04902403,-332.9879146,-151.25616399999998,-0.085412245,3288800,-1,-0.4767
BSESN,8/10/2011,17130.50977,17256.46094,17022.25,17244.71094,15600,272.59961,0.0,272.59961,27.80777668,16432.0,18944.59961,27.80028157,-72.19971843,-358.24637989999997,-192.6542072,-0.059255257,3304400,1,0.0
BSESN,8/11/2011,17059.40039,17207.82031,17012.94922,17056.60938,9400,-71.109375,71.109375,0.0,26.44030091,16432.0,18944.59961,24.97016989,-75.02983011,-379.62573860000003,-230.04851349999998,-0.06252604099999999,3295000,-1,-0.0516
BSESN,8/12/2011,16839.63086,17246.88086,16784.56055,17246.88086,13400,-219.76953199999997,219.76953199999997,0.0,22.49540369,16432.0,18944.59961,16.22347061,-83.77652939,-409.5812019,-265.9550512,-0.080521603,3281600,-1,-0.5423
BSESN,8/16/2011,16730.93945,17035.49023,16673.51953,17015.99023,12600,-108.691406,108.691406,0.0,20.73037381,16432.0,18578.55078,13.92650272,-86.07349728,-437.0535294,-300.17474680000004,-0.07614353900000001,3269000,-1,0.0516
BSESN,8/17/2011,16840.80078,17000.38086,16708.98047,16782.24023,15000,109.861328,0.0,109.861328,27.37600101,16432.0,18440.07031,20.35789177,-79.64210823,-444.8328991,-329.1063773,-0.061299679,3284000,1,0.0
BSESN,8/18/2011,16469.78906,16916.81055,16433.31055,16910.26953,14600,-371.01171800000003,371.01171800000003,0.0,20.63500076,16432.0,18440.07031,1.8818595519999999,-98.11814045,-475.45490250000006,-358.3760823,-0.069144758,3269400,-1,-0.34
BSESN,8/19/2011,16141.669919999998,16287.71973,15987.769530000001,16237.78027,16400,-328.119141,328.119141,0.0,16.49120325,15987.769530000001,18440.07031,6.275755084,-93.72424492,-520.2029574,-390.74145730000004,-0.06727193,3253000,-1,0.0
BSESN,8/22/2011,16341.7002,16370.45996,16046.480469999999,16155.990230000001,11600,200.030273,0.0,200.030273,26.8272712,15987.769530000001,18283.55078,15.41656741,-84.58343259,-533.376905,-419.26854689999993,-0.038167901000000004,3264600,1,0.6369
BSESN,8/23/2011,16498.4707,16549.21094,16213.17969,16446.84961,11400,156.770508,0.0,156.770508,34.19293964,15987.769530000001,18032.55078,24.97583407,-75.02416593,-525.1140952,-440.43765650000006,-0.021321708999999998,3276000,1,0.0
BSESN,8/24/2011,16284.980469999999,16533.2207,16253.78027,16490.7793,13600,-213.490234,213.490234,0.0,29.52324429,15987.769530000001,18032.55078,14.53509699,-85.46490301,-529.6867375,-458.2874727,-0.049358093,3262400,-1,-0.4767
BSESN,8/25/2011,16146.330080000002,16373.83984,16104.33984,16338.13965,12200,-138.65039099999998,138.65039099999998,0.0,26.78235288,15987.769530000001,17358.17969,11.57029858,-88.42970142,-538.293406,-474.2886594,-0.053523002,3250200,-1,0.0
BSESN,8/26/2011,15848.830080000002,16256.37988,15765.53027,16155.549809999999,14200,-297.5,297.5,0.0,21.77695429,15765.53027,17256.46094,5.587101195,-94.41289881,-562.6343182999999,-491.9577912,-0.058837441,3236000,-1,0.0
BSESN,8/29/2011,16416.33008,16462.0293,16068.730469999999,16080.740230000001,11200,567.5,0.0,567.5,44.57592331,15765.53027,17256.46094,43.65057479,-56.34942521,-530.0223913,-499.57071119999995,-0.018804047,3247200,1,0.4019
BSESN,8/30/2011,16676.75,16714.69922,16443.34961,16585.09961,15200,260.41992200000004,0.0,260.41992200000004,51.98573272,15765.53027,17256.46094,61.11751193,-38.88248807,-477.6573562,-495.1880402,-0.00974127,3262400,1,-0.7096
BSESN,9/2/2011,16821.46094,16989.85938,16688.06055,16963.66992,12800,144.710938,0.0,144.710938,55.77657734,15765.53027,17246.88086,71.28161794,-28.71838206,-419.6433381,-480.0790998,0.021352542999999998,3275200,1,0.0
BSESN,9/5/2011,16713.33008,16760.07031,16561.46094,16678.33984,12200,-108.13086000000001,108.13086000000001,0.0,52.22178991,15765.53027,17246.88086,63.98213994,-36.01786006,-378.03432319999996,-459.67014450000005,0.035415181000000004,3263000,-1,-0.3612
BSESN,9/6/2011,16862.81055,16894.73047,16488.30078,16663.73047,14600,149.480469,0.0,149.480469,56.63065988,15765.53027,17035.49023,86.40274557,-13.59725443,-329.20221630000003,-433.57655880000004,0.03188838,3277600,1,0.0
BSESN,9/7/2011,17065.0,17157.21094,16922.31055,16922.31055,17400,202.18945300000001,0.0,202.18945300000001,62.09036262,15765.53027,17157.21094,93.37413098,-6.625869017,-271.06277769999997,-401.0738026,0.034338292,3295000,1,0.0
BSESN,9/8/2011,17165.53906,17209.66016,16987.36914,17118.08008,12200,100.539063,0.0,100.539063,64.64407856,15765.53027,17209.66016,96.94479745,-3.0552025489999997,-214.40269080000002,-363.7395802,0.054071824000000004,3307200,1,-0.3818
BSESN,9/9/2011,16866.9707,17211.80078,16830.94922,17189.75,11800,-298.56836,298.56836,0.0,52.52100274,15765.53027,17211.80078,76.15729035,-23.84270965,-191.38496840000002,-329.2686579,0.044631853,3295400,-1,0.34
BSESN,9/12/2011,16501.74023,16668.25,16393.03906,16668.25,13400,-365.23046899999997,365.23046899999997,0.0,41.52840274,15765.53027,17211.80078,50.90402915,-49.09597085,-200.3053091,-303.4759881,0.041196111,3282000,-1,-0.7269
BSESN,9/13/2011,16467.43945,16766.18945,16374.67969,16618.16992,14600,-34.300781,34.300781,0.0,40.60740707,15765.53027,17211.80078,48.53235796,-51.46764204,-207.74774309999998,-284.3303391,0.003113325,3267400,-1,0.0572
BSESN,9/14/2011,16709.59961,16754.2207,16387.38086,16522.71094,16000,242.160156,0.0,242.160156,49.69537637,15765.53027,17211.80078,65.2761244,-34.7238756,-191.8935949,-265.8429903,0.001969785,3283400,1,0.0
BSESN,9/15/2011,16876.53906,16922.40039,16545.4707,16837.75977,15400,166.939454,0.0,166.939454,55.15376845,15765.53027,17211.80078,76.81887889,-23.18112111,-163.9683248,-245.46805719999998,0.003274277,3298800,1,0.0
BSESN,9/16/2011,16933.83008,17122.53906,16889.58008,17047.73047,20400,57.291015,0.0,57.291015,57.00128255,15765.53027,17211.80078,80.78017207,-19.21982793,-135.6507435,-223.5045944,0.013193062,3319200,1,0.0
BSESN,9/19/2011,16745.34961,16865.92969,16709.41016,16865.92969,11600,-188.480469,188.480469,0.0,49.29273639,16068.730469999999,17211.80078,59.19313387,-40.80686613,-126.954206,-204.19451669999998,-0.00696568,3307600,-1,-0.4019
BSESN,9/20/2011,17099.2793,17135.43945,16758.68945,16768.63086,14200,353.929688,0.0,353.929688,60.78362967,16374.67969,17211.80078,86.55851765,-13.44148235,-90.46020051,-181.4476535,0.0020087489999999998,3321800,1,0.5106
BSESN,9/21/2011,17065.15039,17191.11914,17000.60938,17128.83008,13400,-34.128906,34.128906,0.0,59.28874007,16374.67969,17211.80078,82.48157988,-17.51842012,-63.55967932,-157.8700587,-0.005848268,3308400,-1,-0.5719
BSESN,9/22/2011,16361.15039,16833.60938,16316.03027,16827.84961,18400,-704.0,704.0,0.0,37.39772593,16316.03027,17211.80078,5.037017584,-94.96298242,-97.91898974,-145.8798449,-0.029988806,3290000,-1,0.0
BSESN,9/23/2011,16162.05957,16368.41016,16052.46973,16222.37012,22000,-199.090821,199.090821,0.0,33.37647964,16052.46973,17211.80078,9.452851506,-90.54714849,-139.6046803,-144.62481200000002,-0.020584536,3268000,-1,-0.5423
BSESN,9/26/2011,16051.09961,16209.19043,15801.009769999999,16209.19043,18800,-110.959961,110.959961,0.0,31.21783467,15801.009769999999,17211.80078,17.72692343,-82.27307657,-179.5249797,-151.6048455,-0.02528261,3249200,-1,-0.2023
BSESN,9/27/2011,16524.0293,16551.65039,16282.740230000001,16289.32031,16200,472.929688,0.0,472.929688,47.81588866,15801.009769999999,17211.80078,51.24922992,-48.75077008,-171.0291141,-155.4896992,-0.011105611000000001,3265400,1,-0.5574
BSESN,9/28/2011,16446.01953,16663.25977,16363.62988,16663.25977,19600,-78.009766,78.009766,0.0,45.71621454,15801.009769999999,17211.80078,45.71972448,-54.28027552,-168.6467606,-158.1211115,-0.025509942,3245800,-1,-0.2732
BSESN,9/29/2011,16698.07031,16756.08008,16316.66016,16387.91016,19200,252.05078199999997,0.0,252.05078199999997,53.35269436,15801.009769999999,17191.11914,64.53165219,-35.46834781,-144.75172890000002,-155.447235,-0.013922412,3265000,1,-0.5719
BSESN,9/30/2011,16453.75977,16745.16016,16404.7793,16599.74023,20000,-244.310547,244.310547,0.0,46.09961463,15801.009769999999,17191.11914,46.95673677,-53.04326323,-143.87011830000003,-153.1318117,-0.017413183,3245000,-1,-0.6705
BSESN,10/3/2011,16151.4502,16255.96973,16056.330080000002,16255.96973,17000,-302.309571,302.309571,0.0,38.60618591,15801.009769999999,17191.11914,25.20955799,-74.79044201,-165.65571540000002,-155.6365924,-0.055430939000000005,3228000,-1,0.0
BSESN,10/4/2011,15864.86035,16202.37988,15745.42969,16081.769530000001,19600,-286.58984300000003,286.58984300000003,0.0,32.77812369,15745.42969,17191.11914,8.261156208,-91.73884379,-203.69825659999998,-165.2489253,-0.07033574299999999,3208400,-1,0.0
BSESN,10/5/2011,15792.41016,16044.91016,15760.53027,15967.71973,18800,-72.45019599999999,72.45019599999999,0.0,31.39562999,15745.42969,17191.11914,3.2496929339999996,-96.75030707,-236.96182149999999,-179.59150449999999,-0.034761629,3189600,-1,-0.4588
BSESN,10/7/2011,16232.54004,16347.480469999999,16148.96973,16222.490230000001,16800,440.129883,0.0,440.129883,47.04996214,15745.42969,17191.11914,33.69398248,-66.30601752,-225.2125234,-188.71570830000002,0.004360859,3206400,1,0.2023
BSESN,10/10/2011,16557.23047,16595.92969,16230.769530000001,16270.07031,17200,324.69043,0.0,324.69043,55.66182518,15745.42969,17191.11914,56.15319247,-43.84680753,-187.5394774,-188.4804621,0.031532473,3223600,1,0.0
BSESN,10/11/2011,16536.4707,16774.11914,16510.71094,16668.15039,20000,-20.759766,20.759766,0.0,55.00187792,15745.42969,17191.11914,54.71721561,-45.28278439,-157.5424059,-182.29285090000002,0.000752928,3203600,-1,0.0
BSESN,10/12/2011,16958.39063,16987.06055,16608.57031,16660.42969,21200,421.919922,0.0,421.919922,64.79130366,15745.42969,16987.06055,97.6909464,-2.309053596,-98.58764208,-165.5518091,0.031154717999999998,3224800,1,0.0
BSESN,10/13/2011,16883.91992,17084.07031,16854.0293,17048.0,18000,-74.470703,74.470703,0.0,62.04242894,15745.42969,17084.07031,85.04823571,-14.95176429,-57.21518927,-143.8844851,0.011130005,3206800,-1,-0.7096
BSESN,10/14/2011,17082.68945,17112.44922,16828.44922,16836.83008,15400,198.769531,0.0,198.769531,66.42890713,15745.42969,17112.44922,97.82301823,-2.176981771,-8.292590557,-116.7661062,0.038224071,3222200,1,-0.7096
BSESN,10/17/2011,17025.08984,17188.55078,16928.38086,17176.05078,18400,-57.599608999999994,57.599608999999994,0.0,63.95759657,15745.42969,17188.55078,88.67309626,-11.32690374,25.53674265,-88.30553645,0.054090477000000005,3203800,-1,0.3818
BSESN,10/18/2011,16748.28906,16824.75977,16669.03906,16817.38086,14000,-276.80078100000003,276.80078100000003,0.0,53.02033984,15745.42969,17188.55078,69.49239256,-30.50760744,29.669215,-64.71058616,0.055684619000000005,3189800,-1,0.0
BSESN,10/19/2011,17085.33984,17106.99023,16874.33984,16883.35938,11400,337.05078100000003,0.0,337.05078100000003,62.12130096,15745.42969,17188.55078,92.84807509,-7.151924915,59.45603809,-39.87726131,0.081870321,3201200,1,-0.2263
BSESN,10/20/2011,16936.89063,16962.06055,16744.99023,16911.84961,12000,-148.449219,148.449219,0.0,56.553690700000004,15745.42969,17188.55078,82.56139715,-17.43860285,70.27362802,-17.84708345,0.043391274,3189200,-1,0.0
BSESN,10/21/2011,16785.64063,17032.32031,16752.21094,16975.78906,13800,-151.25,151.25,0.0,51.162941100000005,15745.42969,17188.55078,72.08064119,-27.91935881,65.88258163,-1.101150431,0.013795191000000002,3175400,-1,0.0
BSESN,10/24/2011,16939.2793,17104.88086,16898.59961,17011.06055,12600,153.63867199999999,0.0,153.63867199999999,56.07082542,15745.42969,17188.55078,82.7269184,-17.2730816,73.94758087,13.90859583,0.024358801,3188000,1,0.0
BSESN,10/25/2011,17254.85938,17322.13086,16900.25977,17012.78906,17600,315.58007799999996,0.0,315.58007799999996,64.52111702,15760.53027,17322.13086,95.69214532,-4.307854685,104.5980841,32.04649349,0.017482128,3205600,1,-0.7717
BSESN,10/28/2011,17804.80078,17908.13086,17671.85938,17671.85938,23800,549.9414059999999,0.0,549.9414059999999,74.41651235,16148.96973,17908.13086,94.12617320000001,-5.873826798,171.28998,59.89519079,0.054541887000000004,3229400,1,0.0
BSESN,10/31/2011,17705.00977,17813.10938,17668.26953,17806.21094,15800,-99.791015,99.791015,0.0,70.31062440000001,16230.769530000001,17908.13086,87.89043901,-12.10956099,213.62890589999998,90.64193382,0.036429879,3213600,-1,0.0
BSESN,11/1/2011,17480.83008,17661.7793,17422.4707,17540.55078,17600,-224.179688,224.179688,0.0,61.51314179,16510.71094,17908.13086,69.42216333,-30.57783667,226.48263169999998,117.81007340000002,0.026768742,3196000,-1,-0.2023
BSESN,11/2/2011,17464.84961,17615.91992,17337.65039,17347.69922,15400,-15.980469,15.980469,0.0,60.88652816,16608.57031,17908.13086,65.88991168,-34.11008832,232.69742069999998,140.7875429,0.042784104,3180600,-1,-0.4767
BSESN,11/3/2011,17481.92969,17527.09961,17278.0293,17430.68945,17000,17.080079,0.0,17.080079,61.37179952,16669.03906,17908.13086,65.60374523,-34.39625477,236.2772483,159.88548390000003,0.023212289,3197600,1,0.0
BSESN,11/4/2011,17562.60938,17702.25977,17474.39063,17674.69922,18400,80.679687,0.0,80.679687,63.8184277,16669.03906,17908.13086,72.11494055,-27.88505945,242.8253248,176.4734521,0.036944134,3216000,1,0.0
BSESN,11/8/2011,17569.5293,17632.23047,17455.2207,17593.66992,11000,6.919922,0.0,6.919922,64.04381117,16669.03906,17908.13086,72.67340781,-27.32659219,245.7403605,190.32683380000003,0.046699955999999994,3227000,1,0.4019
BSESN,11/9/2011,17362.09961,17658.33984,17331.23047,17641.98047,15000,-207.429688,207.429688,0.0,52.69131694,16669.03906,17908.13086,55.93294607,-44.06705393,228.67666290000003,197.9967996,0.024960938999999998,3212000,-1,0.0
BSESN,11/11/2011,17192.82031,17279.23047,17096.83984,17187.89063,18200,-169.279296,169.279296,0.0,45.15438059,16744.99023,17908.13086,38.50180016,-61.49819984,199.19790559999998,198.2370208,-0.003595455,3193800,-1,0.0
BSESN,11/14/2011,17118.74023,17391.99023,17094.42969,17348.51953,15000,-74.080079,74.080079,0.0,42.11269495,16744.99023,17908.13086,32.13283003,-67.86716997,167.9224296,192.1741026,-0.038532335,3178800,-1,-0.3612
BSESN,11/15/2011,16882.66992,17172.08984,16837.56055,17081.61914,18000,-236.070312,236.070312,0.0,33.75262614,16752.21094,17908.13086,11.28616106,-88.71383894,122.67338590000001,178.2739592,-0.046446732000000004,3160800,-1,-0.2732
BSESN,11/16/2011,16775.86914,16878.30078,16641.65039,16872.30078,19600,-106.800781,106.800781,0.0,30.583331800000003,16641.65039,17908.13086,10.59777497,-89.40222503,77.30414816,158.079997,-0.040327657999999995,3141200,-1,-0.7964
BSESN,11/17/2011,16461.71094,16807.15039,16408.5,16754.67969,17000,-314.15820299999996,314.15820299999996,0.0,23.19209818,16408.5,17908.13086,3.548269074,-96.45173093,15.816436900000001,129.627285,-0.057437579,3124200,-1,-0.4019
BSESN,11/18/2011,16371.509769999999,16396.68945,16164.990230000001,16387.69922,21600,-90.201172,90.201172,0.0,21.47286857,16164.990230000001,17908.13086,11.8475543,-88.1524457,-39.73347524,95.75513295,-0.063518155,3102600,-1,0.2023
BSESN,11/21/2011,15946.09961,16297.03027,15900.299809999999,16297.03027,21400,-425.410157,425.410157,0.0,15.30058918,15900.299809999999,17813.10938,2.394373424,-97.60562658,-116.73853600000001,53.25639916,-0.092042687,3081200,-1,0.0
BSESN,11/22/2011,16065.419919999998,16212.9502,15970.11035,15995.69043,19400,119.32031299999998,0.0,119.32031299999998,22.50932926,15900.299809999999,17702.25977,9.163362149,-90.83663785,-166.2213531,9.360848703,-0.085608974,3100600,1,-0.1027
BSESN,11/23/2011,15699.96973,15969.59961,15478.69043,15969.59961,17400,-365.450195,365.450195,0.0,17.30456204,15478.69043,17702.25977,9.951535732,-90.04846427,-232.2484037,-38.96100178,-0.09573323,3083200,-1,0.4215
BSESN,11/24/2011,15858.490230000001,15901.299809999999,15479.96973,15715.80957,18600,158.520507,0.0,158.520507,25.88217745,15478.69043,17702.25977,17.08063688,-82.91936312,-268.68678289999997,-84.90615799999999,-0.07760972599999999,3101800,1,0.0
BSESN,11/25/2011,15695.42969,15891.049809999999,15645.78027,15781.25,19200,-163.060546,163.060546,0.0,23.04507807,15478.69043,17702.25977,9.74735775,-90.25264225,-307.1810918,-129.36114479999998,-0.083143416,3082600,-1,-0.743
BSESN,11/28/2011,16167.12988,16186.67969,15888.28027,15890.799809999999,20200,471.700195,0.0,471.700195,43.65909496,15478.69043,17658.33984,31.58487088,-68.41512912,-296.2113059,-162.731177,-0.042383109,3102800,1,-0.5574
BSESN,11/29/2011,16008.33984,16210.37012,15952.54004,16210.37012,14800,-158.79003899999998,158.79003899999998,0.0,39.54458297,15478.69043,17658.33984,24.29975255,-75.70024745,-296.90812850000003,-189.56656730000003,-0.045751984,3088000,-1,0.0
BSESN,11/30/2011,16123.45996,16179.55957,15849.57031,15868.95996,16800,115.120117,0.0,115.120117,43.96231777,15478.69043,17391.99023,33.69934652,-66.30065348,-284.8871325,-208.6306803,-0.020547741,3104800,1,0.0
BSESN,12/1/2011,16483.44922,16718.10938,16430.60938,16555.92969,19800,359.989258,0.0,359.989258,55.65459856,15478.69043,17391.99023,52.51444582,-47.48555418,-243.5053045,-215.60560519999996,0.006837454000000001,3124600,1,0.0772
BSESN,12/2/2011,16846.83008,16888.83984,16428.66016,16493.98047,28600,363.380859,0.0,363.380859,64.32442601,15478.69043,17172.08984,80.79249566,-19.20750434,-179.32100830000002,-208.3486858,0.056485943,3153200,1,-0.4767
BSESN,12/5/2011,16805.33008,16863.09961,16691.21094,16812.30078,13400,-41.5,41.5,0.0,62.70885993,15478.69043,16888.83984,94.0779491,-5.922050896,-130.3011635,-192.7391813,0.046056072999999996,3139800,-1,0.0
BSESN,12/7/2011,16877.06055,17003.71094,16781.61914,16830.03906,14000,71.730469,0.0,71.730469,64.48767731,15478.69043,17003.71094,91.69516801,-8.30483199,-84.68830004,-171.1290051,0.074974082,3153800,1,0.0
BSESN,12/8/2011,16488.24023,16847.82031,16421.55078,16819.74023,16000,-388.820313,388.820313,0.0,49.66913508,15478.69043,17003.71094,66.19909691,-33.80090309,-79.00362228,-152.7039285,0.03971059,3137800,-1,0.0
BSESN,12/9/2011,16213.45996,16382.57031,16142.32031,16258.44043,18400,-274.780273,274.780273,0.0,41.83101881,15478.69043,17003.71094,48.18096066,-51.81903934,-95.56928259,-141.2769993,0.033005167,3119400,-1,-0.2263
BSESN,12/12/2011,15870.34961,16360.32031,15839.95996,16354.95996,21200,-343.110352,343.110352,0.0,34.08200526,15478.69043,17003.71094,25.68222374,-74.31777626,-134.829594,-139.98751830000003,-0.018357017,3098200,-1,0.1027
BSESN,12/13/2011,16002.509769999999,16079.37988,15771.58984,15778.62012,23600,132.160157,0.0,132.160157,39.0962619,15478.69043,17003.71094,34.34834701,-65.65165299,-153.50988710000001,-142.691992,-0.00036419,3121800,1,0.0
BSESN,12/14/2011,15881.13965,16133.41016,15855.12012,15963.75,19000,-121.37011799999999,121.37011799999999,0.0,36.17997673,15479.96973,17003.71094,26.32795636,-73.67204364,-176.0779907,-149.3691918,-0.015029052,3102800,-1,0.0
BSESN,12/15/2011,15836.46973,15908.019530000001,15596.21973,15739.049809999999,19800,-44.669921,44.669921,0.0,35.06908805,15596.21973,17003.71094,17.06937835,-82.93062165,-195.316379,-158.55862919999998,-0.039250249,3083000,-1,0.4019
BSESN,12/16/2011,15491.34961,16068.90039,15425.2002,15868.78027,20400,-345.120118,345.120118,0.0,27.53282521,15425.2002,17003.71094,4.190621717,-95.80937828,-235.6943123,-173.9857658,-0.080459081,3062600,-1,0.34
BSESN,12/19/2011,15379.33984,15440.09961,15190.740230000001,15440.09961,18000,-112.00976499999999,112.00976499999999,0.0,25.48213135,15190.740230000001,17003.71094,10.40279413,-89.59720587,-273.578722,-193.9043571,-0.08485345,3044600,-1,0.4019
BSESN,12/20/2011,15175.080080000002,15448.12988,15135.86035,15436.12012,20800,-204.25976599999998,204.25976599999998,0.0,22.02964203,15135.86035,17003.71094,2.099725015,-97.90027498,-316.4367598,-218.4108376,-0.100845788,3023800,-1,0.0
BSESN,12/21/2011,15685.20996,15727.30957,15377.04004,15487.75,22000,510.129883,0.0,510.129883,43.92353766,15135.86035,17003.71094,29.41078977,-70.58921023,-305.71475580000003,-235.8716212,-0.048703212999999995,3045800,1,-0.4019
BSESN,12/22/2011,15813.36035,15834.62988,15472.7002,15546.66016,18800,128.15039099999998,0.0,128.15039099999998,48.14417593,15135.86035,17003.71094,36.27163784,-63.72836216,-283.6075733,-245.41881170000002,-0.024677004,3064600,1,0.0
BSESN,12/23/2011,15738.7002,15911.230469999999,15671.28027,15863.42969,17000,-74.660157,74.660157,0.0,45.82559374,15135.86035,17003.71094,32.27452172,-67.72547828,-269.01093199999997,-250.1372357,-0.008295306,3047600,-1,0.2732
BSESN,12/26/2011,15970.75,15998.44043,15761.17969,15782.169919999998,11800,232.049805,0.0,232.049805,53.80411248,15135.86035,17003.71094,44.69788185,-55.30211815,-235.9980699,-247.3094026,-0.001984674,3059400,1,0.0
BSESN,12/27/2011,15873.9502,16049.12012,15799.62988,15983.980469999999,10800,-96.799805,96.799805,0.0,50.24254696,15135.86035,16847.82031,43.11373279,-56.88626721,-215.1657769,-240.88067740000002,-0.000452704,3048600,-1,0.0
BSESN,12/28/2011,15727.84961,15887.799809999999,15666.45996,15854.36035,11800,-146.10058600000002,146.10058600000002,0.0,45.04930087,15135.86035,16382.57031,47.48412025,-52.51587975,-208.04689580000002,-234.31392110000002,-0.006858859,3036800,-1,0.0
BSESN,12/29/2011,15543.92969,15724.59961,15515.44043,15658.94043,12800,-183.919921,183.919921,0.0,39.16858897,15135.86035,16360.32031,33.32647445,-66.67352555,-214.77019469999996,-230.4051758,0.003394157,3024000,-1,-0.7783
BSESN,12/30/2011,15454.919919999998,15694.049809999999,15406.92969,15583.549809999999,12800,-89.009766,89.009766,0.0,36.50737811,15135.86035,16133.41016,31.98432486,-68.01567514,-224.6907071,-229.2622821,0.00491439,3011200,-1,0.0
BSESN,1/2/2012,15517.919919999998,15542.84961,15358.019530000001,15534.669919999998,14200,63.0,0.0,63.0,39.845194799999994,15135.86035,16133.41016,38.29979901,-61.70020099,-224.8769694,-228.38521949999998,0.022592292000000003,3025400,1,-0.9217
BSESN,1/3/2012,15939.36035,15970.30957,15640.55957,15640.55957,16200,421.44043,0.0,421.44043,57.20872425,15135.86035,16068.90039,86.11634725,-13.88365275,-188.84102140000002,-220.4763799,0.016203187,3041600,1,0.0
BSESN,1/4/2012,15882.63965,16004.69043,15822.32031,15967.490230000001,17800,-56.720704000000005,56.720704000000005,0.0,54.75435623,15135.86035,16068.90039,80.03721864,-19.96278136,-162.9804228,-208.9771885,0.0043810609999999995,3023800,-1,0.4019
BSESN,1/5/2012,15857.080080000002,15980.169919999998,15809.30957,15893.07031,21200,-25.55957,25.55957,0.0,53.55961271,15135.86035,16049.12012,78.97202457,-21.02797543,-142.9008834,-195.76192749999998,0.0075215790000000005,3002600,-1,-0.5719
BSESN,1/6/2012,15867.730469999999,16001.30957,15664.91016,15789.080080000002,17200,10.650391,0.0,10.650391,54.04175954,15135.86035,16049.12012,80.13821971,-19.86178029,-124.6909466,-181.5477313,-0.006450513000000001,3019800,1,-0.3818
BSESN,1/9/2012,15814.71973,15871.509769999999,15678.299809999999,15840.21973,11200,-53.01074200000001,53.01074200000001,0.0,51.00082598,15358.019530000001,16049.12012,66.08302832,-33.91697168,-113.23169979999999,-167.884525,-0.0037313000000000003,3008600,-1,-0.4019
BSESN,1/10/2012,16165.08984,16180.96973,15898.32031,15898.32031,19600,350.370117,0.0,350.370117,65.71397587,15358.019530000001,16180.96973,98.07037132,-1.9296286790000001,-75.01351474,-149.31032290000002,0.027800382000000002,3028200,1,0.0
BSESN,1/11/2012,16175.86035,16244.7002,16127.769530000001,16222.37012,18600,10.770508,0.0,10.770508,66.07529422,15358.019530000001,16244.7002,92.23623049,-7.763769505,-43.35645158,-128.1195487,0.040654498,3046800,1,-0.4588
BSESN,1/12/2012,16037.509769999999,16178.580080000002,15962.58984,16117.19043,14400,-138.35058600000002,138.35058600000002,0.0,57.14894561,15358.019530000001,16244.7002,76.63302727,-23.36697273,-29.09633258,-108.3149054,0.037696077,3032400,-1,-0.5106
BSESN,1/13/2012,16154.62012,16257.33984,16049.78027,16144.57031,19600,117.110351,0.0,117.110351,62.14391288,15358.019530000001,16257.33984,88.57807107,-11.42192893,-8.250156278,-88.30195561,0.041029996,3052000,1,0.0
BSESN,1/16/2012,16189.36035,16214.36035,16037.59961,16086.740230000001,13400,34.740235,0.0,34.740235,63.59636319,15358.019530000001,16257.33984,92.44101451,-7.558985494,10.94763771,-68.45203695,0.015684444,3065400,1,-0.4404
BSESN,1/17/2012,16466.05078,16501.38086,16270.87012,16270.87012,18800,276.690429,0.0,276.690429,73.08605669,15358.019530000001,16501.38086,96.90998137,-3.0900186260000004,47.93605596,-45.17441837,0.03673263,3084200,1,0.4019
BSESN,1/18/2012,16451.4707,16517.96094,16384.48047,16502.41992,16200,-14.580078,14.580078,0.0,71.94573836,15358.019530000001,16517.96094,94.26779365,-5.732206351,75.20622294,-21.09829011,0.037484242,3068000,-1,0.1027
BSESN,1/19/2012,16643.74023,16662.06055,16572.09961,16573.86914,16800,192.269531,0.0,192.269531,77.32815151,15358.019530000001,16662.06055,98.59511221,-1.404887789,111.05242779999999,5.33185347,0.0489049,3084800,1,-0.6486
BSESN,1/20/2012,16739.00977,16788.48047,16611.71094,16745.00977,18000,95.269532,0.0,95.269532,79.56921757,15640.55957,16788.48047,95.69040837,-4.309591632,145.4713552,33.35975381,0.058444921,3102800,1,-0.6908
BSESN,1/23/2012,16751.73047,16784.0,16659.32031,16667.01953,15000,12.720703,0.0,12.720703,79.8756916,15664.91016,16788.48047,96.72917666,-3.270823337,171.794715,61.04674605,0.036290589,3117800,1,-0.0516
BSESN,1/24/2012,16995.76953,17050.32031,16770.00977,16806.7207,18200,244.039062,0.0,244.039062,84.89223907,15664.91016,17050.32031,96.06248144,-3.937518555,209.92815890000003,90.82302862,0.050687207000000005,3136000,1,0.1779
BSESN,1/25/2012,17077.17969,17130.24023,17016.68945,17068.84961,14000,81.410157,0.0,81.410157,86.21493476,15664.91016,17130.24023,96.37893559,-3.6210644139999997,243.90670269999998,121.4397634,0.064827391,3150000,1,0.0772
BSESN,1/27/2012,17233.98047,17258.9707,17106.57031,17201.33008,17200,156.800781,0.0,156.800781,88.46023462,15678.299809999999,17258.9707,98.41901094,-1.5809890619999998,280.25682969999997,153.2031767,0.066814344,3167200,1,-0.5574
BSESN,1/30/2012,16863.30078,17138.03906,16828.33008,17138.03906,14400,-370.679688,370.679688,0.0,61.24835993,15898.32031,17258.9707,70.92053,-29.07947,275.9725742,177.7570562,0.041628601,3152800,-1,-0.8909999999999999
BSESN,1/31/2012,17193.55078,17238.99023,16965.58008,16965.58008,18600,330.25,0.0,330.25,70.55859834,15962.58984,17258.9707,94.9536495,-5.046350503,295.8157066,201.3687863,0.04418181400000001,3171400,1,0.0
BSESN,2/1/2012,17300.58008,17327.21094,17061.55078,17179.64063,47400,107.029297,0.0,107.029297,72.98561907,15962.58984,17327.21094,98.04847953,-1.951520471,316.5291507,224.40085919999999,0.051612977000000004,3218800,1,0.0
BSESN,2/2/2012,17431.84961,17504.25,17308.2793,17438.07031,27000,131.269531,0.0,131.269531,75.80788546,16037.59961,17504.25,95.06355492,-4.936445075,339.6221063,247.44510860000003,0.047351699000000004,3245800,1,0.0
BSESN,2/3/2012,17604.96094,17630.5293,17382.69922,17444.25,16600,173.111329,0.0,173.111329,79.12617636,16037.59961,17630.5293,98.39488465,-1.605115354,367.65399110000004,271.48688510000005,0.051732521,3262400,1,0.5574
BSESN,2/6/2012,17707.31055,17829.7207,17595.09961,17741.91016,17600,102.349609,0.0,102.349609,80.91226733,16270.87012,17829.7207,92.14740931,-7.8525906910000005,393.5911461,295.9077373,0.057043664,3280000,1,0.0
BSESN,2/7/2012,17622.44922,17832.03906,17582.49023,17813.74023,16800,-84.861328,84.861328,0.0,74.78994329999999,16384.48047,17832.03906,85.52114955,-14.47885045,402.65734510000004,317.25765889999997,0.036872687,3263200,-1,-0.6249
BSESN,2/8/2012,17707.32031,17809.21094,17579.58984,17631.68945,20800,84.871094,0.0,84.871094,76.81444146,16572.09961,17832.03906,90.10121085,-9.898789152,411.9421485,336.1945568,0.036899572,3284000,1,0.0
BSESN,2/9/2012,17830.75,17879.46094,17609.42969,17647.80078,21400,123.42968700000002,0.0,123.42968700000002,79.56782045,16611.71094,17879.46094,96.15768582,-3.8423141789999997,424.3683125,353.8293079,0.034627492999999995,3305400,1,0.0
BSESN,2/10/2012,17748.68945,17890.10938,17627.14063,17817.58984,19600,-82.060547,82.060547,0.0,72.92450874,16659.32031,17890.10938,88.50981648,-11.49018352,422.7216645,367.6077793,0.052503877000000004,3285800,-1,0.431
BSESN,2/13/2012,17772.83984,17849.64063,17665.89063,17761.69922,16800,24.150391,0.0,24.150391,73.67099076,16770.00977,17890.10938,89.53043729,-10.46956271,418.54074160000005,377.7943717,0.03369223,3302600,1,0.0
BSESN,2/14/2012,17848.57031,17890.33008,17742.58008,17767.46094,17400,75.730469,0.0,75.730469,76.05921838,16828.33008,17890.33008,96.06781874,-3.932181262,416.53657180000005,385.5428117,0.031674674,3320000,1,-0.6124
BSESN,2/15/2012,18202.41016,18231.34961,18000.30078,18000.30078,25600,353.83984300000003,0.0,353.83984300000003,83.92176905,16828.33008,18231.34961,97.93734496,-2.062655035,438.44603789999996,396.123457,0.044204176,3345600,1,0.0
BSESN,2/16/2012,18153.99023,18182.7793,18043.32031,18163.05078,20000,-48.419922,48.419922,0.0,79.78454389,16828.33008,18231.34961,94.48622252,-5.513777483999999,446.7524801,406.2492616,0.031186056,3325600,-1,0.0
BSESN,2/17/2012,18289.34961,18423.06055,18234.56055,18331.19922,27800,135.359375,0.0,135.359375,82.55811942,16965.58008,18423.06055,90.82588475,-9.174115252,458.9670789,416.7928251,0.032869987,3353400,1,-0.8779
BSESN,2/21/2012,18428.60938,18470.85938,18293.80078,18303.73047,20600,139.25976599999998,0.0,139.25976599999998,85.00100846,17061.55078,18470.85938,97.00207604,-2.997923959,474.4155683999999,428.31737369999996,0.045746204000000006,3374000,1,0.0
BSESN,2/22/2012,18145.25,18523.7793,18095.81055,18490.86914,21600,-283.359375,283.359375,0.0,63.96684683,17308.2793,18523.7793,68.85814093,-31.14185907,458.5084739,434.3555938,0.024731562000000002,3352400,-1,0.1779
BSESN,2/23/2012,18078.5,18249.5293,18005.2793,18127.34961,19600,-66.75,66.75,0.0,59.93552879999999,17382.69922,18523.7793,60.97738401,-39.02261599,435.4956965,434.5836143,0.013894536,3332800,-1,-0.6705
BSESN,2/24/2012,17923.57031,18198.15039,17848.92969,18079.00977,19600,-154.929687,154.929687,0.0,51.2803784,17579.58984,18523.7793,36.43129754,-63.56870246,400.14376539999995,427.6956445,0.00985317,3313200,-1,0.0
BSESN,2/27/2012,17445.75,17975.18945,17381.64063,17975.18945,20800,-477.820313,477.820313,0.0,33.87330603,17381.64063,18523.7793,5.613099055,-94.38690095,329.7696204,408.1104397,-0.018403916,3292400,-1,0.0
BSESN,2/28/2012,17731.11914,17776.82031,17530.43945,17545.10938,16000,285.369141,0.0,285.369141,46.40919415,17381.64063,18523.7793,30.59860633,-69.40139367,293.6396136,385.2162745,-0.006580425,3308400,1,0.4019
BSESN,2/29/2012,17752.67969,18001.34961,17677.9707,17919.92969,18400,21.560547,0.0,21.560547,47.28045979,17381.64063,18523.7793,32.48634094,-67.51365906,263.7062375,360.9142671,-0.024707193,3326800,1,-0.2263
BSESN,3/1/2012,17583.9707,17717.5293,17463.26953,17714.61914,18800,-168.708985,168.708985,0.0,41.22864409,17381.64063,18523.7793,17.71501858,-82.28498142,223.7906963,333.4895529,-0.031399132,3308000,-1,-0.6124
BSESN,3/2/2012,17636.80078,17731.88086,17504.38086,17661.39063,17000,52.830078,0.0,52.830078,43.82656503,17381.64063,18523.7793,22.34055831,-77.65944169,194.1818802,305.6280184,-0.035679171,3325000,1,0.0
BSESN,3/5/2012,17362.86914,17598.41992,17312.30078,17598.41992,12000,-273.93164,273.93164,0.0,34.66015011,17312.30078,18523.7793,4.174102911,-95.82589709,146.9190943,273.8862336,-0.057830745999999995,3313000,-1,0.0
BSESN,3/6/2012,17173.28906,17691.96094,17128.2793,17336.64063,18600,-189.58007800000001,189.58007800000001,0.0,29.69978357,17128.2793,18523.7793,3.225350484,-96.77464952,93.09235735,237.72745830000002,-0.053565585,3294400,-1,0.4767
BSESN,3/7/2012,17145.51953,17239.34961,17008.76953,17127.17969,20400,-27.769532,27.769532,0.0,28.99835972,17008.76953,18523.7793,9.026344455,-90.97365555,47.64429752,199.71082619999999,-0.051607184,3274000,-1,0.4767
BSESN,3/9/2012,17503.24023,17531.61914,17325.82031,17325.82031,12800,357.72070299999996,0.0,357.72070299999996,47.44649126,17008.76953,18523.7793,32.63811984,-67.36188016,40.03001274,167.7746635,-0.023451247,3286800,1,-0.7717
BSESN,3/12/2012,17587.66992,17772.09961,17494.65039,17772.09961,12200,84.429688,0.0,84.429688,50.91939636,17008.76953,18523.7793,38.21100061,-61.78899939,40.34335433,142.2884017,0.008134928,3299000,1,0.0
BSESN,3/13/2012,17813.61914,17842.91992,17680.23047,17680.23047,12800,225.949219,0.0,225.949219,59.23736082,17008.76953,18523.7793,53.12504434,-46.87495566,58.15353567,125.4614285,0.004652837,3311800,1,0.0
BSESN,3/14/2012,17919.30078,18040.68945,17837.2207,18003.15039,14200,105.68163999999999,0.0,105.68163999999999,62.65319821,17008.76953,18249.5293,73.38497548,-26.61502452,79.87510732,116.3441642,0.009385687,3326000,1,-0.29600000000000004
BSESN,3/15/2012,17675.84961,17918.25,17622.13086,17916.84961,13800,-243.451172,243.451172,0.0,51.24006691,17008.76953,18198.15039,56.08633033,-43.91366967,76.56256873,108.38784509999999,0.005225151,3312200,-1,-0.25
BSESN,3/16/2012,17466.19922,17871.0,17426.58008,17656.81055,24800,-209.65039,209.65039,0.0,43.38679169,17008.76953,18040.68945,44.3280218,-55.6719782,56.37051943,97.98437999,-0.009673045,3287400,-1,0.0
BSESN,3/19/2012,17273.36914,17561.46094,17226.42969,17531.4707,13800,-192.83007800000001,192.83007800000001,0.0,37.31698709,17008.76953,18040.68945,25.64148674,-74.35851326,24.52568234,83.29264046,-0.005154678,3273600,-1,0.0
BSESN,3/20/2012,17316.17969,17410.13086,17211.73047,17308.89063,14200,42.810547,0.0,42.810547,39.48568568,17008.76953,18040.68945,29.79011747,-70.20988253,2.711615057,67.17643538,0.008320516,3287800,1,0.3716
BSESN,3/21/2012,17601.71094,17622.86914,17275.88086,17301.16016,14200,285.53125,0.0,285.53125,52.21006369,17008.76953,18040.68945,57.4600213,-42.5399787,8.367341663,55.41461664,0.026607033,3302000,1,0.0
BSESN,3/22/2012,17196.4707,17687.00977,17136.5,17586.06055,17600,-405.240235,405.240235,0.0,38.8369994,17008.76953,18040.68945,18.18950948,-81.81049052,-19.62374418,40.40694447,-0.017526442,3284400,-1,-0.1615
BSESN,3/23/2012,17361.74023,17458.34961,17179.33008,17257.7207,12600,165.269531,0.0,165.269531,45.41613904,17008.76953,18040.68945,34.20524165,-65.79475835,-28.14655547,26.69624449,-0.012845913999999998,3297000,1,0.0
BSESN,3/26/2012,17052.7793,17377.58984,17021.84961,17377.58984,17000,-308.960937,308.960937,0.0,36.86293364,17008.76953,18040.68945,4.26484314,-95.73515686,-59.14966976,9.527061636000001,-0.042711132,3280000,-1,-0.4767
BSESN,3/27/2012,17257.35938,17366.83984,17061.16016,17209.13086,19000,204.58007800000001,0.0,204.58007800000001,44.80488154,17008.76953,18040.68945,24.09003244,-75.90996756,-66.44601041,-5.667552773,-0.036940136,3299000,1,0.2982
BSESN,3/28/2012,17121.61914,17245.82031,17040.11914,17234.48047,13200,-135.74023400000002,135.74023400000002,0.0,40.86910095,17021.84961,18040.68945,9.792464693,-90.20753531,-82.23357790000001,-20.9807578,-0.031355238,3285800,-1,0.2755
BSESN,3/29/2012,17058.60938,17109.34961,16920.60938,17039.84961,11200,-63.009766000000006,63.009766000000006,0.0,39.03264423,16920.60938,18040.68945,12.32054767,-87.67945233,-98.69204,-36.52301424,-0.023335921000000003,3274600,-1,-0.6428
BSESN,3/30/2012,17404.19922,17439.50977,17105.2207,17117.41016,25000,345.58984399999997,0.0,345.58984399999997,52.53138328,16920.60938,18040.68945,43.17457774,-56.82542226,-82.89373027,-45.79715745,0.007574091,3299600,1,0.4939
BSESN,4/2/2012,17478.15039,17529.98047,17382.38086,17429.96094,10000,73.951172,0.0,73.951172,54.99185809,16920.60938,18040.68945,49.776888899999996,-50.223111100000004,-63.67224049,-49.37217405,0.00935372,3309600,1,0.0
BSESN,4/3/2012,17597.41992,17664.09961,17478.15039,17576.21094,10800,119.269531,0.0,119.269531,58.95138429,16920.60938,17918.25,67.84111734,-32.15888266,-38.37268061,-47.17227537,-0.000243784,3320400,1,0.0
BSESN,4/4/2012,17486.01953,17597.41992,17436.59961,17553.25977,9800,-111.40039099999998,111.40039099999998,0.0,53.84619052,16920.60938,17871.0,59.49239619,-40.50760381,-27.00043348,-43.13790699,0.016837689,3310600,-1,0.0
BSESN,4/9/2012,17222.14063,17486.01953,17199.63086,17407.66016,9800,-263.87890600000003,263.87890600000003,0.0,43.54049224,16920.60938,17687.00977,39.34382779,-60.65617221,-38.83302514,-42.27693062,-0.008040646,3300800,-1,-0.0772
BSESN,4/10/2012,17243.83984,17274.68945,17135.75977,17259.25977,10000,21.699219,0.0,21.699219,44.54749565,16920.60938,17687.00977,42.17514406,-57.82485594,-45.93004074,-43.00755264,0.011204071000000001,3310800,1,-0.8807
BSESN,4/11/2012,17199.40039,17319.15039,17075.89063,17125.96094,11800,-44.439453,44.439453,0.0,42.74588606,16920.60938,17687.00977,36.37667977,-63.62332023,-54.51198891,-45.308439899999996,-0.003358508,3299000,-1,-0.5267
BSESN,4/12/2012,17332.61914,17395.15039,17199.40039,17276.86914,10200,133.21875,0.0,133.21875,49.77217945,16920.60938,17687.00977,53.75907565,-46.24092435,-49.98738149,-46.24422821,0.012323601000000002,3309200,1,0.0
BSESN,4/13/2012,17094.50977,17398.2207,17027.30078,17232.56055,18400,-238.109375,238.109375,0.0,39.7194895,16920.60938,17664.09961,23.3897344,-76.61026559999999,-64.86728442,-49.96883946,0.002104532,3290800,-1,0.4019
BSESN,4/16/2012,17150.94922,17173.06055,17010.16016,17047.86914,9800,56.439453,0.0,56.439453,42.87504421,16920.60938,17664.09961,30.980883600000002,-69.01911640000002,-71.28380718,-54.231832999999995,-0.014551086000000001,3300600,1,0.0
BSESN,4/17/2012,17357.93945,17381.91992,17103.35938,17200.9707,12400,206.99023400000002,0.0,206.99023400000002,53.23454687,16920.60938,17664.09961,58.82122696,-41.17877304,-58.98660483,-55.18278737,-0.0068777840000000005,3313000,1,-0.5106
BSESN,4/18/2012,17392.39063,17522.80078,17357.93945,17447.25977,9800,34.451172,0.0,34.451172,54.808430099999995,16920.60938,17664.09961,63.45493571,-36.54506429,-45.93159093,-53.33254808,-0.011651100000000001,3322800,1,0.0
BSESN,4/19/2012,17503.71094,17530.30078,17361.71094,17432.89063,11800,111.32031299999998,0.0,111.32031299999998,59.84675671,16920.60938,17664.09961,78.42760218,-21.57239782,-26.29961386,-47.92596123,0.001011746,3334600,1,0.0
BSESN,4/20/2012,17373.83984,17519.88086,17231.33984,17459.7207,11200,-129.871094,129.871094,0.0,52.03716227,17010.16016,17664.09961,55.61366367,-44.38633633,-20.97881181,-42.53653135,0.008808383000000001,3323400,-1,0.0
BSESN,4/23/2012,17096.67969,17444.17969,17056.76953,17347.75977,13000,-277.16015600000003,277.16015600000003,0.0,39.38235028,17010.16016,17664.09961,13.23051111,-86.76948889,-38.68065956,-41.76535699,-0.008534070999999999,3310400,-1,0.6369
BSESN,4/24/2012,17207.28906,17247.5293,17046.7207,17154.75,12400,110.609375,0.0,110.609375,45.48687958,17010.16016,17664.09961,30.1448255,-69.8551745,-43.28528347,-42.06934229,0.00045866,3322800,1,0.0772
BSESN,4/25/2012,17151.28906,17249.60938,17019.24023,17225.53906,11400,-56.0,56.0,0.0,42.95957788,17010.16016,17597.41992,24.03176842,-75.96823158,-50.86685167,-43.82884416,-0.010461782,3311400,-1,0.0
BSESN,4/26/2012,17130.66992,17193.25,17084.05078,17191.01953,10800,-20.619141,20.619141,0.0,41.96890777,17010.16016,17530.30078,23.16868943,-76.83131057,-57.87197929999999,-46.63747119,0.0021153079999999998,3300600,-1,0.0
BSESN,4/27/2012,17134.25,17242.15039,17022.08984,17145.39063,11000,3.580078,0.0,3.580078,42.23577658,17010.16016,17530.30078,23.85697983,-76.14302017,-62.41522716,-49.79302239,-0.0009736619999999999,3311600,1,0.3612
BSESN,4/30/2012,17318.81055,17359.17969,17187.33984,17195.50977,8400,184.56054699999999,0.0,184.56054699999999,54.64302426,17010.16016,17530.30078,59.339797,-40.660203,-50.54068851,-49.94255561,-0.002254237,3320000,1,0.4215
BSESN,5/2/2012,17301.91016,17432.33008,17265.48047,17370.92969,9400,-16.900391,16.900391,0.0,53.43044238,17010.16016,17530.30078,56.0906005,-43.9093995,-42.00949212,-48.35594291,-0.005202302,3310600,-1,-0.5574
BSESN,5/3/2012,17151.18945,17301.91016,17120.85938,17271.76953,8600,-150.72070300000001,150.72070300000001,0.0,43.49774593,17010.16016,17530.30078,27.11368623,-72.88631377,-46.87006964,-48.05876826,-0.020139814,3302000,-1,0.2023
BSESN,5/4/2012,16831.08008,17151.18945,16776.7207,17066.83984,11000,-320.109375,320.109375,0.0,29.88372286,16776.7207,17530.30078,7.213483555,-92.78651645,-75.67987317,-53.58298924,-0.031240057999999998,3291000,-1,0.0
BSESN,5/7/2012,16912.71094,16944.13086,16513.76953,16620.43945,11400,81.63086,0.0,81.63086,35.79638542,16513.76953,17530.30078,39.24536575,-60.75463425,-90.87734438,-61.04186027,-0.010760496000000001,3302400,1,0.0
BSESN,5/8/2012,16546.17969,16918.31055,16502.91016,16915.71094,12800,-366.53125,366.53125,0.0,24.9124627,16502.91016,17530.30078,4.211594981,-95.78840502,-130.9875159,-75.0309914,-0.03842031,3289600,-1,-0.2144
BSESN,5/9/2012,16479.58008,16615.74023,16422.92969,16436.41016,12400,-66.59961,66.59961,0.0,23.41955325,16422.92969,17530.30078,5.115754814,-94.88424519,-166.23291819999997,-93.27137675,-0.039163761,3277200,-1,0.0
BSESN,5/10/2012,16420.05078,16671.81055,16377.019530000001,16515.61914,10800,-59.529297,59.529297,0.0,22.05635943,16377.019530000001,17519.88086,3.765220587,-96.23477941,-196.7012209,-113.9573456,-0.041482274,3266400,-1,-0.5719
BSESN,5/11/2012,16292.980469999999,16447.24023,16233.759769999999,16355.58984,11200,-127.07031200000002,127.07031200000002,0.0,19.29075826,16233.759769999999,17444.17969,4.892575041000001,-95.10742496,-228.467452,-136.8593669,-0.049098708,3255200,-1,0.6486
BSESN,5/14/2012,16215.83984,16390.33008,16124.82031,16318.36035,11000,-77.140625,77.140625,0.0,17.73324782,16124.82031,17432.33008,6.9612888129999995,-93.03871119,-256.9055751,-160.8686085,-0.063686285,3244200,-1,-0.5574
BSESN,5/15/2012,16328.25,16370.12012,16123.04004,16146.90039,11400,112.410156,0.0,112.410156,27.56638569,16123.04004,17432.33008,15.67337678,-84.32662322,-267.2912652,-182.1531398,-0.05627472,3255600,1,-0.5859
BSESN,5/16/2012,16030.08984,16328.25,15974.59961,16132.67969,12800,-298.16015600000003,298.16015600000003,0.0,20.18312566,15974.59961,17432.33008,3.8066183139999996,-96.19338169,-296.16700330000003,-204.9559125,-0.065365706,3242800,-1,0.0772
BSESN,5/17/2012,16070.480469999999,16240.17969,16007.919919999998,16119.080080000002,12800,40.390625,0.0,40.390625,23.39035956,15974.59961,17432.33008,6.577406595,-93.42259341,-312.19327810000004,-226.4033856,-0.045190184,3255600,1,0.5267
BSESN,5/18/2012,16152.75,16206.34961,15809.70996,15868.07031,14000,82.269531,0.0,82.269531,30.00086886,15809.70996,17432.33008,21.14111833,-78.85888167,-314.6289066,-244.0484898,-0.044934307,3269600,1,0.0
BSESN,5/21/2012,16183.259769999999,16298.38965,16149.61035,16187.66016,10400,30.509766,0.0,30.509766,32.49342712,15809.70996,17432.33008,23.02139614,-76.97860386,-310.5178204,-257.3423559,-0.021933759,3280000,1,0.0
BSESN,5/22/2012,16026.41016,16366.71973,16000.83984,16344.33984,11600,-156.84961,156.84961,0.0,26.82691442,15809.70996,17301.91016,14.52219318,-85.47780682,-316.2704389,-269.1279725,-0.027498876000000002,3268400,-1,0.0
BSESN,5/23/2012,15948.09961,16026.41016,15847.03027,15995.13965,11400,-78.310547,78.310547,0.0,24.37784867,15809.70996,17151.18945,10.31619558,-89.68380442,-323.4202499,-279.986428,-0.02874237,3257000,-1,0.0
BSESN,5/24/2012,16222.299809999999,16252.37012,15934.769530000001,16033.90039,11000,274.200196,0.0,274.200196,44.754130700000005,15809.70996,16944.13086,36.37008492,-63.62991508,-303.4627329,-284.681689,-0.004338105,3268000,1,-0.0516
BSESN,5/25/2012,16217.82031,16273.480469999999,16118.34961,16213.240230000001,9400,-4.479492,4.479492,0.0,44.52796970000001,15809.70996,16918.31055,36.81310989,-63.18689011,-284.7255753,-284.6904663,0.000122132,3258600,-1,0.3182
BSESN,5/28/2012,16416.83984,16439.9707,16217.82031,16289.82031,8000,199.019531,0.0,199.019531,55.94169088,15809.70996,16671.81055,70.42448327,-29.57551673,-250.92452819999997,-277.9372786,0.005425556999999999,3266600,1,0.0
BSESN,5/29/2012,16438.58008,16544.38086,16410.21094,16500.03906,8600,21.740234,0.0,21.740234,57.05541601,15809.70996,16671.81055,72.94625792,-27.05374208,-219.8484239,-266.31950770000003,0.025482716000000002,3275200,1,0.0
BSESN,5/30/2012,16312.15039,16438.58008,16295.30957,16391.90039,13800,-126.42968700000002,126.42968700000002,0.0,48.78106032,15809.70996,16544.38086,68.38986427,-31.61013573,-203.08121269999998,-253.67184869999997,0.015038127,3261400,-1,0.0
BSESN,5/31/2012,16218.53027,16312.15039,16086.05957,16224.86035,16000,-93.620118,93.620118,0.0,43.40300642,15809.70996,16544.38086,55.64672741,-44.35327259,-195.0984644,-241.95717180000003,0.004072388,3245400,-1,-0.3182
BSESN,6/1/2012,15965.16016,16226.19043,15933.480469999999,16217.480469999999,12200,-253.370117,253.370117,0.0,32.28724878,15809.70996,16544.38086,21.15916057,-78.84083943,-206.83269140000002,-234.93227579999999,-0.013476865,3233200,-1,-0.4404
BSESN,6/4/2012,15988.40039,16012.83984,15748.980469999999,15808.87988,12200,23.240235000000002,0.0,23.240235000000002,34.07417996,15748.980469999999,16544.38086,30.10055376,-69.89944624,-211.8151844,-230.30885750000002,-0.002371696,3245400,1,0.0
BSESN,6/5/2012,16020.63965,16138.29004,15979.769530000001,16065.37012,10800,32.239257,0.0,32.239257,36.74606241,15748.980469999999,16544.38086,34.15376487,-65.84623513,-210.73320619999998,-226.3937272,0.004548507,3256200,1,0.0
BSESN,6/6/2012,16454.30078,16494.5,16100.36035,16100.36035,13600,433.661133,0.0,433.661133,61.17092866,15748.980469999999,16544.38086,88.67487631,-11.32512369,-172.889934,-215.69296859999997,0.014301362,3269800,1,0.4767
BSESN,6/7/2012,16649.05078,16680.58984,16519.89063,16578.00977,11400,194.75,0.0,194.75,67.64479412,15748.980469999999,16680.58984,96.61456144,-3.385438559,-125.7347784,-197.70133059999998,0.026589915,3281200,1,0.0
BSESN,6/8/2012,16718.86914,16767.76953,16485.01953,16611.51953,11800,69.81836,0.0,69.81836,69.73229308,15748.980469999999,16767.76953,95.20014576,-4.799854241,-81.78742525,-174.5185495,0.01839753,3293000,1,0.2023
BSESN,6/11/2012,16668.00977,16893.81055,16627.48047,16804.89063,8800,-50.859375,50.859375,0.0,66.14530129,15748.980469999999,16893.81055,80.27648073,-19.72351927,-50.48084597,-149.71100880000003,0.013956783,3284200,-1,0.0
BSESN,6/12/2012,16862.80078,16897.41992,16553.4707,16570.50977,9800,194.791015,0.0,194.791015,72.41580652,15748.980469999999,16897.41992,96.98554931,-3.014450689,-9.838734548,-121.7365539,0.033757069,3294000,1,-0.2023
BSESN,6/13/2012,16880.50977,16944.10938,16792.86914,16865.7207,9800,17.708985000000002,0.0,17.708985000000002,72.9415325,15748.980469999999,16944.10938,94.67843103,-5.321568968999999,23.52818043,-92.68360707,0.040816244,3303800,1,0.0
BSESN,6/14/2012,16677.88086,16921.49023,16658.98047,16857.23047,9200,-202.628907,202.628907,0.0,58.27743848,15748.980469999999,16944.10938,77.72386605,-22.27613395,33.23809354,-67.49926695,0.044642252,3294600,-1,0.0258
BSESN,6/15/2012,16949.83008,16967.75977,16701.2793,16701.2793,10400,271.94921899999997,0.0,271.94921899999997,68.18290959,15748.980469999999,16967.75977,98.52888148,-1.471118524,62.16074842,-41.56726387,0.06013295,3305000,1,0.0
BSESN,6/18/2012,16705.83008,17109.94922,16636.08984,17039.53906,11400,-244.0,244.0,0.0,54.73091216,15748.980469999999,17109.94922,70.30650843,-29.69349157,64.64817605,-20.32417589,0.042769231,3293600,-1,0.0
BSESN,6/19/2012,16859.80078,16890.0,16681.89063,16681.89063,9800,153.97070300000001,0.0,153.97070300000001,60.41702932,15748.980469999999,17109.94922,81.619825,-18.380175,78.14284722,-0.6307712670000001,0.024644013,3303400,1,-0.4215
BSESN,6/20/2012,16896.63086,16962.49023,16840.09961,16903.96094,9200,36.830078,0.0,36.830078,61.74330545,15748.980469999999,17109.94922,84.32599132,-15.67400868,90.76309042,17.64800107,0.014870521999999999,3312600,1,0.4019
BSESN,6/21/2012,17032.56055,17050.43945,16799.63086,16855.59961,10800,135.929688,0.0,135.929688,66.52041524,15748.980469999999,17109.94922,94.31370691,-5.6862930910000005,110.45980209999999,36.21036127,0.018762716999999998,3323400,1,0.128
BSESN,6/22/2012,16972.50977,17016.06055,16807.80078,16882.74023,11800,-60.05078100000001,60.05078100000001,0.0,62.53965943,15979.769530000001,17109.94922,87.83915032,-12.16084968,119.84252179999999,52.93679337,0.018268528,3311600,-1,-0.5719
BSESN,6/25/2012,16882.16016,17131.15039,16853.05078,17038.76953,10600,-90.34961,90.34961,0.0,56.65398079,16100.36035,17131.15039,75.84471856,-24.15528144,118.6205524,66.07354518,0.0011480519999999999,3301000,-1,0.0
BSESN,6/26/2012,16906.58008,16946.66016,16815.86914,16873.08984,7400,24.419922,0.0,24.419922,57.88990863,16485.01953,17131.15039,65.24383420000001,-34.7561658,118.2593958,76.51071531,0.001544403,3308400,1,0.0
BSESN,6/27/2012,16967.75977,17029.26953,16930.80078,16975.75977,6800,61.179688,0.0,61.179688,61.09649893,16485.01953,17131.15039,74.71245608,-25.28754392,121.50918390000001,85.51040903,0.01738104,3315200,1,0.0
BSESN,6/28/2012,16990.75977,17033.84961,16918.86914,16985.58008,8800,23.0,0.0,23.0,62.34044336,16553.4707,17131.15039,75.69749674,-24.30250326,124.505352,93.30939762,0.002414755,3324000,1,-0.29600000000000004
BSESN,6/29/2012,17429.98047,17448.48047,17134.60938,17134.60938,13000,439.220703,0.0,439.220703,77.90652271,16553.4707,17448.48047,97.93298345,-2.067016551,160.4714616,106.7418104,0.043347166,3337000,1,-0.5719
BSESN,7/2/2012,17398.98047,17486.57031,17363.03906,17438.67969,8600,-31.0,31.0,0.0,75.36948805,16636.08984,17486.57031,89.70113398,-10.29886602,184.3483685,122.263122,0.031980193,3328400,-1,-0.4019
BSESN,7/3/2012,17425.71094,17526.82031,17351.5,17457.94922,9400,26.730469,0.0,26.730469,76.14247258,16636.08984,17526.82031,88.64871266,-11.35128734,203.08685580000002,138.4278688,0.031312756000000004,3337800,1,0.0
BSESN,7/4/2012,17462.81055,17523.76953,17372.44922,17473.25977,10200,37.099609,0.0,37.099609,77.28413399,16636.08984,17526.82031,92.81378956,-7.186210445,218.4131397,154.424923,0.025260442,3348000,1,-0.128
BSESN,7/5/2012,17538.66992,17562.89063,17423.44922,17478.16016,8200,75.859375,0.0,75.859375,79.58861055,16636.08984,17562.89063,97.3866333,-2.613366702,233.98333340000002,170.33660509999999,0.03335748,3356200,1,-0.2732
BSESN,7/6/2012,17521.11914,17554.55078,17425.4707,17546.03906,8000,-17.550781,17.550781,0.0,77.49003811,16681.89063,17562.89063,95.25862838,-4.741371623,242.11566409999998,184.6924169,0.037848177000000004,3348200,-1,0.0
BSESN,7/9/2012,17391.98047,17485.78906,17343.55078,17449.92969,7200,-129.13867199999999,129.13867199999999,0.0,63.31598155,16799.63086,17562.89063,77.60786516,-22.39213484,235.42633500000002,194.83920049999998,0.028710738,3341000,-1,0.4939
BSESN,7/10/2012,17618.34961,17631.18945,17424.28906,17431.67969,8800,226.36914,0.0,226.36914,73.22260114,16799.63086,17631.18945,98.45593033,-1.544069665,245.56042349999998,204.98344509999998,0.038342707000000004,3349800,1,0.0
BSESN,7/11/2012,17489.14063,17582.99023,17466.99023,17553.9707,7800,-129.20898400000002,129.20898400000002,0.0,62.165929500000004,16807.80078,17631.18945,82.74826545,-17.25173455,240.3945577,212.0656676,0.029332465,3342000,-1,-0.4588
BSESN,7/12/2012,17232.55078,17329.46094,17181.16992,17297.06055,11800,-256.58984399999997,256.58984399999997,0.0,46.18574277,16815.86914,17631.18945,51.10649568,-48.89350432,213.13898230000004,212.28033050000002,-0.011327017,3330200,-1,0.0
BSESN,7/13/2012,17213.69922,17342.88086,17182.28906,17269.19922,7600,-18.851562,18.851562,0.0,45.20075488,16815.86914,17631.18945,48.79432931,-51.20567069,187.8521364,207.39469169999998,-0.010648972,3322600,-1,0.0
BSESN,7/16/2012,17103.31055,17282.30078,17079.63086,17241.98047,7600,-110.388672,110.388672,0.0,39.50787862,16918.86914,17631.18945,25.89304318,-74.10695682,157.093806,197.3345146,-0.01850142,3315000,-1,0.0
BSESN,7/17/2012,17105.30078,17236.08008,17074.63086,17176.92969,9200,1.990234,0.0,1.990234,39.66595829,16918.86914,17631.18945,26.17244474,-73.82755526,131.3639213,184.14039590000002,-0.020472636000000002,3324200,1,-0.4404
BSESN,7/18/2012,17185.00977,17205.25977,17038.58984,17113.36914,17600,79.708985,0.0,79.708985,46.16691818,17038.58984,17631.18945,24.70806929,-75.29193071,116.0667065,170.52565800000002,-0.020164593999999997,3341800,1,0.0
BSESN,7/19/2012,17278.84961,17318.92969,17244.75977,17288.33984,8000,93.839843,0.0,93.839843,53.0402698,17038.58984,17631.18945,40.543355299999995,-59.456644700000005,110.24481100000001,158.4694886,-0.013827286000000001,3349800,1,-0.6908
BSESN,7/20/2012,17158.43945,17275.19922,17129.68945,17275.19922,6400,-120.410156,120.410156,0.0,44.60781499,17038.58984,17631.18945,20.22438206,-79.77561794,94.82177724,145.7399463,-0.013428086,3343400,-1,-0.2263
BSESN,7/23/2012,16877.34961,17047.73047,16849.2793,17047.73047,8000,-281.08984399999997,281.08984399999997,0.0,31.23291034,16849.2793,17631.18945,3.589966416,-96.41003358,59.23449225,128.4388555,-0.042058423,3335400,-1,0.7269
BSESN,7/24/2012,16918.08008,16962.74023,16839.69922,16907.74023,12400,40.730469,0.0,40.730469,34.51567149,16839.69922,17631.18945,9.902947078,-90.09705292,33.92683354,109.5364511,-0.032652293,3347800,1,0.0
BSESN,7/25/2012,16846.05078,16899.00977,16736.59961,16899.00977,10800,-72.029297,72.029297,0.0,31.45198467,16736.59961,17631.18945,12.23478812,-87.76521188,7.966338394,89.22242858,-0.022428485,3337000,-1,-0.5106
BSESN,7/26/2012,16639.82031,16899.76953,16598.48047,16887.83984,12800,-206.230468,206.230468,0.0,24.32034578,16598.48047,17631.18945,4.003048743,-95.99695126,-28.91529871,65.59488313,-0.0333385,3324200,-1,-0.3182
BSESN,7/27/2012,16839.18945,16975.0293,16760.7207,16860.16016,11400,199.36914,0.0,199.36914,39.59768967,16598.48047,17631.18945,23.30850101,-76.69149899,-41.57755822,44.16039486,-0.015442688000000001,3335600,1,0.0
BSESN,7/30/2012,17143.67969,17163.94922,16919.14063,16919.14063,8000,304.490235,0.0,304.490235,55.44696338,16598.48047,17582.99023,55.37773605,-44.62226395,-26.73449427,29.98141703,0.002243685,3343600,1,0.5423
BSESN,7/31/2012,17236.17969,17253.66992,17004.08984,17186.60938,10400,92.5,0.0,92.5,59.19959996,16598.48047,17342.88086,85.66615864,-14.33384136,-7.421729127000001,22.5007878,0.002977591,3354000,1,-0.743
BSESN,8/1/2012,17257.38086,17291.99023,17189.16016,17244.43945,9200,21.201171,0.0,21.201171,60.08864085,16598.48047,17342.88086,88.51424567,-11.48575433,9.485194286,19.8976691,-0.001242487,3363200,1,0.0
BSESN,8/2/2012,17224.35938,17246.00977,17157.2793,17245.67969,15200,-33.021484,33.021484,0.0,57.8242471,16598.48047,17318.92969,86.87342418,-13.12657582,19.98907352,19.91594998,0.0038418370000000003,3348000,-1,0.5719
BSESN,8/3/2012,17197.92969,17208.35938,17026.9707,17164.48047,7600,-26.429687,26.429687,0.0,55.87953338,16598.48047,17318.92969,83.20492315,-16.79507685,25.88246171,21.10925233,0.018994693,3340400,-1,0.3182
BSESN,8/6/2012,17412.96094,17451.5293,17313.05078,17313.05078,6600,215.03125,0.0,215.03125,66.46669451,16598.48047,17451.5293,95.47876303,-4.521236972,47.35832185,26.35906623,0.029251597,3347000,1,0.2263
BSESN,8/7/2012,17601.7793,17641.55078,17417.91992,17456.36914,12000,188.81835900000002,0.0,188.81835900000002,73.02499736,16598.48047,17641.55078,96.18707545,-3.81292455,78.70687542,36.82862807,0.044860871,3359000,1,-0.2023
BSESN,8/8/2012,17600.56055,17726.64063,17582.66016,17638.5293,14400,-1.21875,1.21875,0.0,72.91878554,16598.48047,17726.64063,88.82427488,-11.17572512,102.27354129999999,49.91761072,0.057737416,3344600,-1,-0.4767
BSESN,8/9/2012,17560.86914,17702.98047,17516.99023,17612.08008,14600,-39.691406,39.691406,0.0,69.13993245,16598.48047,17726.64063,85.30603274,-14.69396726,116.4056769,63.21522395,0.042857150999999996,3330000,-1,0.0
BSESN,8/10/2012,17557.74023,17590.60938,17471.36914,17515.41992,13600,-3.128907,3.128907,0.0,68.81555454,16598.48047,17726.64063,85.02868674,-14.97131326,125.901703,75.75251977,0.024152372999999998,3316400,-1,0.0
BSESN,8/13/2012,17633.44922,17642.38086,17522.09961,17551.68945,9000,75.708985,0.0,75.708985,72.42720557,16598.48047,17726.64063,91.73952337,-8.260476627000001,137.94629550000002,88.19127492,0.023048584,3325400,1,-0.3182
BSESN,8/14/2012,17728.19922,17753.42969,17572.33984,17631.64063,10000,94.75,0.0,94.75,76.37784171,16598.48047,17753.42969,97.81544776,-2.1845522369999997,153.3693091,101.2268818,0.027282145,3335400,1,0.0
BSESN,8/16/2012,17657.21094,17763.58984,17640.61914,17752.2207,8800,-70.988281,70.988281,0.0,67.96009982,16760.7207,17763.58984,89.39254369,-10.60745631,158.0421855,112.5899425,0.025130198,3326600,-1,-0.3182
BSESN,8/17/2012,17691.08008,17801.39063,17622.61914,17701.19922,9800,33.86914,0.0,33.86914,69.79285048,16919.14063,17801.39063,87.49667929,-12.50332071,162.6040322,122.5927604,0.028674986,3336400,1,0.0258
BSESN,8/21/2012,17885.25977,17898.34961,17705.14063,17705.14063,9200,194.179688,0.0,194.179688,78.08547261,17004.08984,17898.34961,98.53623706,-1.4637629369999998,179.81520869999997,134.0372501,0.027123407000000002,3345600,1,-0.0772
BSESN,8/22/2012,17846.85938,17912.08008,17800.28906,17827.25,8800,-38.400391,38.400391,0.0,73.48242601,17026.9707,17912.08008,92.63133971,-7.368660286,188.1872935,144.86725880000003,0.013923597,3336800,-1,-0.7096
BSESN,8/23/2012,17850.2207,17972.53906,17792.86914,17856.28906,9200,3.361328,0.0,3.361328,73.63937337,17026.9707,17972.53906,87.06403839,-12.93596161,192.8701748,154.467842,0.014184783999999999,3346000,1,-0.1779
BSESN,8/24/2012,17783.21094,17822.5,17725.41992,17790.25,8200,-67.009765,67.009765,0.0,64.81523284,17026.9707,17972.53906,79.97732020000001,-20.022679800000002,188.9956399,161.3734016,0.012661206999999999,3337800,-1,0.0516
BSESN,8/27/2012,17678.81055,17820.07031,17662.21094,17769.43945,7400,-104.400391,104.400391,0.0,53.32769225,17313.05078,17972.53906,55.46114707,-44.53885293,175.4780028,164.1943218,0.006895551999999999,3330400,-1,-0.6369
BSESN,8/28/2012,17631.71094,17712.34961,17570.71094,17676.13086,9600,-47.099609,47.099609,0.0,48.82326216,17417.91992,17972.53906,38.54735623,-61.45264377,159.1302785,163.1815132,-9.86e-05,3320800,-1,0.0
BSESN,8/29/2012,17490.81055,17653.90039,17471.13086,17651.14063,9600,-140.90039099999998,140.90039099999998,0.0,37.8017385,17471.13086,17972.53906,3.924883527,-96.07511647,133.2688646,157.1989834,-0.013390456,3311200,-1,-0.4404
BSESN,8/30/2012,17541.64063,17605.50977,17367.55078,17433.5,10000,50.830078,0.0,50.830078,43.14425287,17367.55078,17972.53906,28.77573817,-71.22426183,115.5431606,148.8678189,-0.0065452190000000006,3321200,1,-0.5574
BSESN,8/31/2012,17380.75,17557.61914,17337.60938,17557.61914,10600,-160.890625,160.890625,0.0,32.84158985,17337.60938,17972.53906,6.794551557,-93.20544844,87.50418988,136.59509309999999,-0.017541613,3310600,-1,0.4019
BSESN,9/3/2012,17384.40039,17509.99023,17349.57031,17465.59961,12600,3.6503910000000004,0.0,3.6503910000000004,33.25882123,17337.60938,17972.53906,7.369479942000001,-92.63052006,64.83033585,122.2421416,-0.028004031000000002,3323200,1,0.0
BSESN,9/4/2012,17440.86914,17452.69922,17308.26953,17378.67969,6600,56.46875,0.0,56.46875,39.92099546,17308.26953,17972.53906,19.96171789,-80.03828211,50.83174268,107.9600618,-0.022748552999999998,3329800,1,-0.29600000000000004
BSESN,9/5/2012,17313.33984,17411.66992,17250.80078,17359.96094,11400,-127.529297,127.529297,0.0,31.68034168,17250.80078,17972.53906,8.665061084,-91.33493892,29.11162756,92.19037499,-0.030076987000000003,3318400,-1,0.0
BSESN,9/6/2012,17346.26953,17418.40039,17294.74023,17320.73047,10000,32.929687,0.0,32.929687,35.63866181,17250.80078,17972.53906,13.22761344,-86.77238656,14.38955652,76.63021129,-0.024570445,3328400,1,-0.5719
BSESN,9/7/2012,17683.73047,17701.19922,17575.78906,17575.78906,9600,337.460938,0.0,337.460938,61.80545077,17250.80078,17972.53906,59.98430439,-40.01569561,29.6111477,67.22639857,0.000278295,3338000,1,-0.5994
BSESN,9/10/2012,17766.7793,17810.90039,17728.11914,17780.92969,8200,83.048828,0.0,83.048828,65.75853126,17250.80078,17972.53906,71.49108325,-28.50891675,47.82442453,63.34600377,0.007660536,3346200,1,0.0
BSESN,9/11/2012,17852.94922,17867.84961,17677.38086,17711.80078,8200,86.169922,0.0,86.169922,69.53360496,17250.80078,17972.53906,83.43030334,-16.56969666,68.42303207,64.36140943,0.020704511000000002,3354400,1,-0.7506
BSESN,9/12/2012,18000.0293,18012.89063,17884.96094,17916.13086,11400,147.08007800000001,0.0,147.08007800000001,74.96865241,17250.80078,18012.89063,98.31236066,-1.687639338,95.51467631,70.59206280000001,0.02613146,3365800,1,0.0
BSESN,9/13/2012,18021.16016,18062.67969,17976.2793,18023.94922,8000,21.130859,0.0,21.130859,75.68763872,17250.80078,18062.67969,94.88599449,-5.114005505,117.3374897,79.94114819,0.036845945,3373800,1,0.3818
BSESN,9/14/2012,18464.26953,18498.53906,18284.75,18284.75,16800,443.109375,0.0,443.109375,85.65633298,17250.80078,18498.53906,97.25346794,-2.746532065,168.44571259999998,97.64206108,0.062117135,3390600,1,-0.2263
BSESN,9/17/2012,18542.31055,18715.0293,18480.53906,18619.90039,20200,78.041016,0.0,78.041016,86.75958004,17250.80078,18715.0293,88.20411240000001,-11.795887599999999,212.79365249999998,120.6723794,0.063152897,3410800,1,-0.6705
BSESN,9/18/2012,18496.00977,18580.48047,18469.50977,18514.7207,9600,-46.300781,46.300781,0.0,82.41989748,17250.80078,18715.0293,85.04198432,-14.95801568,241.42068089999998,144.82203969999998,0.06830975,3401200,-1,0.0
BSESN,9/20/2012,18349.25,18443.91992,18291.92969,18292.2207,8800,-146.75976599999998,146.75976599999998,0.0,69.67381528,17250.80078,18715.0293,75.01897463,-24.98102537,249.3906999,165.7357717,0.057821105,3392400,-1,0.6808
BSESN,9/21/2012,18752.83008,18866.86914,18411.19922,18411.19922,15000,403.58007799999996,0.0,403.58007799999996,79.65640099,17250.80078,18866.86914,92.94342579999999,-7.056574202999999,284.9873796,189.58609330000002,0.060456679000000006,3407400,1,0.0
BSESN,9/24/2012,18673.33984,18811.13086,18650.42969,18756.31055,15000,-79.490234,79.490234,0.0,74.1121053,17250.80078,18866.86914,88.02468375,-11.97531625,303.2876955,212.32641370000002,0.051025598,3392400,-1,0.3818
BSESN,9/25/2012,18694.41016,18790.00977,18636.16016,18708.00977,10600,21.070312,0.0,21.070312,74.65171455,17250.80078,18866.86914,89.32848453,-10.67151547,315.85010239999997,233.03115150000002,0.047132880999999995,3403000,1,0.0
BSESN,9/26/2012,18632.16992,18670.48047,18573.17969,18644.53906,10400,-62.240233999999994,62.240233999999994,0.0,69.69991493,17294.74023,18866.86914,85.07124842,-14.92875158,317.12797969999997,249.85051710000002,0.035118866,3392600,-1,-0.4215
BSESN,9/27/2012,18579.5,18735.94922,18552.67969,18659.75,10400,-52.669922,52.669922,0.0,65.46016963,17575.78906,18866.86914,77.74195839,-22.25804161,310.3135823,261.9431301,0.030982457999999997,3382200,-1,-0.6249
BSESN,9/28/2012,18762.74023,18869.93945,18698.50977,18704.98047,11400,183.24023400000002,0.0,183.24023400000002,72.23892383,17677.38086,18869.93945,91.01098935,-8.989010647999999,316.05578439999994,272.76566099999997,0.016164772,3393600,1,0.0
BSESN,10/1/2012,18823.91016,18838.53906,18745.2793,18784.64063,8200,61.169922,0.0,61.169922,74.19003534,17677.38086,18869.93945,96.14029053,-3.8597094710000004,321.8325373,282.57903619999996,0.015186867,3401800,1,0.4939
BSESN,10/3/2012,18869.68945,18905.61914,18816.57031,18841.49023,8400,45.779297,0.0,45.779297,75.66684112,17884.96094,18905.61914,96.47975317,-3.520246826,326.3427857,291.3317861,0.02020326,3410200,1,0.0
BSESN,10/4/2012,19058.15039,19107.03906,18939.75,18939.75,11600,188.460938,0.0,188.460938,80.8670242,17976.2793,19107.03906,95.67647581,-4.323524189,341.1913711,301.30370310000006,0.038633753,3421800,1,0.0
BSESN,10/5/2012,18938.46094,19137.28906,18757.33984,19115.89063,39400,-119.689453,119.689453,0.0,69.91764767,18284.75,19137.28906,76.67812143,-23.32187857,339.3887807,308.92071860000004,0.009898818,3382400,-1,0.4767
BSESN,10/8/2012,18708.98047,18969.18945,18684.40039,18969.18945,9400,-229.480469,229.480469,0.0,53.80181902,18291.92969,19137.28906,49.33414041,-50.66585959,315.8026822,310.2971113,0.0019086370000000001,3373000,-1,0.4019
BSESN,10/9/2012,18793.35938,18885.83984,18722.05078,18796.25,8200,84.378906,0.0,84.378906,57.91716965,18291.92969,19137.28906,59.3155647,-40.6844353,300.455735,308.3288361,0.005292984000000001,3381200,1,0.0
BSESN,10/10/2012,18631.09961,18740.63086,18614.36914,18699.18945,7200,-162.25976599999998,162.25976599999998,0.0,48.35882716,18291.92969,19137.28906,40.12138873,-59.87861127,272.06397749999996,301.0758644,-5.739999999999999e-05,3374000,-1,0.0
BSESN,10/11/2012,18804.75,18847.81055,18581.49023,18627.36914,9400,173.65039099999998,0.0,173.65039099999998,57.10126529,18411.19922,19137.28906,54.20138902,-45.79861098,260.5717318,292.9750378,0.012123577,3383400,1,0.0
BSESN,10/12/2012,18675.17969,18844.34961,18638.33984,18727.09961,9000,-129.570312,129.570312,0.0,49.83737501,18552.67969,19137.28906,20.95416277,-79.04583723,238.26226380000003,282.032483,-0.004666725,3374400,-1,-0.4939
BSESN,10/15/2012,18713.55078,18726.38086,18596.65039,18690.99023,6000,38.371093,0.0,38.371093,51.92701378,18552.67969,19137.28906,27.51770667,-72.48229333,221.1290384,269.8517941,-0.005862723,3380400,1,-0.2732
BSESN,10/16/2012,18577.69922,18801.09961,18549.2793,18784.75,7600,-135.851562,135.851562,0.0,44.37537258,18549.2793,19137.28906,4.833239794,-95.16676021,194.3484204,254.75111940000002,-0.015474035,3372800,-1,0.0
BSESN,10/17/2012,18610.76953,18705.18945,18535.36914,18667.7207,7000,33.070312,0.0,33.070312,46.55835085,18535.36914,19137.28906,12.52664802,-87.47335198,173.7897456,238.5588446,-0.023474516,3379800,1,-0.0258
BSESN,10/18/2012,18791.92969,18806.56055,18576.41016,18653.59961,8200,181.160157,0.0,181.160157,57.18018249,18535.36914,19137.28906,42.62370086,-57.37629914,170.15353430000002,224.87778250000002,-0.007737231,3388000,1,-0.5719
BSESN,10/19/2012,18682.31055,18769.58984,18611.75977,18768.0,8000,-109.61914099999998,109.61914099999998,0.0,50.21229336,18535.36914,19137.28906,24.41211873,-75.58788127,156.6210323,211.22643250000002,-0.001425514,3380000,-1,0.0
BSESN,10/22/2012,18793.43945,18809.2793,18600.88086,18655.92969,7000,111.128906,0.0,111.128906,56.42375804,18535.36914,19137.28906,42.87452576,-57.12547424,153.09877360000002,199.6009007,4.26e-06,3387000,1,-0.765
BSESN,10/23/2012,18710.01953,18812.92969,18689.38086,18803.61914,6000,-83.419922,83.419922,0.0,50.92123953,18535.36914,19137.28906,29.01555234,-70.98444766,141.9398731,188.06869519999998,0.004235924,3381000,-1,-0.2732
BSESN,10/25/2012,18758.63086,18789.91992,18699.07031,18712.41016,8600,48.611328,0.0,48.611328,53.94137279,18535.36914,19137.28906,37.09159804,-62.90840196,135.4574232,177.5464408,-0.002452526,3389600,1,0.0
BSESN,10/29/2012,18635.82031,18743.41016,18572.01953,18656.0,7600,-122.810546,122.810546,0.0,45.73698569,18535.36914,18969.18945,23.15501815,-76.84498185,119.03805359999998,165.8447634,-0.0021075770000000002,3382000,-1,0.0
BSESN,10/30/2012,18430.84961,18718.2793,18393.41992,18642.00977,9000,-204.970704,204.970704,0.0,35.37533871,18393.41992,18885.83984,7.6011723589999995,-92.39882764,88.46637684,150.3690861,-0.015106763,3373000,-1,0.0
BSESN,10/31/2012,18505.38086,18521.61914,18398.48047,18436.78906,7000,74.53125,0.0,74.53125,40.98478231,18393.41992,18847.81055,24.63979907,-75.36020093,69.45155739,134.1855803,-0.003892751,3380000,1,0.0
BSESN,11/1/2012,18561.69922,18589.13086,18445.17969,18487.90039,9000,56.31836,0.0,56.31836,45.13682619,18393.41992,18847.81055,37.03406007,-62.96593993,58.25506879,118.999478,-0.002636662,3389000,1,-0.7579
BSESN,11/2/2012,18755.44922,18793.75,18687.92969,18692.15039,9200,193.75,0.0,193.75,57.113972600000004,18393.41992,18844.34961,80.28508822,-19.71491178,64.27485615,108.05455359999999,-0.001941284,3398200,1,0.0
BSESN,11/5/2012,18762.86914,18794.63086,18683.25,18749.36914,5600,7.419922,0.0,7.419922,57.52372769,18393.41992,18812.92969,88.06689354,-11.93310646,68.85063937,100.21377079999999,0.004312025,3403800,1,0.34
BSESN,11/6/2012,18817.38086,18829.07031,18726.93945,18739.9707,7600,54.511718,0.0,54.511718,60.70624323,18393.41992,18829.07031,97.31678101,-2.683218985,75.99954517,95.37092567,0.0012739239999999998,3411400,1,0.0
BSESN,11/7/2012,18902.41016,18973.42969,18786.14063,18802.82031,8800,85.029297,0.0,85.029297,65.37537225,18393.41992,18973.42969,87.75545928,-12.24454072,87.51741192,93.80022292,0.010282759,3420200,1,0.0
BSESN,11/8/2012,18846.25977,18865.21094,18736.44922,18779.74023,9800,-56.15039,56.15039,0.0,59.94766186,18393.41992,18973.42969,78.07452056,-21.92547944,91.06479878,93.25313809,0.0046713909999999996,3410400,-1,0.0
BSESN,11/9/2012,18683.67969,18894.41992,18656.41016,18832.75,9600,-162.58007800000001,162.58007800000001,0.0,46.93041024,18393.41992,18973.42969,50.043944599999996,-49.956055400000004,79.83696405,90.56990328,0.002568139,3400800,-1,0.4404
BSESN,11/12/2012,18670.33984,18750.91992,18607.66016,18691.01953,19400,-13.339844,13.339844,0.0,45.98505488,18393.41992,18973.42969,47.74401023,-52.25598977,69.06625738,86.26917409999999,0.012993988,3381400,-1,0.5574
BSESN,11/15/2012,18471.36914,18593.53906,18408.68945,18590.07031,6200,-198.97070300000001,198.97070300000001,0.0,34.14701548,18393.41992,18973.42969,13.43929423,-86.56070577,43.96828289,77.80899586,-0.0018379370000000002,3375200,-1,0.34
BSESN,11/16/2012,18309.36914,18563.32031,18266.75977,18491.49023,7000,-162.0,162.0,0.0,27.49700596,18266.75977,18973.42969,6.029600762,-93.97039924,10.88048768,64.42329422,-0.013594126000000002,3368200,-1,0.0
BSESN,11/19/2012,18339.0,18386.7793,18256.07031,18349.5293,7200,29.630859,0.0,29.630859,30.35927171,18256.07031,18973.42969,11.56041029,-88.43958971,-12.80327751,48.97797988,-0.022204172,3375400,1,0.0
BSESN,11/20/2012,18329.32031,18467.91016,18255.68945,18422.68945,6600,-9.679687,9.679687,0.0,29.91413295,18255.68945,18973.42969,10.25870592,-89.74129408,-31.98519646,32.78534461,-0.023106745,3368800,-1,0.2263
BSESN,11/21/2012,18460.38086,18478.5,18309.81055,18379.90039,6800,131.060546,0.0,131.060546,42.9763682,18255.68945,18973.42969,28.5188702,-71.48112979999999,-36.19428944,18.989417800000002,-0.018971822,3375600,1,0.8024
BSESN,11/22/2012,18517.33984,18567.67969,18456.19922,18510.93945,6200,56.958985,0.0,56.958985,47.8502753,18255.68945,18973.42969,36.45474759,-63.54525241,-34.53580464,8.284373311,-0.020371493,3381800,1,0.0
BSESN,11/23/2012,18506.57031,18556.5,18402.38086,18543.94922,6000,-10.769531,10.769531,0.0,46.97435289,18255.68945,18973.42969,34.95427005,-65.04572995,-33.70195942,-0.112893235,-0.018024237,3375800,-1,0.0
BSESN,11/26/2012,18537.00977,18590.33008,18508.78906,18574.35938,5800,30.439453000000004,0.0,30.439453000000004,49.96160921,18255.68945,18973.42969,39.19528254,-60.80471746,-30.2363755,-6.137589687,-0.007850163,3381600,1,-0.4404
BSESN,11/27/2012,18842.08008,18862.69922,18616.55078,18616.55078,7600,305.070312,0.0,305.070312,69.70078175,18255.68945,18973.42969,81.69956154,-18.30043846,-2.840507071,-5.478173163999999,0.00919856,3389200,1,-0.3182
BSESN,11/29/2012,19170.91016,19205.33008,18873.63086,18873.63086,11400,328.83007799999996,0.0,328.83007799999996,79.67341003,18255.68945,19205.33008,96.3754792,-3.6245208019999997,44.88732207,4.594925883,0.037871639,3400600,1,0.0
BSESN,11/30/2012,19339.90039,19372.69922,19186.30078,19229.69922,11200,168.990235,0.0,168.990235,82.99274073,18255.68945,19372.69922,97.06369371,-2.936306288,95.25008647,22.725958,0.056284367,3411800,1,-0.1531
BSESN,12/3/2012,19305.32031,19416.44922,19257.30078,19342.83008,7200,-34.580078,34.580078,0.0,79.91162355,18255.68945,19416.44922,90.42619246,-9.57380754,130.864097,44.35358579,0.052692094,3404600,-1,-0.5859
BSESN,12/4/2012,19348.11914,19373.93945,19263.71094,19277.58008,8200,42.798828,0.0,42.798828,80.92304239,18255.68945,19416.44922,94.11333163,-5.88666837,160.6896345,67.62079554,0.055583012,3412800,1,-0.2263
BSESN,12/5/2012,19391.85938,19463.25,19371.00977,19397.98047,9600,43.740234,0.0,43.740234,81.99220525,18255.68945,19463.25,94.08802936,-5.91197064,185.7152494,91.23968632,0.05045825,3422400,1,-0.5106
BSESN,12/6/2012,19486.80078,19523.25,19186.24023,19475.08984,10000,94.941406,0.0,94.941406,84.20873755,18255.68945,19523.25,97.12445933,-2.875540666,210.779473,115.14764369999999,0.052354223,3432400,1,-0.8807
BSESN,12/7/2012,19424.09961,19561.86914,19363.13086,19514.88086,9000,-62.701172,62.701172,0.0,76.98765165,18255.68945,19561.86914,89.45248244,-10.54751756,223.01283709999998,136.72068230000002,0.04957857,3423400,-1,0.0
BSESN,12/10/2012,19409.68945,19478.00977,19362.32031,19442.18945,6800,-14.410156,14.410156,0.0,75.27589427,18255.68945,19561.86914,88.34925322,-11.65074678,228.9063966,155.1578252,0.047077695,3416600,-1,0.4019
BSESN,12/11/2012,19387.14063,19612.17969,19285.28906,19466.28906,7600,-22.548828,22.548828,0.0,72.37062328,18309.81055,19612.17969,82.72079275,-17.27920725,229.11647090000002,169.94955430000002,0.028927832999999997,3409000,-1,0.0
BSESN,12/12/2012,19355.25977,19478.78906,19317.23047,19432.53906,7600,-31.880859,31.880859,0.0,68.08386614,18402.38086,19612.17969,78.76341786,-21.23658214,224.12684280000002,180.78501200000002,0.009616112,3401400,-1,0.0
BSESN,12/13/2012,19229.25977,19421.7207,19196.75,19403.66016,9400,-126.0,126.0,0.0,53.60432403,18402.38086,19612.17969,68.34846316,-31.65153684,207.6121558,186.1504408,-0.005720848000000001,3392000,-1,0.0
BSESN,12/14/2012,19317.25,19348.84961,19193.10938,19217.96094,11400,87.990234,0.0,87.990234,60.39179005,18508.78906,19612.17969,73.27060052,-26.72939948,199.326512,188.785655,0.000617948,3403400,1,-0.631
BSESN,12/17/2012,19244.41992,19346.7793,19221.86914,19290.91992,12800,-72.830078,72.830078,0.0,52.98833199999999,18616.55078,19612.17969,63.06256644,-36.93743356,184.7535767,187.9792394,-0.005359654,3390600,-1,0.3875
BSESN,12/18/2012,19364.75,19396.2793,19149.0293,19293.00977,14000,120.330078,0.0,120.330078,61.89391539,18873.63086,19612.17969,66.49785657,-33.50214343,180.8295615,186.54930380000002,-0.0013979770000000001,3404600,1,0.0
BSESN,12/19/2012,19476.0,19516.01953,19419.75977,19429.91016,9800,111.25,0.0,111.25,68.29996361,19149.0293,19612.17969,70.597091,-29.402909,184.5690988,186.1532628,-0.000554261,3414400,1,-0.6908
BSESN,12/20/2012,19453.91992,19520.50977,19335.7207,19511.41016,10400,-22.080078,22.080078,0.0,65.76799134,19149.0293,19612.17969,65.82972419,-34.17027581,183.6342104,185.6494523,0.0015352220000000001,3404000,-1,-0.0516
BSESN,12/21/2012,19242.0,19394.55078,19221.11914,19394.55078,9200,-211.919922,211.919922,0.0,46.626043599999996,19149.0293,19612.17969,20.07354518,-79.92645482,163.90375749999998,181.30031340000002,-0.008639471,3394800,-1,-0.2732
BSESN,12/24/2012,19255.08984,19347.64063,19237.25977,19278.0,7400,13.089844,0.0,13.089844,47.71070681,19149.0293,19612.17969,22.89980729,-77.10019271,147.6217805,174.5646068,-0.006811256,3402200,1,0.0
BSESN,12/26/2012,19417.46094,19468.40039,19274.07031,19302.4707,5800,162.371094,0.0,162.371094,59.49274618,19149.0293,19612.17969,57.95777057,-42.04222943,146.1356261,168.87881059999998,0.003213657,3408000,1,-0.5423
BSESN,12/27/2012,19323.80078,19504.40039,19302.21094,19479.83984,7600,-93.660157,93.660157,0.0,51.73421308,19149.0293,19612.17969,37.73536359,-62.26463641,135.8344314,162.26993480000002,0.004916519,3400400,-1,0.128
BSESN,12/28/2012,19444.83984,19465.74023,19346.07031,19364.08008,6600,121.03906299999998,0.0,121.03906299999998,59.59201949,19149.0293,19612.17969,63.86922105,-36.13077895,135.8712618,156.99020019999998,0.0066049690000000005,3407000,1,0.3818
BSESN,12/31/2012,19426.71094,19491.58008,19406.16992,19422.58984,4800,-18.128906,18.128906,0.0,57.96124617,19149.0293,19612.17969,59.95496202,-40.04503798,132.9055466,152.1732695,0.009472409000000001,3402200,-1,-0.6908
BSESN,1/2/2013,19714.24023,19756.67969,19686.5,19693.30078,7400,287.529296,0.0,287.529296,71.98909434,19149.0293,19756.67969,93.01581063,-6.984189367999999,152.0041974,152.1394551,0.018047753,3409600,1,-0.1779
BSESN,1/3/2013,19764.7793,19786.30078,19693.28906,19771.0293,6600,50.539063,0.0,50.539063,73.76459940000001,19149.0293,19786.30078,96.62287039,-3.377129613,169.26689230000002,155.5649425,0.014827443999999999,3416200,1,-0.4939
BSESN,1/4/2013,19784.08008,19797.43945,19679.99023,19782.58984,7000,19.300781,0.0,19.300781,74.47747541,19149.0293,19797.43945,97.93967215,-2.060327846,182.4024918,160.9324524,0.016971395,3423200,1,0.0
BSESN,1/7/2013,19691.41992,19856.42969,19654.46094,19820.56055,7400,-92.660156,92.660156,0.0,64.73378746,19149.0293,19856.42969,76.67378078,-23.32621922,183.22356169999998,165.39067419999998,0.023356196,3415800,-1,-0.9325
BSESN,1/8/2013,19742.51953,19761.7793,19632.58984,19681.38086,7400,51.099609,0.0,51.099609,67.44399174,19149.0293,19856.42969,83.89735736,-16.10264264,185.8551543,169.48357019999997,0.025314329,3423200,1,0.0
BSESN,1/9/2013,19666.58984,19824.06055,19627.16016,19770.21094,9600,-75.929687,75.929687,0.0,59.59210746,19221.11914,19856.42969,70.11857509999999,-29.881424900000003,179.7418669,171.53522959999998,0.012830148000000001,3413600,-1,0.1779
BSESN,1/10/2013,19663.55078,19783.75,19596.38086,19728.01953,9200,-3.039063,3.039063,0.0,59.27341881,19221.11914,19856.42969,69.64021644,-30.35978356,172.6614815,171.76048,0.017581945,3404400,-1,-0.128
BSESN,1/11/2013,19663.64063,19839.80078,19619.83008,19813.64063,10000,0.08984400000000001,0.0,0.08984400000000001,59.28084684,19221.11914,19856.42969,69.65435819,-30.34564181,165.15368590000003,170.4391212,0.011252383000000001,3414400,1,0.0
BSESN,1/14/2013,19906.41016,19948.63086,19689.08984,19689.08984,8800,242.769531,0.0,242.769531,74.04199721,19237.25977,19948.63086,94.06488352,-5.935116484,176.75564690000002,171.7024263,0.024692766,3423200,1,0.0
BSESN,1/15/2013,19986.82031,20036.82031,19881.7793,19999.82031,9600,80.410157,0.0,80.410157,77.20069267,19274.07031,20036.82031,93.44477221,-6.555227793999999,190.2456785,175.4110767,0.013826558000000001,3432800,1,0.2263
BSESN,1/16/2013,19817.63086,20009.35938,19783.01953,19978.18945,8600,-169.189454,169.189454,0.0,59.59489124,19302.21094,20036.82031,70.16244804,-29.83755196,185.150155,177.3588924,0.0026740270000000003,3424200,-1,-0.6808
BSESN,1/17/2013,19964.0293,20005.98047,19783.41016,19846.41992,11800,146.398438,0.0,146.398438,67.08853267,19346.07031,20036.82031,89.4620317,-10.537968300000001,190.7264704,180.032408,0.009095658000000001,3436000,1,0.0
BSESN,1/18/2013,20039.03906,20126.55078,19990.61914,20038.66992,14600,75.009766,0.0,75.009766,70.34052399,19406.16992,20126.55078,87.85202065,-12.14797935,198.9055425,183.80703490000002,0.01765333,3450600,1,0.0
BSESN,1/21/2013,20101.82031,20163.38086,20056.46094,20132.83008,11400,62.78125,0.0,62.78125,72.92422949,19596.38086,20163.38086,89.14276085,-10.85723915,208.0551084,188.6566496,0.018199338,3462000,1,0.3724
BSESN,1/22/2013,19981.57031,20156.85938,19952.91016,20102.42969,8600,-120.25,120.25,0.0,61.15121542,19596.38086,20163.38086,67.93464797,-32.06535203,203.25998080000002,191.5773158,0.016016019,3453400,-1,-0.8481
BSESN,1/23/2013,20026.60938,20058.07031,19920.91016,19997.03906,10200,45.039062,0.0,45.039062,63.68491456,19596.38086,20163.38086,75.87804515,-24.12195485,200.779621,193.4177769,0.018463532,3463600,1,0.4019
BSESN,1/24/2013,19923.7793,20072.2793,19884.19922,20017.19922,12000,-102.830078,102.830078,0.0,54.34732987,19596.38086,20163.38086,57.74222892,-42.25777108,188.3452631,192.4032741,0.013229426,3451600,-1,0.4939
BSESN,1/25/2013,20103.5293,20129.00977,19928.10938,19945.68945,12000,179.75,0.0,179.75,64.76681998,19596.38086,20163.38086,89.44416896,-10.55583104,190.79589140000002,192.08179760000002,0.009902295,3463600,1,0.4939
BSESN,1/28/2013,20103.34961,20172.44922,20062.78906,20129.0,6800,-0.17968800000000001,0.17968800000000001,0.0,64.74977421,19596.38086,20172.44922,88.00496351,-11.99503649,190.5272531,191.7708887,0.005830307,3456800,-1,0.5859
BSESN,1/29/2013,19990.90039,20203.66016,19970.05078,20080.31055,9000,-112.44921799999999,112.44921799999999,0.0,54.40966004,19596.38086,20203.66016,64.96508838,-35.03491162,179.1752227,189.2517555,0.008743200999999999,3447800,-1,0.0
BSESN,1/30/2013,20005.0,20073.46094,19964.64063,20014.80078,9200,14.099609,0.0,14.099609,55.439189299999995,19619.83008,20203.66016,65.97294941,-34.02705059,169.3640541,185.2742152,0.002052226,3457000,1,-0.4019
BSESN,1/31/2013,19894.98047,20008.83008,19865.7207,19987.2793,8400,-110.019531,110.019531,0.0,46.07192364,19689.08984,20203.66016,40.0121461,-59.9878539,150.97067959999998,178.4135081,-0.007188897,3448600,-1,0.4588
BSESN,2/1/2013,19781.18945,19966.68945,19736.44922,19907.21094,16400,-113.79101599999998,113.79101599999998,0.0,38.34079096,19736.44922,20203.66016,9.576024544,-90.42397546,125.76210649999999,167.88322780000001,-0.01595034,3432200,-1,-0.25
BSESN,2/4/2013,19751.18945,19902.59961,19728.21094,19860.9707,6800,-30.0,30.0,0.0,36.47867377,19728.21094,20203.66016,4.83301142,-95.16698858,102.1854512,154.7436725,-0.011529667,3425400,-1,0.0
BSESN,2/5/2013,19659.82031,19717.25977,19631.9707,19665.53906,7800,-91.36914,91.36914,0.0,31.16035331,19631.9707,20203.66016,4.8714577210000005,-95.12854228,75.26049976,138.8470379,-0.018315085,3417600,-1,0.0
BSESN,2/6/2013,19639.7207,19767.25,19611.26953,19737.76953,7200,-20.099610000000002,20.099610000000002,0.0,30.04838454,19611.26953,20203.66016,4.802772157,-95.19722784,51.70439515,121.4185094,-0.014257265,3410400,-1,0.0
BSESN,2/7/2013,19580.32031,19702.56055,19540.08008,19589.43945,9000,-59.40039,59.40039,0.0,26.788593900000002,19540.08008,20203.66016,6.0641113760000005,-93.93588862,27.92104111,102.7190157,-0.026025727999999998,3401400,-1,0.3818
BSESN,2/8/2013,19484.76953,19648.07031,19414.80078,19577.18945,14200,-95.550782,95.550782,0.0,22.29865781,19414.80078,20203.66016,8.869609999,-91.13039,1.346886066,82.44458979,-0.030770001,3387200,-1,0.128
BSESN,2/11/2013,19460.57031,19543.43945,19416.93945,19517.58984,7200,-24.199218,24.199218,0.0,21.25749804,19414.80078,20203.66016,5.801988726,-94.19801127,-21.41909196,61.67185344,-0.026528574,3380000,-1,0.0
BSESN,2/12/2013,19561.03906,19583.5293,19438.5293,19489.86914,6800,100.46875,0.0,100.46875,35.65077148,19414.80078,20203.66016,18.53794055,-81.46205945,-30.99699107,43.13808454,-0.022192498999999997,3386800,1,0.0
BSESN,2/13/2013,19608.08008,19723.00977,19574.15039,19601.68945,8000,47.041015,0.0,47.041015,41.43423231,19414.80078,20203.66016,24.50110921,-75.49889079,-34.39524142,27.63141935,-0.014420743,3394800,1,0.4939
BSESN,2/14/2013,19497.17969,19639.83008,19444.33008,19626.81055,10000,-110.90038999999999,110.90038999999999,0.0,33.29433245,19414.80078,20203.66016,10.44278735,-89.55721265,-45.51247446,13.00264058,-0.014357568000000001,3384800,-1,-0.5719
BSESN,2/15/2013,19468.15039,19512.89063,19381.82031,19449.83008,7600,-29.029296999999996,29.029296999999996,0.0,31.42946445,19381.82031,20203.66016,10.50448925,-89.49551075,-56.01962405,-0.801812344,-0.014330229,3377200,-1,0.4201
BSESN,2/18/2013,19501.08008,19554.48047,19462.91992,19496.25,6000,32.929687,0.0,32.929687,36.11315525,19381.82031,20073.46094,17.24302487,-82.75697513,-60.98645142,-12.83874016,-0.008074348,3383200,1,0.3252
BSESN,2/19/2013,19635.7207,19671.16992,19457.21094,19523.69922,5800,134.640625,0.0,134.640625,51.6830753,19381.82031,20008.83008,40.49384941,-59.50615059,-53.44227541,-20.95944721,-0.00020366900000000002,3389000,1,0.0
BSESN,2/20/2013,19642.75,19742.41992,19619.89063,19717.93945,6800,7.029297,0.0,7.029297,52.38215765,19381.82031,19966.68945,44.61334496,-55.38665504,-46.36182577,-26.03992292,0.0031883890000000002,3395800,1,0.34
BSESN,2/21/2013,19325.35938,19554.65039,19289.69922,19549.05078,12400,-317.390625,317.390625,0.0,29.86771622,19289.69922,19902.59961,5.818262899,-94.18173709999999,-65.60503531,-33.9529454,-0.00818127,3383400,-1,0.4404
BSESN,2/22/2013,19317.00977,19401.75,19289.83008,19341.90039,7600,-8.349609,8.349609,0.0,29.48306215,19289.69922,19767.25,5.718878094,-94.28112191,-80.60005393,-43.28236711,-0.007376995999999999,3375800,-1,0.0
BSESN,2/25/2013,19331.68945,19411.17969,19237.98047,19365.33008,7800,14.679687,0.0,14.679687,31.27845622,19237.98047,19767.25,17.70534265,-82.29465735,-90.25873959,-52.677641599999994,-0.011724817,3383600,1,-0.1027
BSESN,2/26/2013,19015.14063,19293.49023,18976.93945,19290.66016,9200,-316.54882799999996,316.54882799999996,0.0,19.14826594,18976.93945,19742.41992,4.990482912,-95.00951709,-122.04925459999998,-66.55196421,-0.030239547000000002,3374400,-1,-0.5267
BSESN,2/27/2013,19152.41016,19213.01953,18997.82031,19090.32031,8400,137.269531,0.0,137.269531,32.28756207,18976.93945,19742.41992,22.92294972,-77.07705028,-134.61520269999997,-80.16461190000001,-0.017683046,3382800,1,0.0
BSESN,2/28/2013,18861.53906,19322.2793,18793.9707,19264.80078,14800,-290.87109300000003,290.87109300000003,0.0,23.10652534,18793.9707,19742.41992,7.124088317000001,-92.87591168,-166.12963430000002,-97.35761637,-0.031159166000000002,3368000,-1,0.0
BSESN,3/1/2013,18918.51953,18988.9707,18820.90039,18876.67969,8400,56.980468,0.0,56.980468,27.75024713,18793.9707,19742.41992,13.13183938,-86.86816062,-184.3817626,-114.7624456,-0.029873245,3376400,1,0.5106
BSESN,3/4/2013,18877.96094,18930.85938,18760.41016,18920.90039,7600,-40.558593,40.558593,0.0,26.4388793,18760.41016,19742.41992,11.97042902,-88.02957098,-199.81608980000001,-131.7731745,-0.038590881,3368800,-1,-0.29600000000000004
BSESN,3/5/2013,19143.16992,19164.03906,18943.61914,18943.61914,9400,265.208984,0.0,265.208984,45.77306826,18760.41016,19742.41992,38.97718528,-61.02281472,-188.4751328,-143.11356609999999,-0.025433306,3378200,1,-0.6705
BSESN,3/6/2013,19252.60938,19293.39063,19195.4707,19254.19922,9400,109.439453,0.0,109.439453,51.80446647,18760.41016,19742.41992,50.121621600000005,-49.878378399999995,-168.71169,-148.2331909,-0.0037644840000000002,3387600,1,0.0
BSESN,3/7/2013,19413.53906,19465.51953,19212.91992,19222.05078,8800,160.929688,0.0,160.929688,59.45587017,18760.41016,19742.41992,66.50941056,-33.49058944,-138.467175,-146.2799877,0.004997114,3396400,1,0.4404
BSESN,3/8/2013,19683.23047,19706.0293,19477.60938,19478.66992,10000,269.69140600000003,0.0,269.69140600000003,68.97881978,18760.41016,19742.41992,93.97262074,-6.027379262999999,-91.679512,-135.3598926,0.018184702,3406400,1,0.0
BSESN,3/11/2013,19646.21094,19754.66016,19602.71094,19679.88086,7400,-37.019531,37.019531,0.0,66.50477233,18760.41016,19754.66016,89.09235927,-10.90764073,-56.9308553,-119.6740851,0.03318778,3399000,-1,-0.4939
BSESN,3/12/2013,19564.91992,19697.83984,19505.75,19675.81055,7600,-81.291016,81.291016,0.0,60.96452672,18760.41016,19754.66016,80.91624501,-19.08375499,-35.54209301,-102.84768670000001,0.021538269,3391400,-1,0.0
BSESN,3/13/2013,19362.55078,19511.9707,19338.51953,19511.9707,8200,-202.36914099999998,202.36914099999998,0.0,49.19307947,18760.41016,19754.66016,60.56229570000001,-39.43770429999999,-34.52288488,-89.18272634,0.026562611,3383200,-1,0.0
BSESN,3/14/2013,19570.43945,19604.69922,19179.33008,19367.25977,11200,207.88867199999999,0.0,207.88867199999999,58.65554604,18760.41016,19754.66016,81.47139019,-18.52860981,-16.74722508,-74.69562608,0.034459352,3394400,1,0.0
BSESN,3/15/2013,19427.56055,19673.16016,19383.13086,19570.00977,10200,-142.878906,142.878906,0.0,51.10724588,18760.41016,19754.66016,67.1008691,-32.8991309,-14.027322,-62.56196527,0.029113293,3384200,-1,-0.128
BSESN,3/18/2013,19293.19922,19345.41992,19232.23047,19282.63086,7400,-134.36132800000001,134.36132800000001,0.0,44.84527746,18760.41016,19754.66016,53.58703173,-46.41296827,-22.45477087,-54.54052639,0.007837223,3376800,-1,0.0
BSESN,3/19/2013,19008.09961,19378.60938,18939.4707,19345.91016,12600,-285.09961,285.09961,0.0,34.49678185,18760.41016,19754.66016,24.91219039,-75.08780961,-51.54456698,-53.94133451,-0.012700085,3364200,-1,-0.6908
BSESN,3/20/2013,18884.18945,19028.08984,18836.76953,19026.46094,11000,-123.910156,123.910156,0.0,30.91877646,18760.41016,19754.66016,12.44951441,-87.55048559,-83.63288615,-59.87964483,-0.027267033,3353200,-1,0.0
BSESN,3/21/2013,18792.86914,19082.28906,18756.65039,18926.21094,12400,-91.320312,91.320312,0.0,28.412758399999998,18756.65039,19754.66016,3.629097757,-96.37090224,-115.10503700000001,-70.92472328,-0.045234512000000004,3340800,-1,-0.5994
BSESN,3/22/2013,18735.59961,18859.82031,18669.19922,18784.92969,13600,-57.269532,57.269532,0.0,26.83867711,18669.19922,19754.66016,6.11725284,-93.88274716,-143.0194765,-85.34367392,-0.046350481,3327200,-1,0.1531
BSESN,3/25/2013,18681.41992,18950.2207,18654.60938,18894.13086,12200,-54.179687,54.179687,0.0,25.30817028,18654.60938,19754.66016,2.437209942,-97.56279006,-167.5819385,-101.7913268,-0.045157353,3315000,-1,-0.29600000000000004
BSESN,3/26/2013,18704.5293,18758.88086,18612.36914,18645.08984,12000,23.109375,0.0,23.109375,27.34721179,18612.36914,19754.66016,8.068010235,-91.93198977,-183.0727841,-118.0476183,-0.033984235,3327000,1,-0.2023
BSESN,3/28/2013,18835.76953,18882.53906,18568.42969,18702.46094,14600,131.24023400000002,0.0,131.24023400000002,38.37173061,18568.42969,19754.66016,22.53692265,-77.46307735,-182.65388059999998,-130.9688708,-0.037539776000000004,3341600,1,0.3182
BSESN,4/1/2013,18864.75,18959.48047,18796.59961,18890.81055,8400,28.980469,0.0,28.980469,40.66576042,18568.42969,19754.66016,24.97999503,-75.02000497,-177.9323218,-140.36156100000002,-0.028969697000000003,3350000,1,-0.4939
BSESN,4/2/2013,19040.94922,19060.50977,18826.5293,18863.82031,8200,176.199219,0.0,176.199219,52.95172518,18568.42969,19697.83984,41.837726399999994,-58.162273600000006,-158.1495979,-143.91916840000002,-0.013074555,3358200,1,0.0
BSESN,4/3/2013,18801.64063,19035.19922,18721.7207,19034.0,7800,-239.308594,239.308594,0.0,39.97884628,18568.42969,19673.16016,21.11021138,-78.88978862,-159.9381824,-147.1229712,-0.010861632,3350400,-1,0.6348
BSESN,4/4/2013,18509.69922,18733.61914,18473.84961,18731.38086,8400,-291.94140600000003,291.94140600000003,0.0,29.72716579,18473.84961,19673.16016,2.989184919,-97.01081508,-182.8056109,-154.2594991,-0.019830887,3342000,-1,-0.2732
BSESN,4/5/2013,18450.23047,18525.44922,18389.28906,18493.66992,8000,-59.46875,59.46875,0.0,28.03733743,18389.28906,19673.16016,4.746691964,-95.25330804,-203.3823784,-164.084075,-0.018232377,3334000,-1,-0.6908
BSESN,4/8/2013,18437.7793,18504.48047,18402.92969,18455.80078,7600,-12.451172,12.451172,0.0,27.65752279,18389.28906,19378.60938,4.901368486,-95.09863151,-218.17928540000003,-174.90311699999998,-0.015895958,3326400,-1,-0.5904
BSESN,4/9/2013,18226.48047,18565.56055,18206.60938,18481.4707,10600,-211.298828,211.298828,0.0,21.85918346,18206.60938,19378.60938,1.695485836,-98.30451416,-244.14167700000002,-188.750829,-0.024352508999999998,3315800,-1,0.0
BSESN,4/10/2013,18414.44922,18461.43945,18173.31055,18355.14063,8000,187.96875,0.0,187.96875,35.69675056,18173.31055,19082.28906,26.52853371,-73.47146629,-246.7056827,-200.34179980000002,-0.015508547,3323800,1,-0.4215
BSESN,4/11/2013,18542.19922,18599.14063,18397.93945,18577.51953,8400,127.75,0.0,127.75,43.53761866,18173.31055,19082.28906,40.58277127,-59.41722873,-235.71217510000002,-207.4158748,-0.015585788,3332200,1,0.4019
BSESN,4/12/2013,18242.56055,18337.91016,18186.09961,18275.66016,9400,-299.63867200000004,299.63867200000004,0.0,32.73501142,18173.31055,19060.50977,7.805462236,-92.19453776,-248.3156495,-215.5958298,-0.03298159,3322800,-1,-0.7906
BSESN,4/15/2013,18357.80078,18424.40039,18144.2207,18196.08984,9200,115.24023400000002,0.0,115.24023400000002,39.40679589,18144.2207,19060.50977,23.30924668,-76.69075332,-246.1674054,-221.7101449,-0.035877856,3332000,1,0.0
BSESN,4/16/2013,18744.92969,18771.33008,18325.73047,18356.32031,9400,387.12890699999997,0.0,387.12890699999997,56.23336208,18144.2207,19060.50977,65.55889503,-34.44110497,-210.7969035,-219.5274966,-0.0030162759999999996,3341400,1,-0.5719
BSESN,4/17/2013,18731.16016,18869.88086,18673.43945,18773.44922,11000,-13.769532,13.769532,0.0,55.59970318,18144.2207,19060.50977,64.05614524,-35.94385476,-181.78115219999998,-211.9782277,0.011964589,3330400,-1,0.0
BSESN,4/18/2013,19016.46094,19058.80078,18691.60938,18695.33984,10000,285.30078199999997,0.0,285.30078199999997,65.02253616,18144.2207,19060.50977,95.19269303,-4.807306971,-134.2173968,-196.4260616,0.030689615,3340400,1,0.0
BSESN,4/22/2013,19169.83008,19204.90039,18989.7793,18989.7793,8600,153.36914,0.0,153.36914,69.09127354,18144.2207,19204.90039,96.69360002,-3.306399981,-83.18822811,-173.7784949,0.039703848,3349000,1,0.34
BSESN,4/23/2013,19179.35938,19210.25977,19042.08008,19210.25977,8400,9.529297,0.0,9.529297,69.34690626,18144.2207,19210.25977,97.10138286,-2.89861714,-41.49992431,-147.32278080000003,0.052279917999999995,3357400,1,0.4215
BSESN,4/25/2013,19406.84961,19434.84961,19192.10938,19192.10938,10200,227.490234,0.0,227.490234,75.03446623,18144.2207,19434.84961,97.83051504,-2.16948496,9.782154872000001,-115.9017936,0.053892483,3367600,1,-0.3612
BSESN,4/26/2013,19286.7207,19384.94922,19249.75,19376.0,9600,-120.128906,120.128906,0.0,67.41316599,18144.2207,19434.84961,88.52273451,-11.47726549,40.26601182,-84.66823254,0.040152814,3358000,-1,-0.4767
BSESN,4/29/2013,19387.5,19428.93945,19284.40039,19306.66992,9200,100.779297,0.0,100.779297,70.33028017,18144.2207,19434.84961,96.33127627,-3.668723735,71.72987771,-53.38861049,0.062761993,3367200,1,0.0
BSESN,4/30/2013,19504.17969,19622.67969,19317.38086,19492.83008,13400,116.67968799999998,0.0,116.67968799999998,73.49940095,18144.2207,19622.67969,91.98489771,-8.015102292,104.87140159999998,-21.73660808,0.062446418,3380600,1,0.0
BSESN,5/2/2013,19735.76953,19792.0,19451.25977,19459.33008,9400,231.58984300000003,0.0,231.58984300000003,78.70793287,18144.2207,19792.0,96.58749997,-3.41250003,148.1162707,12.23396767,0.052859086,3390000,1,-0.4767
BSESN,5/3/2013,19575.64063,19744.84961,19542.63086,19707.94922,11600,-160.128906,160.128906,0.0,68.03911228,18144.2207,19792.0,86.86963871,-13.13036129,167.53582780000002,43.29433970000001,0.045084259,3378400,-1,-0.29600000000000004
BSESN,5/6/2013,19673.64063,19694.28906,19554.31055,19571.66016,7800,98.0,0.0,98.0,70.83115104,18144.2207,19792.0,92.81703714,-7.182962865,188.6590042,72.36727259999999,0.034558464,3386200,1,0.2023
BSESN,5/7/2013,19888.94922,19917.88086,19697.33008,19697.33008,8200,215.308594,0.0,215.308594,76.11959088,18144.2207,19917.88086,98.36881717,-1.631182834,220.2341555,101.94064920000001,0.037513068,3394400,1,0.0
BSESN,5/8/2013,19990.17969,20037.26953,19851.2207,19950.2207,6200,101.230469,0.0,101.230469,78.25806617,18325.73047,20037.26953,97.2486843,-2.7513157039999996,250.538096,131.6601385,0.042275672,3400600,1,-0.2023
BSESN,5/9/2013,19939.03906,20058.48047,19903.83008,20015.85938,5800,-51.140625,51.140625,0.0,74.37570225,18673.43945,20058.48047,91.37632715,-8.623672846,267.3457705,158.7972649,0.027422764,3394800,-1,0.0
BSESN,5/10/2013,20082.61914,20119.14063,19908.80078,19911.08008,8000,143.58007800000001,0.0,143.58007800000001,77.92360247,18691.60938,20119.14063,97.44163331,-2.558366691,288.92118250000004,184.82204850000002,0.041266654,3402800,1,0.0
BSESN,5/13/2013,19691.66992,20109.08008,19667.39063,20073.41016,6600,-390.94921899999997,390.94921899999997,0.0,54.30200131,18989.7793,20119.14063,62.14934119,-37.85065881,271.3456139,202.1267615,0.015688971,3396200,-1,0.0
BSESN,5/14/2013,19722.28906,19831.78906,19652.68945,19715.80078,7200,30.619141,0.0,30.619141,55.52048825,19042.08008,20119.14063,63.15420121,-36.84579879,256.9258764,213.08658450000001,0.011182698999999999,3403400,1,-0.5423
BSESN,5/15/2013,20212.96094,20241.96094,19798.17969,19798.17969,9200,490.671875,0.0,490.671875,70.20848027,19192.10938,20241.96094,97.23770474,-2.7622952639999996,281.842347,226.837737,0.024179012000000003,3412600,1,0.0
BSESN,5/16/2013,20247.33008,20326.48047,20162.11914,20167.92969,9600,34.36914,0.0,34.36914,70.98290941,19249.75,20326.48047,92.64900611,-7.350993891,300.8936175,241.64891310000002,0.034312515,3422200,1,0.1027
BSESN,5/17/2013,20286.11914,20328.18945,20155.00977,20267.59961,8000,38.789063,0.0,38.789063,71.93301807,19284.40039,20328.18945,95.96946227,-4.030537733,315.4851237,256.4161552,0.031131936000000002,3430200,1,0.0
BSESN,5/20/2013,20223.98047,20443.61914,20186.66016,20277.75977,6800,-62.138672,62.138672,0.0,67.82787581,19317.38086,20443.61914,80.49802821,-19.50197179,318.3650123,268.8059266,0.016845096,3423400,-1,-0.29600000000000004
BSESN,5/21/2013,20111.60938,20308.03906,20072.67969,20227.16992,15600,-112.371094,112.371094,0.0,60.61036597,19451.25977,20443.61914,66.54339402,-33.45660598,308.02916810000005,276.6505749,0.006074466999999999,3407800,-1,-0.128
BSESN,5/22/2013,20062.24023,20220.34961,20000.85938,20150.68945,7600,-49.369141,49.369141,0.0,57.50824892,19542.63086,20443.61914,57.67104694,-42.32895306,292.4827015,279.8170002,0.006178891999999999,3400200,-1,0.0
BSESN,5/23/2013,19674.33008,20027.56055,19634.78906,19971.36914,15600,-387.91015600000003,387.91015600000003,0.0,39.28110976,19554.31055,20443.61914,13.49582494,-86.50417506,246.02488530000002,273.0585772,-0.020330469,3384600,-1,0.0
BSESN,5/24/2013,19704.33008,19833.14063,19568.49023,19765.32031,11000,30.0,0.0,30.0,40.95119071,19568.49023,20443.61914,15.52226682,-84.47773318,209.21577130000003,260.2900161,0.000642919,3395600,1,0.0772
BSESN,5/27/2013,20030.76953,20083.4707,19678.31055,19750.66992,8200,326.43945299999996,0.0,326.43945299999996,56.10853372,19568.49023,20443.61914,52.82413748,-47.17586252,204.0332507,249.03866299999999,0.01564121,3403800,1,0.4939
BSESN,5/28/2013,20160.82031,20209.82031,19963.23047,20056.2793,8600,130.050782,0.0,130.050782,60.74097266,19568.49023,20443.61914,67.68489468,-32.31510532,208.0221274,240.8353559,-0.002579564,3412400,1,-0.4767
BSESN,5/29/2013,20147.64063,20216.49023,20044.74023,20202.50977,8000,-13.179688,13.179688,0.0,60.00047385,19568.49023,20443.61914,66.17886649,-33.82113351,207.725322,234.2133491,-0.004923585,3404400,-1,-0.5574
BSESN,5/30/2013,20215.40039,20254.0293,20066.14063,20066.93945,9600,67.759766,0.0,67.759766,62.69813757,19568.49023,20443.61914,73.92169906,-26.07830094,210.5308795,229.47685519999996,-0.003486066,3414000,1,-0.6597
BSESN,5/31/2013,19760.30078,20191.28906,19730.55078,20186.66992,9400,-455.09961,455.09961,0.0,41.17684002,19568.49023,20443.61914,21.91797637,-78.08202363,174.02551119999998,218.3865864,-0.022927222,3404600,-1,-0.1027
BSESN,6/3/2013,19610.48047,19860.18945,19541.9707,19859.2207,7400,-149.820312,149.820312,0.0,36.42728662,19541.9707,20443.61914,7.598279231,-92.40172077,131.4897646,201.00722199999998,-0.024917395,3397200,-1,0.0
BSESN,6/4/2013,19545.7793,19742.69922,19522.4707,19605.67969,6000,-64.701172,64.701172,0.0,34.44737739,19522.4707,20443.61914,2.530384142,-97.46961586,91.50423124,179.10662390000002,-0.025742935,3391200,-1,0.4019
BSESN,6/5/2013,19568.2207,19604.42969,19441.34961,19532.41992,5600,22.441406,0.0,22.441406,35.84293814,19441.34961,20443.61914,12.6583808,-87.34161920000001,60.92394855,155.4700888,-0.00539329,3396800,1,-0.128
BSESN,6/6/2013,19519.49023,19635.36914,19395.32031,19503.67969,6600,-48.730469,48.730469,0.0,34.0278742,19395.32031,20443.61914,11.84489744,-88.15510256,32.38341674,130.8527544,-0.009380671,3390200,-1,-0.4404
BSESN,6/7/2013,19429.23047,19711.55078,19397.50977,19522.31055,7000,-90.259765,90.259765,0.0,30.70482711,19395.32031,20308.03906,3.715290828,-96.28470917,2.453350256,105.1728736,-0.030030751,3383200,-1,0.0
BSESN,6/10/2013,19441.07031,19585.75,19366.82031,19530.34961,6400,11.839844,0.0,11.839844,31.71415449,19366.82031,20254.0293,8.368941404,-91.63105859999999,-20.07960146,80.12237856,-0.035700432000000004,3389600,1,-0.2263
BSESN,6/11/2013,19143.0,19418.74023,19121.17969,19382.2207,14200,-298.070313,298.070313,0.0,22.28515849,19121.17969,20254.0293,1.926143755,-98.07385624,-61.28248488,51.84140587,-0.049863934000000006,3375400,-1,0.0
BSESN,6/12/2013,19041.13086,19143.24023,18969.08008,19103.96094,10800,-101.869141,101.869141,0.0,19.94657695,18969.08008,20254.0293,5.60728626,-94.39271374,-100.9918836,21.27474798,-0.058087869,3364600,-1,-0.29600000000000004
BSESN,6/13/2013,18827.16016,18914.13086,18765.5293,18897.49023,13200,-213.970703,213.970703,0.0,15.90218551,18765.5293,20254.0293,4.140467518,-95.85953248,-148.0212192,-12.58444545,-0.047222997,3351400,-1,-0.4215
BSESN,6/14/2013,19177.92969,19213.09961,18952.08984,18959.83008,10400,350.76953199999997,0.0,350.76953199999997,39.21507665,18765.5293,20254.0293,27.70577031,-72.29422969,-155.19909819999998,-41.10737599,-0.022057122999999998,3361800,1,-0.743
BSESN,6/17/2013,19325.86914,19344.2793,19084.67969,19249.90039,7000,147.93945300000001,0.0,147.93945300000001,46.44042221,18765.5293,20254.0293,37.64459819,-62.35540181,-147.252704,-62.33644159,-0.01125103,3368800,1,0.0
BSESN,6/18/2013,19223.2793,19383.60938,19191.36914,19329.16992,8600,-102.589844,102.589844,0.0,42.40704341,18765.5293,20254.0293,30.75243534,-69.24756466,-147.53260830000002,-79.37567493,-0.017627633,3360200,-1,-0.2263
BSESN,6/19/2013,19245.69922,19274.25977,19100.13086,19224.08984,10400,22.419922,0.0,22.419922,43.64131668,18765.5293,20191.28906,33.67817871,-66.32182129,-144.2821394,-92.35696783,-0.014026545,3370600,1,0.0
BSESN,6/20/2013,18719.28906,19069.19922,18687.18945,19069.19922,14200,-526.4101559999999,526.4101559999999,0.0,27.61053167,18687.18945,19860.18945,2.736539642,-97.26346036,-182.0840679,-110.3023878,-0.036539862,3356400,-1,-0.7783
BSESN,6/21/2013,18774.24023,18820.81055,18615.14063,18695.80078,14600,54.951170999999995,0.0,54.951170999999995,30.67765196,18615.14063,19742.69922,14.11009679,-85.88990321,-205.2423621,-129.2903827,-0.03430007,3371000,1,-0.2023
BSESN,6/24/2013,18540.89063,18714.06055,18467.16016,18714.06055,11200,-233.349609,233.349609,0.0,25.40375772,18467.16016,19711.55078,5.925026075,-94.07497393,-239.66216409999998,-151.364739,-0.03145324,3359800,-1,-0.1779
BSESN,6/25/2013,18629.15039,18802.31055,18487.30078,18602.25,10800,88.259766,0.0,88.259766,30.60983735,18467.16016,19711.55078,13.01763544,-86.98236456,-256.85738760000004,-172.4632687,-0.021636345,3370600,1,-0.8316
BSESN,6/26/2013,18552.11914,18690.5,18514.34961,18662.36914,9200,-77.03125,77.03125,0.0,28.59977922,18467.16016,19711.55078,6.8273565629999995,-93.17264344,-273.54722210000006,-192.6800594,-0.014608736,3361400,-1,-0.872
BSESN,6/27/2013,18875.94922,18925.75,18688.2793,18716.10938,10000,323.83007799999996,0.0,323.83007799999996,45.84848011,18467.16016,19585.75,36.54503616,-63.45496384,-257.67335719999994,-205.6787189,-0.01574625,3371400,1,0.0258
BSESN,6/28/2013,19395.81055,19432.93945,19093.17969,19093.17969,14000,519.8613280000001,0.0,519.8613280000001,62.58914504,18467.16016,19432.93945,96.15554959999999,-3.844450395,-200.8297006,-204.70891519999998,0.003619056,3385400,1,-0.29600000000000004
BSESN,7/1/2013,19577.39063,19598.42969,19347.57031,19352.48047,8600,181.58007800000001,0.0,181.58007800000001,66.73384633,18467.16016,19598.42969,98.14022544,-1.8597745630000002,-139.52039419999997,-191.671211,0.018420963999999998,3394000,1,-0.5267
BSESN,7/2/2013,19463.82031,19589.14063,19442.75,19573.92969,9200,-113.57031200000002,113.57031200000002,0.0,61.79323108,18467.16016,19598.42969,88.10103418,-11.89896582,-98.95580128,-173.1281291,0.011333498000000001,3384800,-1,0.4939
BSESN,7/3/2013,19177.75977,19347.10938,19147.31055,19347.10938,9600,-286.06054700000004,286.06054700000004,0.0,50.85163142,18467.16016,19598.42969,62.81435059,-37.18564941,-88.86636842,-156.2757769,0.024491886,3375200,-1,0.0
BSESN,7/4/2013,19410.83984,19445.01953,19245.00977,19256.11914,9600,233.080078,0.0,233.080078,57.86571091,18467.16016,19598.42969,83.41775866,-16.58224134,-61.35553739,-137.291729,0.033908142,3384800,1,0.0
BSESN,7/5/2013,19495.82031,19640.26953,19477.74023,19568.78906,10000,84.980469,0.0,84.980469,60.25208127,18467.16016,19640.26953,87.68663681,-12.31336319,-32.32319034,-116.2980213,0.051503982000000004,3394800,1,0.0
BSESN,7/8/2013,19324.76953,19422.68945,19185.91992,19418.98047,8400,-171.050782,171.050782,0.0,53.247883900000005,18467.16016,19640.26953,73.10566204,-26.89433796,-22.85377067,-97.60917117,0.037340358,3386400,-1,0.0
BSESN,7/9/2013,19439.48047,19486.0,19380.25,19399.36914,6600,114.71093799999998,0.0,114.71093799999998,57.10628732,18467.16016,19640.26953,82.88402887,-17.11597113,-6.02353774,-79.29204448,0.047830726,3393000,1,0.0
BSESN,7/10/2013,19294.11914,19505.92969,19237.91016,19482.66016,7800,-145.36132800000001,145.36132800000001,0.0,50.95728572,18467.16016,19640.26953,70.49291418,-29.50708582,-4.364588962,-64.30655338,0.022153584,3385200,-1,0.0
BSESN,7/11/2013,19676.06055,19723.50977,19468.46094,19468.46094,8400,381.94140600000003,0.0,381.94140600000003,63.02708693,18467.16016,19723.50977,96.22324721,-3.7767527939999996,27.45315645,-45.95461141,0.014448997,3393600,1,-0.4215
BSESN,7/12/2013,19958.4707,19991.93945,19785.58984,19898.68945,7600,282.41015600000003,0.0,282.41015600000003,69.44311400000001,18487.30078,19991.93945,97.77562875,-2.224371248,74.59717847,-21.84425344,0.019465315,3401200,1,0.4588
BSESN,7/15/2013,20034.48047,20072.43945,19883.18945,19926.09961,7000,76.009766,0.0,76.009766,71.00565974,18514.34961,20072.43945,97.56374871,-2.436251295,116.7467249,5.873942223999999,0.029319021,3408200,1,0.29600000000000004
BSESN,7/16/2013,19851.23047,19890.63086,19649.58008,19788.08984,8000,-183.25,183.25,0.0,62.16308569,18688.2793,20072.43945,84.01854128,-15.98145872,133.8211931,31.46339241,0.035117277,3400200,-1,0.0
BSESN,7/17/2013,19948.73047,19983.2207,19778.53906,19928.94922,10400,97.5,0.0,97.5,64.85037816,19093.17969,20072.43945,87.36709212,-12.63290788,153.45137549999998,55.86098902,0.027710837000000002,3410600,1,-0.2023
BSESN,7/18/2013,20128.41016,20176.90039,19956.19922,19999.50977,9800,179.679687,0.0,179.679687,69.46226201,19147.31055,20176.90039,95.29033476,-4.70966524,181.41583669999997,80.97195856,0.03244746,3420400,1,-0.7506
BSESN,7/19/2013,20149.84961,20256.59961,20111.13086,20213.44922,11600,21.439453,0.0,21.439453,70.00411566,19147.31055,20256.59961,90.37671932,-9.623280681,202.9681676,105.37120039999999,0.042695468,3432000,1,0.0
BSESN,7/22/2013,20159.11914,20264.90039,20065.68945,20096.71094,9400,9.269532,0.0,9.269532,70.26730688,19147.31055,20264.90039,90.53487729999999,-9.465122698,218.2803193,127.9530242,0.03701944,3441400,1,0.0
BSESN,7/23/2013,20302.13086,20351.06055,20249.98047,20249.98047,7800,143.011718,0.0,143.011718,74.28404971,19185.91992,20351.06055,95.80053369,-4.199466309,239.19783650000002,150.2019866,0.052244505999999996,3449200,1,-0.1027
BSESN,7/24/2013,20090.67969,20252.69922,19994.25,20200.19922,8000,-211.451171,211.451171,0.0,60.37016191,19185.91992,20351.06055,77.65240921,-22.34759079,235.9924037,167.36007,0.021072264,3441200,-1,0.7063
BSESN,7/25/2013,19804.75977,20110.81055,19763.90039,20062.0,12800,-285.91992200000004,285.91992200000004,0.0,46.71756294,19185.91992,20351.06055,53.11288876,-46.88711124,207.9832258,175.4847012,-0.007701539,3428400,-1,0.4939
BSESN,7/26/2013,19748.18945,19907.44922,19699.75977,19892.4707,11000,-56.570313,56.570313,0.0,44.42403986,19237.91016,20351.06055,45.84100236,-54.15899764,179.1558025,176.21892150000002,-0.014289915,3417400,-1,-0.5574
BSESN,7/29/2013,19593.2793,19751.0293,19570.86914,19714.41992,9900,-154.910156,154.910156,0.0,38.45844362,19237.91016,20351.06055,31.92462976,-68.07537024,142.17104750000001,169.4093467,-0.012994216000000001,3407500,-1,-0.5106
BSESN,7/30/2013,19348.33984,19672.7207,19328.53906,19577.75,9500,-244.939453,244.939453,0.0,30.89036542,19328.53906,20351.06055,1.936466012,-98.06353399,92.03487518,153.9344524,-0.030096683,3398000,-1,-0.1027
BSESN,7/31/2013,19345.69922,19387.5,19126.82031,19304.07031,13900,-2.640625,2.640625,0.0,30.81493421,19126.82031,20351.06055,17.87875451,-82.12124549,51.49491964,133.4465458,-0.03888588,3384100,-1,-0.0258
BSESN,8/1/2013,19317.18945,19569.19922,19170.46094,19443.28906,10600,-28.509766,28.509766,0.0,29.90521014,19126.82031,20351.06055,15.54998232,-84.45001768,16.871726199999998,110.13158190000001,-0.041323393,3373500,-1,0.0
BSESN,8/2/2013,19164.01953,19451.69922,19078.7207,19399.55078,8600,-153.16992199999999,153.16992199999999,0.0,25.27890347,19078.7207,20351.06055,6.704091552,-93.29590845,-22.66566104,83.57213332,-0.049362257,3364900,-1,-0.128
BSESN,8/5/2013,19182.25977,19306.50977,19141.67969,19178.06055,12000,18.240235000000002,0.0,18.240235000000002,26.83415556,19078.7207,20351.06055,8.137689273,-91.86231073,-51.92888686,56.47192928,-0.055160274,3376900,1,0.0
BSESN,8/6/2013,18733.03906,19131.91992,18667.30078,19127.09961,13800,-449.220703,449.220703,0.0,16.86120874,18667.30078,20351.06055,3.904255425,-96.09574458,-110.09940320000001,23.15766278,-0.067575644,3363100,-1,0.0
BSESN,8/7/2013,18664.88086,18811.46094,18551.34961,18758.5293,12800,-68.158204,68.158204,0.0,15.8311671,18551.34961,20351.06055,6.308304717,-93.69169528,-159.8570217,-13.44527412,-0.057555805999999994,3350300,-1,-0.4404
BSESN,8/8/2013,18789.33984,18829.25977,18621.66992,18687.30078,11900,124.45898500000001,0.0,124.45898500000001,25.42936978,18551.34961,20351.06055,13.22380333,-86.77619667,-187.0908263,-48.17438456,-0.048553797999999995,3362200,1,-0.3818
BSESN,8/12/2013,18946.98047,19066.9707,18796.00977,18898.93945,11700,157.640625,0.0,157.640625,36.08188934,18551.34961,20351.06055,21.98302248,-78.01697752,-193.720443,-77.28359626,-0.032985741,3373900,1,0.128
BSESN,8/13/2013,19229.83984,19248.10938,18864.81055,18895.25977,11900,282.859375,0.0,282.859375,50.67121664,18551.34961,20252.69922,39.8795304,-60.1204696,-174.14266619999998,-96.65541025,-0.006124556,3385800,1,-0.4939
BSESN,8/14/2013,19367.58984,19392.56055,19203.63086,19299.41992,14700,137.75,0.0,137.75,56.278761200000005,18551.34961,20110.81055,52.34117862,-47.65882138,-145.8308163,-106.4904915,0.00113155,3400500,1,0.0
BSESN,8/16/2013,18598.17969,19310.94922,18559.65039,19297.10938,14300,-769.4101559999999,769.4101559999999,0.0,32.48163781,18551.34961,19907.44922,3.453291975,-96.54670803,-183.3647263,-121.86533840000001,-0.037221241,3386200,-1,0.0
BSESN,8/19/2013,18307.51953,18587.38086,18139.15039,18587.38086,14300,-290.66015699999997,290.66015699999997,0.0,27.42657057,18139.15039,19751.0293,10.4455204,-89.5544796,-233.86857450000002,-144.2659856,-0.044693129000000005,3371900,-1,0.0
BSESN,8/20/2013,18246.03906,18306.46094,17970.98047,18142.83008,18200,-61.480468,61.480468,0.0,26.42294926,17970.98047,19672.7207,16.16337138,-83.83662862,-275.6763724,-170.54806299999998,-0.048806590999999996,3353700,-1,-0.0516
BSESN,8/21/2013,17905.91016,18567.69922,17807.18945,18545.43945,17400,-340.12890699999997,340.12890699999997,0.0,21.41957021,17807.18945,19569.19922,5.602733021000001,-94.39726698,-332.42294889999994,-202.92304019999997,-0.044153482,3336300,-1,-0.5267
BSESN,8/22/2013,18312.93945,18349.82031,17759.58984,17896.83984,19800,407.02929700000004,0.0,407.02929700000004,37.70696547,17759.58984,19569.19922,30.57840088,-69.42159912,-340.624648,-230.4633617,-0.018855808,3356100,1,0.0
BSESN,8/23/2013,18519.43945,18546.59961,18210.75,18386.5293,19200,206.5,0.0,206.5,44.44734497,17759.58984,19451.69922,44.90546653,-55.09453347,-326.6957839,-249.7098462,-0.014364548999999999,3375300,1,0.0
BSESN,8/26/2013,18558.13086,18728.18945,18488.92969,18602.56055,17200,38.691406,0.0,38.691406,45.71718664,17759.58984,19392.56055,48.90112318,-51.09887682,-308.97333330000004,-261.56254359999997,-0.020523039,3392500,1,-0.25
BSESN,8/27/2013,17968.08008,18460.7207,17921.82031,18460.7207,17800,-590.0507809999999,590.0507809999999,0.0,32.60335013,17759.58984,19392.56055,12.76754284,-87.23245716,-338.63673680000005,-276.97738219999997,-0.06561467900000001,3374700,-1,0.3818
BSESN,8/28/2013,17996.15039,18101.83984,17448.71094,17851.43945,21400,28.070313,0.0,28.070313,33.64809308,17448.71094,19392.56055,28.162644399999994,-71.8373556,-355.7789598,-292.73769780000003,-0.070811054,3396100,1,0.0
BSESN,8/29/2013,18401.03906,18455.66016,18071.2207,18073.66016,18600,404.88867200000004,0.0,404.88867200000004,47.25572977,17448.71094,19392.56055,48.99186236,-51.00813764,-332.8562038,-300.76139900000004,-0.010599996,3414700,1,0.0
BSESN,8/30/2013,18619.7207,18679.25977,18272.75977,18424.7207,18600,218.68164,0.0,218.68164,53.23288432,17448.71094,19392.56055,60.24178823,-39.75821177,-293.6588573,-299.3408906,0.017053166,3433300,1,0.0
BSESN,9/2/2013,18886.13086,18942.06055,18678.92969,18691.83008,10800,266.41015600000003,0.0,266.41015600000003,59.65904696,17448.71094,19392.56055,73.94707463,-26.05292537,-238.3500536,-287.1427232,0.035081137000000005,3444100,1,-0.29600000000000004
BSESN,9/3/2013,18234.66016,19007.31055,18166.16992,19002.76953,19400,-651.4707030000001,651.4707030000001,0.0,42.99111121,17448.71094,19392.56055,40.43261446,-59.56738554,-244.26987830000002,-278.5681542,0.01835986,3424700,-1,0.34
BSESN,9/4/2013,18567.55078,18612.59961,18188.42969,18314.67969,14400,332.890625,0.0,332.890625,51.05378679,17448.71094,19310.94922,60.08038039,-39.91961961,-219.5688377,-266.7682909,0.013903357,3439100,1,0.0
BSESN,9/5/2013,18979.75977,19117.51953,18847.01953,18857.59961,13800,412.208985,0.0,412.208985,59.28170538,17448.71094,19117.51953,91.74502303,-8.254976968,-164.8311937,-246.38087149999998,0.024856061000000002,3452900,1,0.0
BSESN,9/6/2013,19270.06055,19293.96094,18929.38086,19072.01953,15600,290.30078100000003,0.0,290.30078100000003,64.17534082,17448.71094,19293.96094,98.70476136,-1.29523864,-96.90925983,-216.4865492,0.038362144,3468500,1,-0.6705
BSESN,9/10/2013,19997.09961,20012.68945,19444.66016,19448.39063,17800,727.0390620000001,0.0,727.0390620000001,73.40995179,17448.71094,20012.68945,99.39196667,-0.608033332,15.40772756,-170.10769380000002,0.11292355800000001,3486300,1,-0.3182
BSESN,9/11/2013,19997.44922,20055.5293,19777.63086,19999.76953,15700,0.34961,0.0,0.34961,73.41375428,17448.71094,20055.5293,97.77199367,-2.228006328,103.25766970000001,-115.43462109999999,0.11120705199999999,3502000,1,0.34
BSESN,9/12/2013,19781.88086,20052.05078,19676.49023,20046.05078,11900,-215.56836,215.56836,0.0,66.63429126,17448.71094,20055.5293,89.50258897,-10.49741103,153.71291000000002,-61.60511488,0.075041512,3490100,-1,0.0
BSESN,9/13/2013,19732.75977,19899.36914,19675.67969,19744.53906,10600,-49.121093,49.121093,0.0,65.05476133,17448.71094,20055.5293,87.61825772,-12.38174228,187.57316310000002,-11.76945928,0.059777431,3479500,-1,-0.6908
BSESN,9/16/2013,19742.4707,20086.42969,19596.15039,19977.38086,11200,9.710937,0.0,9.710937,65.24270042,17448.71094,20086.42969,86.95998256,-13.04001744,212.73892719999998,33.13221801,0.045342259,3490700,1,0.1901
BSESN,9/17/2013,19804.0293,19819.09961,19635.43945,19721.90039,9900,61.55859399999999,0.0,61.55859399999999,66.55821023,17448.71094,20086.42969,89.29376413,-10.70623587,234.94197569999997,73.49416954,0.086065171,3500600,1,0.0
BSESN,9/18/2013,19962.16016,20013.33008,19775.28906,19865.99023,9300,158.13085900000002,0.0,158.13085900000002,69.93137445,18071.2207,20086.42969,93.83341713,-6.166582867000001,262.2745526,111.2502462,0.075110034,3509900,1,-0.4767
BSESN,9/19/2013,20646.64063,20739.68945,20347.30078,20354.73047,18300,684.4804690000001,0.0,684.4804690000001,80.00462849,18166.16992,20739.68945,96.38437452,-3.6156254839999997,335.30251150000004,156.0606992,0.087824128,3528200,1,0.0
BSESN,9/20/2013,20263.71094,20677.99023,20051.42969,20616.34961,13500,-382.929687,382.929687,0.0,65.77959525,18166.16992,20739.68945,81.50476384,-18.49523616,358.14994,196.47854740000002,0.051564465999999996,3514700,-1,-0.1027
BSESN,9/23/2013,19900.96094,20199.81055,19826.30078,20060.82031,11100,-362.75,362.75,0.0,55.07585181,18166.16992,20739.68945,67.40928115,-32.59071885,343.0315443,225.78914680000003,-0.004807631,3503600,-1,0.2023
BSESN,9/24/2013,19920.21094,20050.41992,19782.7793,19820.0293,10700,19.25,0.0,19.25,55.5190417,18188.42969,20739.68945,67.87945601,-32.12054399,328.8130685,246.39393109999997,-0.003862407,3514300,1,0.0
BSESN,9/25/2013,19856.24023,19978.49023,19658.74023,19947.42969,13900,-63.970704000000005,63.970704000000005,0.0,53.49543987,18847.01953,20739.68945,53.32259425,-46.67740575,308.8230034,258.8797456,0.003758964,3500400,-1,0.0
BSESN,9/26/2013,19893.84961,19997.2793,19826.99023,19853.66016,14900,37.609375,0.0,37.609375,54.61754609,18929.38086,20739.68945,53.27648298,-46.72351702,292.64209910000005,265.63221630000004,0.008163574,3515300,1,-0.3724
BSESN,9/27/2013,19727.26953,19981.57031,19674.38086,19951.73047,11800,-166.58007800000001,166.58007800000001,0.0,48.62178672,19444.66016,20739.68945,21.82262406,-78.17737594,263.3413605,265.1740451,-0.0007699730000000001,3503500,-1,0.0
BSESN,9/30/2013,19379.76953,19651.31055,19320.73047,19643.89063,10000,-347.5,347.5,0.0,38.45942864,19320.73047,20739.68945,4.160730695,-95.8392693,209.66310249999998,254.07185660000002,-0.021422901,3493500,-1,0.0
BSESN,10/1/2013,19517.15039,19532.91016,19264.7207,19452.05078,9200,137.38086,0.0,137.38086,43.81609761,19264.7207,20739.68945,17.11423974,-82.88576026,176.177321,238.4929495,-0.022292666000000003,3502700,1,0.0
BSESN,10/3/2013,19902.07031,19929.24023,19583.9707,19585.78906,15700,384.91992200000004,0.0,384.91992200000004,56.15431038,19264.7207,20739.68945,43.21105854,-56.78894146,178.6401661,226.52239280000003,-0.03606254,3518400,1,0.2484
BSESN,10/4/2013,19915.94922,20052.0,19833.16992,19870.0,12900,13.878906,0.0,13.878906,56.5512735,19264.7207,20739.68945,44.15202125,-55.84797875,179.6411095,217.1461361,-0.017161798,3531300,1,-0.3182
BSESN,10/7/2013,19895.09961,19921.38086,19647.88086,19880.93945,12300,-20.849610000000002,20.849610000000002,0.0,55.67751046,19264.7207,20739.68945,42.73845842,-57.26154158,176.71491540000002,209.059892,-0.000294525,3519000,-1,0.0
BSESN,10/8/2013,19983.60938,20150.26953,19936.7207,20094.21094,10900,88.509766,0.0,88.509766,58.79591676,19264.7207,20739.68945,48.73924766,-51.26075234,179.4690762,203.1417288,0.0031826190000000002,3529900,1,-0.7579
BSESN,10/9/2013,20249.25977,20277.74023,19826.96094,19918.19922,10200,265.650391,0.0,265.650391,66.86856417,19264.7207,20739.68945,66.74982524,-33.25017476,200.773147,202.6680125,0.01979325,3540100,1,0.0
BSESN,10/10/2013,20272.91016,20323.76953,20135.91016,20228.75977,10400,23.650389999999998,0.0,23.650389999999998,67.52220329999999,19264.7207,20677.99023,71.33737981,-28.66262019,217.0629983,205.5470097,0.019054158,3550500,1,0.0
BSESN,10/11/2013,20528.58984,20559.68945,20368.06055,20535.90039,11700,255.679688,0.0,255.679688,73.9363495,19264.7207,20559.68945,97.59842784,-2.401572161,247.74815040000001,213.9872378,0.04061993,3562200,1,0.0
BSESN,10/14/2013,20607.53906,20645.93945,20497.88086,20534.60938,8900,78.949219,0.0,78.949219,75.64973654,19264.7207,20645.93945,97.21981837,-2.780181633,275.2638266,226.24255559999997,0.06335315400000001,3571100,1,-0.7003
BSESN,10/15/2013,20547.61914,20759.58008,20446.73047,20722.90039,13600,-59.919922,59.919922,0.0,71.53170096,19264.7207,20759.58008,85.82067715,-14.17932285,288.9048461,238.77501370000002,0.052798115,3557500,-1,0.0
BSESN,10/17/2013,20415.50977,20629.80078,20375.41992,20579.56055,10300,-132.109375,132.109375,0.0,62.83077635,19264.7207,20759.58008,76.98309836,-23.01690164,285.761252,248.1722613,0.025798294,3547200,-1,-0.5423
BSESN,10/18/2013,20882.89063,20932.23047,20486.7793,20486.7793,15700,467.380859,0.0,467.380859,75.16318576,19264.7207,20932.23047,97.04110614,-2.958893855,317.32572680000004,262.0029544,0.048551107999999996,3562900,1,0.0
BSESN,10/21/2013,20893.89063,20970.91992,20768.99023,20915.75977,12200,11.0,0.0,11.0,75.38497192,19264.7207,20970.91992,95.48532808,-4.514671918,339.31697379999997,277.4657583,0.050202866,3575100,1,0.0
BSESN,10/22/2013,20864.9707,20948.91016,20810.25,20863.15039,10700,-28.919921999999996,28.919921999999996,0.0,73.39673721,19264.7207,20970.91992,93.79033715,-6.209662847000001,350.3727207,292.0471508,0.044104211,3564400,-1,-0.5106
BSESN,10/23/2013,20767.88086,20922.32031,20589.7207,20875.31055,11200,-97.089844,97.089844,0.0,66.59316321,19583.9707,20970.91992,85.36074283,-14.63925717,347.2967205,303.0970647,0.025611854,3553200,-1,0.4019
BSESN,10/24/2013,20725.42969,21039.41992,20656.69922,20766.05078,8200,-42.451171,42.451171,0.0,63.618043500000006,19647.88086,21039.41992,77.43575855,-22.56424145,337.5425332,309.98615839999997,0.02232139,3545000,-1,0.0
BSESN,10/25/2013,20683.51953,20782.16016,20622.55078,20725.51953,9600,-41.910157,41.910157,0.0,60.53716616,19647.88086,21039.41992,74.42397411,-25.57602589,322.7104647,312.53101969999994,0.00754702,3535400,-1,0.34
BSESN,10/28/2013,20570.2793,20771.35938,20550.64063,20696.50977,8100,-113.24023400000002,113.24023400000002,0.0,52.59612853,19826.96094,21039.41992,61.30668079,-38.69331921,298.3788771,309.7005912,-0.001808065,3527300,-1,0.0258
BSESN,10/29/2013,20929.00977,20952.55078,20493.66016,20593.49023,11300,358.73046899999997,0.0,358.73046899999997,67.95910152,19826.96094,21039.41992,90.89369971,-9.106300292,304.532014,308.6668757,0.018561305,3538600,1,-0.4215
BSESN,10/30/2013,21033.9707,21086.58984,20937.11914,20944.14063,10400,104.96093700000002,0.0,104.96093700000002,71.11905176,20135.91016,21086.58984,94.46510306,-5.534896944,314.25534960000005,309.78457050000003,0.030293681,3549000,1,0.0
BSESN,10/31/2013,21164.51953,21205.43945,20991.98047,21000.59961,11900,130.54882800000001,0.0,130.54882800000001,74.69993658,20368.06055,21205.43945,95.11333259999999,-4.886667398,328.7062416,313.56890469999996,0.013486106999999999,3560900,1,-0.8074
BSESN,11/1/2013,21196.81055,21293.88086,21141.32031,21158.81055,10000,32.291016,0.0,32.291016,75.56461521,20375.41992,21293.88086,89.43119864,-10.56880136,338.85814700000003,318.62675319999994,0.014498013999999998,3570900,1,-0.34
BSESN,11/5/2013,20974.78906,21158.56055,20951.71094,21134.09961,11900,-222.021484,222.021484,0.0,59.44631464,20375.41992,21293.88086,65.25798941,-34.74201059,325.2391722,319.94923700000004,0.0052632880000000005,3559000,-1,-0.6908
BSESN,11/6/2013,20894.93945,21045.38086,20861.41992,21004.53906,10900,-79.84961,79.84961,0.0,54.61220812,20375.41992,21293.88086,56.56414008,-43.43585992,304.4928364,316.8579569,0.0061180340000000005,3548100,-1,0.0
BSESN,11/7/2013,20822.76953,21142.84961,20797.06055,20896.13086,11900,-72.169922,72.169922,0.0,50.34286961,20486.7793,21293.88086,41.62923848,-58.37076152,279.0114362,309.2886527,0.0046966379999999995,3536200,-1,0.0772
BSESN,11/8/2013,20666.15039,20821.00977,20600.90039,20785.19922,10700,-156.61914,156.61914,0.0,42.10141211,20493.66016,21293.88086,21.55533272,-78.44466728,243.37392409999998,296.105707,-0.000839757,3525500,-1,0.4404
BSESN,11/11/2013,20490.96094,20672.5293,20453.15039,20596.40039,10300,-175.18945300000001,175.18945300000001,0.0,34.7575259,20453.15039,21293.88086,4.497344683,-95.50265532,198.7040774,276.6253811,-0.0038559690000000003,3515200,-1,0.34
BSESN,11/12/2013,20281.91016,20584.2207,20262.2207,20510.31055,10200,-209.050782,209.050782,0.0,28.02639218,20262.2207,21293.88086,1.90852122,-98.09147878,144.76548459999998,250.2534018,-0.030918788,3505000,-1,0.0
BSESN,11/13/2013,20194.40039,20365.58984,20161.64063,20248.51953,9000,-87.509765,87.509765,0.0,25.62907791,20161.64063,21293.88086,2.893358231,-97.10664177,93.87531833,218.97778509999998,-0.03991497,3496000,-1,0.0
BSESN,11/14/2013,20399.41992,20568.99023,20348.26953,20351.39063,12600,205.019531,0.0,205.019531,39.59624528,20161.64063,21293.88086,21.00078145,-78.99921855,69.28913562,189.04005519999998,-0.036150105,3508600,1,-0.29600000000000004
BSESN,11/18/2013,20850.74023,20868.75977,20570.58984,20570.58984,10900,451.320312,0.0,451.320312,59.10449473,20161.64063,21293.88086,60.86160766,-39.13839234,85.23959701,168.2799636,-0.016326528,3519500,1,0.0
BSESN,11/19/2013,20890.82031,20934.40039,20828.68945,20870.16016,11400,40.080079,0.0,40.080079,60.41452643,20161.64063,21293.88086,64.40149944,-35.59850056,99.96227708,154.6164263,-0.004003318,3530900,1,0.3612
BSESN,11/20/2013,20635.13086,20895.30078,20579.93945,20857.00977,8900,-255.689454,255.689454,0.0,48.88709362,20161.64063,21293.88086,41.81888435,-58.18111565,89.96108962,141.6853589,-0.012434043999999998,3522000,-1,0.0
BSESN,11/21/2013,20229.05078,20579.25977,20189.23047,20579.25977,8100,-406.08007799999996,406.08007799999996,0.0,36.22195633,20161.64063,21293.88086,5.953697279,-94.04630272,48.70635146,123.0895574,-0.028512957999999998,3513900,-1,0.0
BSESN,11/22/2013,20217.39063,20388.11914,20137.66992,20316.58008,10600,-11.660156,11.660156,0.0,35.91369689,20137.66992,21293.88086,6.894996445,-93.10500356,14.89905012,101.45145600000001,-0.021714725,3503300,-1,0.0
BSESN,11/25/2013,20605.08008,20626.15039,20326.66016,20326.66016,8200,387.68945299999996,0.0,387.68945299999996,51.68736597,20137.66992,21158.56055,45.78454778,-54.21545222,19.16885245,84.99493527,0.005569243000000001,3511500,1,0.0
BSESN,11/26/2013,20425.01953,20604.26953,20390.61914,20604.26953,10500,-180.06054699999999,180.06054699999999,0.0,45.66418757,20137.66992,21142.84961,28.58688976,-71.41311024,7.93188639,69.58232549,0.007056011,3501000,-1,-0.4404
BSESN,11/27/2013,20420.25977,20482.66992,20348.06055,20449.0,7000,-4.759765,4.759765,0.0,45.5024574,20137.66992,21142.84961,28.11336596,-71.88663404,-1.342092617,55.39744187,0.011184258,3494000,-1,-0.8271
BSESN,11/28/2013,20534.91016,20606.38086,20461.50977,20522.35938,9000,114.65038999999999,0.0,114.65038999999999,50.38623023,20137.66992,20934.40039,49.85879786,-50.14120214,0.553163975,44.42858629,0.006641866999999999,3503000,1,0.4767
BSESN,11/29/2013,20791.92969,20819.76953,20558.92969,20558.92969,11200,257.01953199999997,0.0,257.01953199999997,59.72260729,20137.66992,20934.40039,82.11808026,-17.88191974,22.53473036,40.04981511,-0.00282055,3514200,1,0.0
BSESN,12/2/2013,20898.00977,20941.0,20770.50977,20771.26953,9600,106.080078,0.0,106.080078,63.03528459,20137.66992,20941.0,94.6484969,-5.351503097,47.96217771,41.63228763,0.000344144,3523800,1,0.4019
BSESN,12/3/2013,20854.91992,20927.05078,20817.75,20857.84961,12000,-43.089844,43.089844,0.0,60.69556538,20137.66992,20941.0,89.28459417,-10.71540583,63.90002295,46.08583469,0.010651208,3511800,-1,-0.8126
BSESN,12/4/2013,20708.71094,20863.36914,20673.61914,20839.44922,12200,-146.20898400000002,146.20898400000002,0.0,52.99439075,20137.66992,20941.0,71.08423195,-28.91576805,63.99533861,49.66773548,0.023711452,3499600,-1,0.0
BSESN,12/5/2013,20957.81055,21165.59961,20929.19922,20992.25,11900,249.099609,0.0,249.099609,62.37832629,20137.66992,21165.59961,79.78567361,-20.21432639,83.21191839,56.37657206,0.036622922,3511500,1,0.0772
BSESN,12/6/2013,20996.5293,21049.83984,20922.44922,20955.74023,10100,38.71875,0.0,38.71875,63.67877147,20137.66992,21165.59961,83.55234661,-16.44765339,100.4080345,65.18286456,0.018997704,3521600,1,-0.25
BSESN,12/9/2013,21326.41992,21483.74023,21282.64063,21416.66992,13400,329.890625,0.0,329.890625,72.89098865,20137.66992,21483.74023,88.312623,-11.687377,139.0525853,79.95680870000001,0.044132168,3535000,1,0.128
BSESN,12/10/2013,21255.25977,21327.75,21175.08008,21293.58008,17300,-71.160156,71.160156,0.0,68.56279225,20137.66992,21483.74023,83.02611194,-16.97388806,162.06841640000002,96.37913024,0.040890763,3517700,-1,-0.1531
BSESN,12/11/2013,21171.41016,21215.93945,21069.44922,21191.26953,10600,-83.84961,83.84961,0.0,63.44107375,20137.66992,21483.74023,76.79689722,-23.20310278,171.5649715,111.41629850000001,0.030995996,3507100,-1,-0.3818
BSESN,12/12/2013,20925.60938,21103.80078,20901.4707,21101.05078,9100,-245.800781,245.800781,0.0,50.64459618,20326.66016,21483.74023,51.76385199,-48.23614801,157.44209650000002,120.6214581,0.006429403,3498000,-1,0.0
BSESN,12/13/2013,20715.58008,20867.16992,20692.66992,20867.16992,9500,-210.029297,210.029297,0.0,42.24368751,20348.06055,21483.74023,32.36119614,-67.63880386,127.82848020000002,122.0628625,-0.008729524,3488500,-1,0.0
BSESN,12/16/2013,20659.51953,20764.51953,20637.76953,20714.25977,10300,-56.060547,56.060547,0.0,40.19044015,20348.06055,21483.74023,27.42489696,-72.57510304,98.69812774,117.3899156,-0.00936951,3478200,-1,-0.5859
BSESN,12/17/2013,20612.14063,20784.0293,20594.99023,20732.43945,8300,-47.378906,47.378906,0.0,38.37171823,20461.50977,21483.74023,14.73550865,-85.26449135,70.97092316,108.10611709999999,-0.00466327,3469900,-1,-0.4767
BSESN,12/18/2013,20859.85938,20917.57031,20568.69922,20568.69922,8400,247.71875,0.0,247.71875,51.58821594,20558.92969,21483.74023,32.53960374,-67.46039626,68.19958426,100.1248105,-0.0046737309999999995,3478300,1,0.0
BSESN,12/19/2013,20708.61914,21017.44922,20646.0293,20959.80078,10300,-151.24023400000002,151.24023400000002,0.0,44.81742244,20568.69922,21483.74023,15.29110933,-84.70889067,53.1863561,90.73711963,-0.013712273999999998,3468000,-1,-0.5267
BSESN,12/20/2013,21079.7207,21117.99023,20745.93945,20792.36914,9100,371.101562,0.0,371.101562,59.76739916,20568.69922,21483.74023,55.84683917,-44.15316083,70.42128649,86.673953,-0.011567775,3477100,1,0.0
BSESN,12/23/2013,21101.0293,21207.89063,21059.11914,21080.53906,6700,21.308594,0.0,21.308594,60.47681421,20568.69922,21483.74023,58.17554287,-41.82445713,84.82174615,86.30351163,-0.007256108000000001,3483800,1,0.0
BSESN,12/24/2013,21032.71094,21156.91992,21010.65039,21127.66016,5800,-68.318359,68.318359,0.0,56.77343649,20568.69922,21483.74023,50.70939022,-49.29060978,89.6876304,86.98033539,-0.006551251,3478000,-1,0.0
BSESN,12/26/2013,21074.58984,21135.84961,21013.14063,21051.0,7300,41.878906,0.0,41.878906,58.56796823,20568.69922,21483.74023,55.28611469,-44.71388531,95.81861905,88.74799212,0.007119528000000001,3485300,1,0.0
BSESN,12/27/2013,21193.58008,21235.14063,21113.25,21114.49023,5500,118.99023400000002,0.0,118.99023400000002,63.53141374,20568.69922,21483.74023,68.28992895,-31.71007105,109.0222485,92.80284341,0.02307442,3490800,1,0.0
BSESN,12/30/2013,21143.00977,21304.69922,21089.21094,21260.15039,6100,-50.570312,50.570312,0.0,60.00627728,20568.69922,21327.75,75.66167658,-24.33832342,114.09045479999999,97.06036568,0.023402782,3484700,-1,0.0
BSESN,12/31/2013,21170.67969,21230.88086,21122.67969,21177.76953,5000,27.669921999999996,0.0,27.669921999999996,61.35986455,20568.69922,21304.69922,81.79082459,-18.20917541,118.9683827,101.4419691,0.027097577,3489700,1,-0.4019
BSESN,1/1/2014,21140.48047,21244.34961,21133.82031,21222.18945,4000,-30.199219,30.199219,0.0,58.85151664,20568.69922,21304.69922,77.68766984,-22.31233016,119.02530159999998,104.9586356,0.013452684,3485700,-1,-0.0762
BSESN,1/2/2014,20888.33008,21331.32031,20846.66992,21179.91016,9300,-252.150391,252.150391,0.0,42.22270331,20568.69922,21331.32031,41.91214504,-58.08785496,97.59892131,103.4866927,0.008678074000000001,3476400,-1,0.0
BSESN,1/3/2014,20851.33008,20885.17969,20731.33008,20819.58008,9300,-37.0,37.0,0.0,40.29498073,20568.69922,21331.32031,37.06045653,-62.93954347,76.74806589,98.13896736,-0.010834613,3467100,-1,0.0
BSESN,1/6/2014,20787.30078,20913.78906,20721.98047,20913.78906,7600,-64.029297,64.029297,0.0,36.92843641,20568.69922,21331.32031,28.66450505,-71.33549495,54.42955358,89.39708459999999,-0.014867925,3459500,-1,-0.0258
BSESN,1/7/2014,20693.24023,20890.48047,20637.17969,20845.76953,8100,-94.060547,94.060547,0.0,32.347532199999996,20568.69922,21331.32031,16.33065437,-83.66934563,28.81985439,77.28163856,-0.016140131000000002,3451400,-1,0.0
BSESN,1/8/2014,20729.38086,20786.41016,20688.17969,20767.41992,8000,36.140625,0.0,36.140625,35.87415843,20637.17969,21331.32031,13.28277984,-86.71722016,11.30985668,64.08728218,-0.016380342,3459400,1,0.5106
BSESN,1/9/2014,20713.36914,20778.13086,20652.68945,20755.73047,9000,-16.011718,16.011718,0.0,34.94299461,20637.17969,21331.32031,10.97608327,-89.02391673,-3.81497779,50.50683019,-0.022658321000000002,3450400,-1,0.2023
BSESN,1/10/2014,20758.49023,20971.23047,20625.16992,20760.7207,10400,45.121093,0.0,45.121093,40.00635894,20625.16992,21331.32031,18.87987512,-81.12012488,-12.02204037,38.00105608,-0.018186603,3460800,1,-0.6908
BSESN,1/13/2014,21134.21094,21169.08008,20850.53906,20850.53906,7900,375.720704,0.0,375.720704,65.67453334,20625.16992,21331.32031,72.08677109999999,-27.9132289,11.65695013,32.73223489,-0.001722606,3468700,1,-0.2023
BSESN,1/14/2014,21032.88086,21154.75977,21009.05078,21115.0,5600,-101.330079,101.330079,0.0,57.95796746,20625.16992,21331.32031,57.73712543,-42.26287457,21.99271188,30.58433029,-0.005089743,3463100,-1,-0.5574
BSESN,1/15/2014,21289.49023,21302.73047,21091.46094,21091.46094,9400,256.609375,0.0,256.609375,68.70307537,20625.16992,21331.32031,94.07632148,-5.923678516,50.31016525,34.52949728,0.019204989,3472500,1,-0.5904
BSESN,1/16/2014,21265.17969,21379.28906,21199.65039,21366.91016,13400,-24.310546,24.310546,0.0,66.83580853,20625.16992,21379.28906,84.86852159,-15.13147841,69.98356619,41.62031106,0.019847636000000002,3459100,-1,0.1531
BSESN,1/17/2014,21063.61914,21270.10938,21015.60938,21236.65039,12000,-201.56054699999999,201.56054699999999,0.0,53.043899800000005,20625.16992,21379.28906,58.14057689,-41.85942311,68.52076185,47.00040122,0.013292652,3447100,-1,0.0
BSESN,1/20/2014,21205.05078,21221.36914,21001.13086,21083.5293,6000,141.43164,0.0,141.43164,59.7658986,20625.16992,21379.28906,76.89512538,-23.10487462,77.87612276,53.17554553,0.024733223999999998,3453100,1,-0.5994
BSESN,1/21/2014,21251.11914,21302.51953,21189.19922,21237.96094,9400,46.06836,0.0,46.06836,61.82011013,20625.16992,21379.28906,83.00402217,-16.99597783,87.99331318,60.13909906,0.025169023999999998,3462500,1,0.0
BSESN,1/22/2014,21337.66992,21377.91016,21168.42969,21251.65039,13400,86.550781,0.0,86.550781,65.62474458,20625.16992,21379.28906,94.48109208,-5.51890792,101.8214499,68.47556922,0.030139992,3475900,1,0.5859
BSESN,1/23/2014,21373.66016,21409.66016,21264.71094,21319.68945,6500,35.990234,0.0,35.990234,67.19330872,20625.16992,21409.66016,95.41103274,-4.58896726,114.3661175,77.65367888,0.029634617999999998,3482400,1,0.8126
BSESN,1/24/2014,21133.56055,21333.66016,21123.99023,21289.15039,10800,-240.099609,240.099609,0.0,49.72693556,20625.16992,21409.66016,64.80522038,-35.19477962,103.73799809999998,82.87054273,-3.0799999999999996e-05,3471600,-1,-0.25
BSESN,1/27/2014,20707.44922,20899.0293,20688.0293,20899.0293,10100,-426.111328,426.111328,0.0,32.45248614,20625.16992,21409.66016,10.48825,-89.51175,60.23713765,78.34386171,-0.015472518999999999,3461500,-1,0.0
BSESN,1/28/2014,20683.50977,20795.34961,20554.2793,20721.16992,8200,-23.939453,23.939453,0.0,31.73777904,20554.2793,21409.66016,15.10794492,-84.89205508,23.55910387,67.38691014,-0.028463832,3453300,-1,-0.8316
BSESN,1/29/2014,20647.30078,20828.67969,20613.61914,20784.03906,7800,-36.208985,36.208985,0.0,30.56307826,20554.2793,21409.66016,10.87486153,-89.12513847,-8.334193244,52.24268947,-0.029055899,3445500,-1,0.128
BSESN,1/30/2014,20498.25,20528.41016,20343.7793,20491.74023,12600,-149.050781,149.050781,0.0,25.99345369,20343.7793,21409.66016,14.49230481,-85.50769519,-45.11693342,32.77076489,-0.026841026,3432900,-1,0.0
BSESN,1/31/2014,20513.84961,20572.32031,20448.42969,20544.64063,6100,15.599609,0.0,15.599609,27.30598433,20343.7793,21409.66016,15.95584634,-84.04415366,-72.17675325,11.78126126,-0.032596063,3439000,1,-0.2023
BSESN,2/3/2014,20209.25977,20480.34961,20182.19922,20479.0293,5700,-304.58984300000003,304.58984300000003,0.0,19.5103176,20182.19922,21409.66016,2.204595371,-97.79540463,-116.852705,-13.94553198,-0.049026094000000006,3433300,-1,-0.8316
BSESN,2/4/2014,20211.92969,20255.51953,19963.11914,20050.99023,9800,2.669922,0.0,2.669922,19.74206479,19963.11914,21409.66016,17.20037969,-82.79962031,-150.31059119999998,-41.21854383,-0.052758349,3443100,1,0.0
BSESN,2/5/2014,20261.0293,20289.33008,20076.09961,20241.11914,9300,49.099609,0.0,49.099609,24.36306059,19963.11914,21409.66016,20.594656699999998,-79.4053433,-170.8943157,-67.15369821,-0.052056169000000006,3452400,1,0.4588
BSESN,2/6/2014,20310.74023,20358.18945,20079.82031,20286.08984,12400,49.710937,0.0,49.710937,29.12991993,19963.11914,21409.66016,24.03119506,-75.96880494,-181.10810700000002,-89.94457998,-0.038934297,3464800,1,-0.5994
BSESN,2/7/2014,20376.56055,20450.50977,20282.30078,20441.03906,11100,65.820313,0.0,65.820313,35.35427163,19963.11914,21409.66016,28.5813815,-71.41861850000001,-181.79583190000002,-108.3148304,-0.01597921,3475900,1,0.1027
BSESN,2/10/2014,20334.26953,20434.5,20312.21094,20429.16016,7900,-42.291016,42.291016,0.0,33.19297927,19963.11914,21409.66016,25.65778544,-74.34221456,-183.63654250000002,-123.37917279999999,-0.01688496,3468000,-1,0.0
BSESN,2/11/2014,20363.36914,20443.34961,20349.50977,20400.93945,9400,29.09961,0.0,29.09961,36.28539297,19963.11914,21409.66016,27.66945395,-72.33054605,-180.6646342,-134.8362651,-0.013751514,3477400,1,0.4215
BSESN,2/12/2014,20448.49023,20516.59961,20427.23047,20449.83008,10100,85.121093,0.0,85.121093,44.894675799999995,19963.11914,21333.66016,35.41456167,-64.58543833,-169.4870732,-141.7664267,-0.002427513,3487500,1,0.0
BSESN,2/13/2014,20193.34961,20503.85938,20164.66992,20478.66992,7900,-255.140625,255.140625,0.0,30.59628878,19963.11914,20899.0293,24.59963347,-75.40036653,-179.15134650000002,-149.2434107,-0.015623591000000001,3479600,-1,0.0
BSESN,2/14/2014,20366.82031,20391.94922,20149.00977,20265.13086,8300,173.470704,0.0,173.470704,44.47055373,19963.11914,20828.67969,46.64043127,-53.35956873,-170.8433409,-153.5633967,0.007796453,3487900,1,0.5719
BSESN,2/17/2014,20464.06055,20492.42969,20338.94922,20438.86914,6100,97.240234,0.0,97.240234,50.82839181,19963.11914,20828.67969,57.8747966,-42.1252034,-154.6302314,-153.77676369999998,0.012474358999999999,3494000,1,0.0
BSESN,2/18/2014,20634.21094,20685.01953,20436.48047,20457.56055,9400,170.15039099999998,0.0,170.15039099999998,60.06089233,19963.11914,20685.01953,92.96182774,-7.038172261000001,-126.59223429999999,-148.33985780000003,0.018418691,3503400,1,0.0
BSESN,2/19/2014,20722.9707,20750.51953,20629.56055,20643.84961,4700,88.759765,0.0,88.759765,64.11628932,19963.11914,20750.51953,96.50129358,-3.498706421,-96.10194494,-137.8922752,0.020296181,3508100,1,0.0
BSESN,2/20/2014,20536.64063,20662.66016,20522.03906,20661.07031,6000,-186.33007800000001,186.33007800000001,0.0,51.45969282,19963.11914,20750.51953,72.83733807,-27.16266193,-85.98230058,-127.5102803,0.007856089,3502100,-1,0.0
BSESN,2/21/2014,20700.75,20725.03906,20599.91016,20600.58008,6300,164.109375,0.0,164.109375,59.57020726,19963.11914,20750.51953,93.67926005,-6.320739948,-63.98260286,-114.80474479999998,0.0180228,3508400,1,0.0
BSESN,2/24/2014,20811.43945,20828.63086,20637.30078,20695.48047,12500,110.689453,0.0,110.689453,64.22259095,20076.09961,20828.63086,97.71552264,-2.284477356,-37.1872981,-99.28125547,0.022003742000000003,3520900,1,0.0
BSESN,2/25/2014,20852.4707,20912.53906,20777.73047,20877.7207,9500,41.03125,0.0,41.03125,65.90090517,20079.82031,20912.53906,92.78647683,-7.213523173,-12.49689069,-81.92438251,0.019756005,3530400,1,0.4404
BSESN,2/26/2014,20986.99023,21005.03906,20860.01953,20869.60938,8500,134.519531,0.0,134.519531,71.03994791,20149.00977,21005.03906,97.8915641,-2.1084358990000003,17.72076306,-61.9953534,0.039302079,3538900,1,-0.4767
BSESN,2/28/2014,21120.11914,21140.50977,20989.66016,20995.39063,11400,133.128907,0.0,133.128907,75.2921113,20149.00977,21140.50977,97.94345688,-2.056543116,51.81358679,-39.23356536,0.03698657,3550300,1,0.4019
BSESN,3/3/2014,20946.65039,21140.0,20920.98047,21079.26953,121600,-173.46875,173.46875,0.0,61.67675757,20149.00977,21140.50977,80.44786939,-19.55213061,64.09605738,-18.56764081,0.023582311,3428700,-1,0.2023
BSESN,3/4/2014,21209.73047,21224.64063,20940.39063,20947.0,9700,263.08007799999996,0.0,263.08007799999996,70.88877182,20149.00977,21224.64063,98.61382222,-1.386177784,93.97508121,3.9409035919999997,0.027891521000000002,3438400,1,0.0
BSESN,3/5/2014,21276.85938,21333.19922,21176.16016,21280.35938,7500,67.128906,0.0,67.128906,72.81286175,20149.00977,21333.19922,95.24232851,-4.757671491,121.6686442,27.48645171,0.026728247000000004,3445900,1,0.4019
BSESN,3/6/2014,21513.86914,21525.14063,21329.88086,21336.32031,9700,237.009766,0.0,237.009766,78.58029838,20149.00977,21525.14063,99.18092935,-0.8190706520000001,160.88610480000003,54.16638233,0.047584633,3455600,1,0.6124
BSESN,3/7/2014,21919.78906,21960.89063,21539.43945,21539.43945,15200,405.91992200000004,0.0,405.91992200000004,84.90740637,20338.94922,21960.89063,97.46590340000002,-2.534096599,222.159652,87.76503627,0.058888642000000005,3470800,1,-0.4939
BSESN,3/10/2014,21934.83008,22023.98047,21805.2207,21819.18945,15500,15.041015,0.0,15.041015,85.09563684,20436.48047,22023.98047,94.38422734,-5.615772661,268.8341116,123.9788513,0.053979477000000005,3486300,1,0.7906
BSESN,3/11/2014,21826.41992,22018.51953,21772.10938,21918.83008,12000,-108.410156,108.410156,0.0,77.09886382,20522.03906,22023.98047,86.84632129,-13.15367871,293.69068010000007,157.92121709999998,0.046706658,3474300,-1,0.5574
BSESN,3/12/2014,21856.2207,21965.94922,21768.14063,21793.32031,10400,29.800781,0.0,29.800781,77.7617125,20522.03906,22023.98047,88.83047199,-11.16952801,312.1955675,188.7760872,0.041417586,3484700,1,0.0772
BSESN,3/13/2014,21774.60938,21991.35938,21720.13086,21736.60938,9500,-81.611328,81.611328,0.0,71.24563366,20599.91016,22023.98047,82.48884962,-17.51115038,316.6256091,214.34599159999996,0.030988946,3475200,-1,-0.3818
BSESN,3/14/2014,21809.80078,21853.32031,21573.48047,21648.05078,8800,35.191406,0.0,35.191406,72.39648438,20637.30078,22023.98047,84.55449446,-15.44550554,319.295462,235.33588569999998,0.041207084,3484000,1,0.34
BSESN,3/18/2014,21832.60938,22040.7207,21785.38086,21849.65039,8600,22.808594,0.0,22.808594,73.1986816,20777.73047,22040.7207,83.52233276,-16.47766724,319.56802139999996,252.1823128,0.029367601,3492600,1,0.0
BSESN,3/19/2014,21832.85938,21895.83008,21782.00977,21872.67969,11000,0.25,0.0,0.25,73.20852857,20860.01953,22040.7207,82.39509429,-17.60490571,316.15970719999996,264.9777917,0.026131676,3503600,1,0.0
BSESN,3/20/2014,21740.08984,21853.25,21704.66016,21797.60938,7600,-92.769531,92.769531,0.0,63.25742332,20920.98047,22040.7207,73.15173199,-26.84826801,302.4859976,272.4794329,0.01051511,3496000,-1,0.0
BSESN,3/21/2014,21753.75,21870.10938,21729.90039,21823.51953,60600,13.660156,0.0,13.660156,64.08681891,20920.98047,22040.7207,74.37167172,-25.62832828,289.4155424,275.8666548,-0.007574848,3556600,1,-0.4767
BSESN,3/24/2014,22055.48047,22074.33984,21827.5,21827.5,9000,301.73046899999997,0.0,301.73046899999997,77.20249817,20940.39063,22074.33984,98.33684131,-1.6631586919999999,299.9466415,280.68265210000004,0.005500402,3565600,1,0.0
BSESN,3/25/2014,22055.21094,22079.96094,21916.86914,21948.31055,7800,-0.269531,0.269531,0.0,77.17344843,21176.16016,22079.96094,97.26156466,-2.738435338,304.7578062,285.4976829,0.010482297,3557800,-1,0.0
BSESN,3/26/2014,22095.30078,22172.19922,22020.58008,22134.71094,10600,40.089843,0.0,40.089843,78.55812165,21329.88086,22172.19922,90.8706207,-9.1293793,308.252264,290.04859910000005,0.010938766,3568400,1,-0.2263
BSESN,3/27/2014,22214.36914,22307.74023,22094.28906,22116.23047,10400,119.06836000000001,0.0,119.06836000000001,82.24836685,21539.43945,22307.74023,87.8470652,-12.1529348,316.9755714,295.4339936,0.020195988999999998,3578800,1,0.0
BSESN,3/28/2014,22339.9707,22363.9707,22185.10938,22273.43945,9200,125.60156200000002,0.0,125.60156200000002,85.32290027,21573.48047,22363.9707,96.96390936,-3.0360906389999998,330.2173121,302.39065730000004,0.024308793,3588000,1,-0.3818
BSESN,3/31/2014,22386.26953,22467.21094,22253.7793,22423.14063,11200,46.298828,0.0,46.298828,86.32991318,21573.48047,22467.21094,90.94342088,-9.056579115,340.52208889999997,310.01694360000005,0.025359321,3599200,1,0.0
BSESN,4/1/2014,22446.43945,22485.76953,22295.65039,22455.23047,11000,60.169922,0.0,60.169922,87.60515688,21573.48047,22485.76953,95.68885788,-4.311142118999999,349.51491810000005,317.9165385,0.028103514,3610200,1,0.0
BSESN,4/2/2014,22551.49023,22592.09961,22473.46094,22550.58008,15700,105.050781,0.0,105.050781,89.56599103,21573.48047,22592.09961,96.01329158,-3.986708418,360.9576253,326.5247559,0.037322771,3625900,1,0.0
BSESN,4/3/2014,22509.07031,22620.65039,22369.2793,22598.18945,7400,-42.419921,42.419921,0.0,83.41740861,21573.48047,22620.65039,89.34460629,-10.65539371,362.4253068,333.7048661,0.034721384,3618500,-1,0.2023
BSESN,4/4/2014,22359.5,22525.21094,22339.40039,22522.46094,7100,-149.570313,149.570313,0.0,65.20602168,21704.66016,22620.65039,71.48982805,-28.51017195,347.5134618,336.4665852,0.013784308,3611400,-1,-0.1779
BSESN,4/7/2014,22343.44922,22481.61914,22197.50977,22355.56055,4700,-16.050781,16.050781,0.0,63.48974007,21704.66016,22620.65039,69.73754071,-30.26245929,330.5897209,335.2912124,0.013068942,3606700,-1,0.4404
BSESN,4/9/2014,22702.33984,22740.03906,22379.94922,22389.21094,8500,358.890625,0.0,358.890625,78.25566847,21704.66016,22740.03906,96.35889637,-3.641103633,342.192427,336.67145530000005,0.027473672999999997,3615200,1,0.0
BSESN,4/10/2014,22715.33008,22792.49023,22644.42969,22729.46094,10900,12.990234,0.0,12.990234,78.61684571,21729.90039,22792.49023,92.73848169,-7.2615183089999995,348.4194954,339.0210633,0.022551212,3626100,1,0.0
BSESN,4/11/2014,22628.96094,22679.17969,22526.89063,22642.05078,9500,-86.36914,86.36914,0.0,69.73116401,21827.5,22792.49023,83.05378746,-16.94621254,342.4378143,339.7044135,0.012936017,3616600,-1,-0.4939
BSESN,4/15/2014,22484.92969,22737.31055,22416.24023,22698.08984,8600,-144.03125,144.03125,0.0,57.27495387,21916.86914,22792.49023,64.87515565,-35.12484435,322.3592144,336.23537369999997,0.0044071729999999995,3608000,-1,0.0
BSESN,4/16/2014,22277.23047,22533.60938,22247.39063,22486.73047,6700,-207.699219,207.699219,0.0,44.15191077,22020.58008,22792.49023,33.24873873,-66.75126127,286.3859097,326.2654809,-0.007538344000000001,3601300,-1,-0.7579
BSESN,4/17/2014,22628.83984,22648.68945,22312.18945,22327.75977,8500,351.609375,0.0,351.609375,61.41893527,22094.28906,22792.49023,76.56114071,-23.43885929,282.9866506,317.6097148,0.003429911,3609800,1,0.1027
BSESN,4/21/2014,22764.83008,22795.58008,22636.75,22644.75,9100,135.99023400000002,0.0,135.99023400000002,66.0967754,22185.10938,22795.58008,94.96290324,-5.03709676,287.94671810000006,311.67711549999996,0.01136252,3618900,1,-0.5267
BSESN,4/22/2014,22758.36914,22853.0293,22727.63086,22771.24023,9000,-6.460937,6.460937,0.0,65.66034997,22197.50977,22853.0293,85.55952164,-14.44047836,288.0359644,306.94888530000003,0.017838911000000002,3609900,-1,0.3182
BSESN,4/23/2014,22876.53906,22912.51953,22780.13086,22783.65039,7200,118.169922,0.0,118.169922,69.86016359999999,22197.50977,22912.51953,94.96783544,-5.032164561,294.250086,304.4091254,0.023858887999999998,3617100,1,0.0
BSESN,4/25/2014,22688.07031,22939.31055,22656.64063,22892.5,7500,-188.46875,188.46875,0.0,57.02552234,22197.50977,22939.31055,66.13103674,-33.86896326,280.7308784,299.673476,-0.0006285490000000001,3609600,-1,0.0
BSESN,4/28/2014,22631.60938,22721.35938,22597.18945,22717.58984,6900,-56.460938,56.460938,0.0,53.62034021,22197.50977,22939.31055,58.51970234,-41.48029766,262.4356878,292.2259184,-0.0036856479999999997,3602700,-1,0.0
BSESN,4/29/2014,22466.18945,22681.89063,22443.56055,22654.2793,7700,-165.41992199999999,165.41992199999999,0.0,44.61431888,22197.50977,22939.31055,36.21992506,-63.78007494,231.91523769999998,280.16378219999996,-0.00719306,3595000,-1,-0.5106
BSESN,4/30/2014,22417.80078,22680.46094,22284.96094,22517.63086,9700,-48.388672,48.388672,0.0,42.22081667,22197.50977,22939.31055,29.69678931,-70.30321069,201.5002305,264.4310719,-0.002985507,3585300,-1,0.7184
BSESN,5/2/2014,22403.89063,22575.61914,22386.94922,22493.58984,6300,-13.910156,13.910156,0.0,41.48263692,22247.39063,22939.31055,22.61822431,-77.38177569,174.2648679,246.39783109999996,0.005685633000000001,3579000,-1,-0.4404
BSESN,5/5/2014,22445.11914,22592.0293,22354.44922,22412.80078,11700,41.228516,0.0,41.228516,44.78414889,22247.39063,22939.31055,28.57679187,-71.42320813,154.2295809,227.96418109999996,-0.008118874,3590700,1,-0.29600000000000004
BSESN,5/6/2014,22508.41992,22602.71094,22475.65039,22512.23047,6200,63.30078100000001,0.0,63.30078100000001,49.80153831,22247.39063,22939.31055,37.72536224,-62.27463776,141.82445159999997,210.73623519999998,-0.011263434,3596900,1,-0.2732
BSESN,5/7/2014,22323.90039,22532.82031,22286.25977,22488.96094,10800,-184.519531,184.519531,0.0,38.14369979999999,22247.39063,22939.31055,11.05760415,-88.94239585,115.76959340000002,191.74290680000001,-0.019090505,3586100,-1,-0.1027
BSESN,5/8/2014,22344.03906,22443.13086,22277.03906,22382.14063,6000,20.138672,0.0,20.138672,39.91494281,22247.39063,22939.31055,13.96815367,-86.03184633,95.64343509999999,172.5230125,-0.023277122,3592100,1,-0.4588
BSESN,5/9/2014,22994.23047,23048.49023,22317.17969,22374.98047,11300,650.1914059999999,0.0,650.1914059999999,70.92740717,22277.03906,23048.49023,92.96653281,-7.03346719,130.6522445,164.14885890000002,0.013494323,3603400,1,0.0
BSESN,5/12/2014,23551.0,23572.88086,23008.65039,23031.10938,12400,556.7695309999999,0.0,556.7695309999999,80.74635424,22277.03906,23572.88086,98.31145599,-1.688544008,201.00654780000002,171.5203967,0.040624182,3615800,1,-0.6705
BSESN,5/13/2014,23871.23047,24068.93945,23729.25,23729.7793,18200,320.23046899999997,0.0,320.23046899999997,84.27167557,22277.03906,24068.93945,88.96651928,-11.03348072,279.3822184,193.09276100000002,0.062540246,3634000,1,0.5859
BSESN,5/14/2014,23815.11914,23964.66992,23753.35938,23897.88086,11500,-56.111328,56.111328,0.0,81.2634073,22277.03906,24068.93945,85.83513272,-14.16486728,333.127698,221.0997484,0.062330751,3622500,-1,-0.7845
BSESN,5/15/2014,23905.59961,23971.7793,23742.75,23809.41992,14900,90.480468,0.0,90.480468,82.43035179,22277.03906,24068.93945,90.88454666,-9.115453342999999,378.6574678,252.6112923,0.067028937,3637400,1,-0.7506
BSESN,5/16/2014,24121.74023,25375.63086,23873.16016,24271.53906,35700,216.140625,0.0,216.140625,85.00458325,22277.03906,25375.63086,59.53353305,-40.46646695,427.25574220000004,287.5401823,0.07469869400000001,3673100,1,-0.5994
BSESN,5/19/2014,24363.05078,24448.4707,24107.99023,24340.32031,23500,241.310547,0.0,241.310547,87.38549154,22277.03906,25375.63086,67.3212819,-32.678718100000005,479.7121462,325.974575,0.082397204,3696600,1,0.0
BSESN,5/20/2014,24376.88086,24587.16016,24299.5293,24555.31055,19000,13.830078,0.0,13.830078,87.51656491,22277.03906,25375.63086,67.7676162,-32.2323838,516.4469174999999,364.0690435,0.09196334099999999,3715600,1,0.0
BSESN,5/21/2014,24298.01953,24419.53906,24156.4707,24404.48047,18000,-78.861328,78.861328,0.0,81.91638141,22277.03906,25375.63086,65.22254627,-34.77745373,533.0513541,397.8655056,0.08744974300000001,3697600,-1,0.0
BSESN,5/22/2014,24374.40039,24524.75977,24326.48047,24415.41992,14500,76.38086,0.0,76.38086,83.12327384,22277.03906,25375.63086,67.68756474,-32.31243526,546.0789288,427.50819029999997,0.060022444,3712100,1,0.0
BSESN,5/23/2014,24693.34961,24745.85938,24470.7793,24535.14063,21200,318.94921800000003,0.0,318.94921800000003,87.22973728,22277.03906,25375.63086,77.98092505,-22.01907495,575.5058387999999,457.10772000000003,0.048505355,3733300,1,-0.5106
BSESN,5/26/2014,24716.88086,25175.2207,24433.90039,24913.89063,21900,23.53125,0.0,23.53125,87.48888485,22277.03906,25375.63086,78.74034259999999,-21.2596574,593.8797758999999,484.4621312,0.035425505,3755200,1,0.34
BSESN,5/27/2014,24549.50977,24777.31055,24422.33008,24748.09961,12600,-167.371093,167.371093,0.0,74.99831688,22277.03906,25375.63086,73.33882139,-26.66117861,588.1559097999999,505.2008869,0.030837159,3742600,-1,0.0
BSESN,5/28/2014,24556.08984,24643.33008,24488.81055,24591.60938,15100,6.580078,0.0,6.580078,75.1591937,22317.17969,25375.63086,73.20405103,-26.79594897,577.4936743,519.6594444,0.027210789,3757700,1,-0.3182
BSESN,5/29/2014,24234.15039,24528.19922,24206.5,24523.13086,16000,-321.93945299999996,321.93945299999996,0.0,55.13203517,23008.65039,25375.63086,51.77482521,-48.22517479,536.8771669,523.1029888999999,0.0046601179999999996,3741700,-1,0.0
BSESN,5/30/2014,24217.33984,24353.58984,24163.61914,24300.99023,14900,-16.810547,16.810547,0.0,54.26091142,23729.25,25375.63086,29.64622926,-70.35377074,497.59584620000004,518.0015603,-0.005980816999999999,3726800,-1,0.0
BSESN,6/2/2014,24684.84961,24709.08984,24270.19922,24368.96094,14400,467.509765,0.0,467.509765,69.64949159,23742.75,25375.63086,57.69555101,-42.30444899,498.4435011,514.0899485,0.012633641000000001,3741200,1,0.0
BSESN,6/3/2014,24858.58984,24892.06055,24626.9707,24729.2207,21100,173.740235,0.0,173.740235,73.47603863,23742.75,25375.63086,68.33565583,-31.66434417,507.2869702,512.7293528,0.023070617,3762300,1,0.0
BSESN,6/4/2014,24805.83008,24925.90039,24773.92969,24909.0293,14800,-52.759766000000006,52.759766000000006,0.0,70.36744995,23873.16016,25375.63086,62.07574764,-37.92425236,504.22580980000004,511.0286442,0.017700115,3747500,-1,0.4767
BSESN,6/5/2014,25019.50977,25044.06055,24644.88086,24828.38086,17500,213.679688,0.0,213.679688,75.25896767,24107.99023,25175.2207,85.40981151,-14.59018849,513.1269747,511.4483103,0.013208421000000001,3765000,1,0.0
BSESN,6/6/2014,25396.46094,25419.14063,25129.75977,25204.94922,18100,376.95117200000004,0.0,376.95117200000004,81.48131783,24156.4707,25419.14063,98.2038309,-1.796169102,544.3234,518.0233283,0.027494572999999998,3783100,1,0.0
BSESN,6/9/2014,25580.21094,25644.76953,25496.83984,25543.59961,15300,183.75,0.0,183.75,83.77628786,24156.4707,25644.76953,95.66225601,-4.337743992,577.2200478,529.8626722,0.041984593,3798400,1,0.7783
BSESN,6/10/2014,25583.68945,25711.10938,25347.33008,25706.34961,13600,3.4785150000000002,0.0,3.4785150000000002,83.8200862,24163.61914,25711.10938,91.76602739,-8.233972609,596.6932568,543.2287891,0.041847037000000004,3812000,1,-0.5574
BSESN,6/11/2014,25473.89063,25735.86914,25365.65039,25650.61914,14000,-109.798828,109.798828,0.0,76.31636390000001,24163.61914,25735.86914,83.33734991,-16.66265009,596.3912404,553.8612794,0.051156744000000004,3798000,-1,0.0
BSESN,6/12/2014,25576.21094,25611.32031,25409.68945,25597.21094,10200,102.320313,0.0,102.320313,78.39594555,24163.61914,25735.86914,89.84524071,-10.15475929,597.5204407000001,562.5931116,0.056111493,3808200,1,0.0
BSESN,6/13/2014,25228.16992,25688.31055,25171.60938,25677.05078,14700,-348.041016,348.041016,0.0,58.3032971,24163.61914,25735.86914,67.70874740000001,-32.2912526,563.8318364,562.8408566,0.022010274,3793500,-1,-0.8625
BSESN,6/16/2014,25190.48047,25268.41016,25063.92969,25239.5,12000,-37.689453,37.689453,0.0,56.49410764,24163.61914,25735.86914,65.31158073,-34.68841927,528.0056306,555.8738114,0.013351143999999999,3781500,-1,-0.1531
BSESN,6/17/2014,25521.18945,25545.88086,25104.5,25189.46094,11300,330.708984,0.0,330.708984,66.89478114,24163.61914,25735.86914,86.34570278,-13.65429722,520.3008513,548.7592194,0.028838357000000002,3792800,1,0.0
BSESN,6/18/2014,25246.25,25609.2793,25114.30078,25565.18945,13200,-274.93945299999996,274.93945299999996,0.0,54.4158409,24163.61914,25735.86914,68.85869671,-31.14130329,486.40249680000005,536.2878749,0.009062536999999999,3779600,-1,-0.4019
BSESN,6/19/2014,25201.80078,25425.84961,25069.66016,25327.08984,15200,-44.449219,44.449219,0.0,52.58592976,24270.19922,25735.86914,63.56148462,-36.43851538,450.75510189999994,519.1813202999999,-0.0076648540000000005,3764400,-1,0.0
BSESN,6/20/2014,25105.50977,25276.31055,25056.17969,25237.53906,8800,-96.291015,96.291015,0.0,48.50845193,24626.9707,25735.86914,43.1544537,-56.8455463,410.00808650000005,497.3466735,-0.01855736,3755600,-1,0.0
BSESN,6/23/2014,25031.32031,25197.5,24878.66016,25108.08984,10200,-74.189453,74.189453,0.0,45.38026033,24644.88086,25735.86914,35.42104534,-64.57895466,367.4930829,471.37595539999995,-0.021590676,3745400,-1,-0.6705
BSESN,6/24/2014,25368.90039,25414.68945,25115.83008,25115.83008,9700,337.58007799999996,0.0,337.58007799999996,59.19569284,24644.88086,25735.86914,66.36363964,-33.63636036,356.9251167,448.48578770000006,-0.004121484,3755100,1,0.0
BSESN,6/25/2014,25313.74023,25427.80078,25274.39063,25421.49023,7700,-55.160157,55.160157,0.0,56.50124685,24878.66016,25735.86914,50.75542669,-49.24457331,340.1776079,426.8241517,-0.010262298000000001,3747400,-1,-0.2732
BSESN,6/26/2014,25062.66992,25309.33008,25021.23047,25217.68945,10300,-251.070312,251.070312,0.0,45.60028728,24878.66016,25735.86914,21.46614994,-78.53385006,303.1512715,402.08957569999995,-0.006560127,3737100,-1,0.0
BSESN,6/27/2014,25099.91992,25209.60938,25032.93945,25132.08008,10100,37.25,0.0,37.25,47.33956898,24878.66016,25735.86914,25.81164802,-74.18835198,273.65882819999996,376.4034262,-0.003595031,3747200,1,0.0
BSESN,6/30/2014,25413.7793,25460.96094,25179.55078,25179.55078,9500,313.859375,0.0,313.859375,59.8268074,24878.66016,25735.86914,62.42575036,-37.57424964,272.4708091,355.6169028,-0.004208666,3756700,1,0.0
BSESN,7/1/2014,25516.34961,25571.90039,25466.76953,25469.93945,10600,102.570312,0.0,102.570312,63.12411125,24878.66016,25688.31055,78.76108751,-21.23891249,276.6171915,339.8169605,0.010698603000000001,3767300,1,0.0
BSESN,7/2/2014,25841.21094,25864.5293,25660.16016,25660.57031,12300,324.861329,0.0,324.861329,71.63281057,24878.66016,25864.5293,97.63474096,-2.365259042,302.62831289999997,332.379231,0.025371606,3779600,1,-0.7096
BSESN,7/3/2014,25823.75,25999.08008,25793.69922,25875.75,3700,-17.460938,17.460938,0.0,70.62221022,24878.66016,25999.08008,84.35139589,-15.64860411,318.16574560000004,329.5365339,0.028608869,3775900,-1,-0.8176
BSESN,7/4/2014,25962.06055,25981.50977,25659.33008,25844.80078,9500,138.31054699999999,0.0,138.31054699999999,73.97765106,24878.66016,25999.08008,96.69592353,-3.304076469,337.74644739999997,331.1785166,0.037183026,3785400,1,0.4404
BSESN,7/7/2014,26100.08008,26123.55078,25992.73047,26039.66992,8900,138.019531,0.0,138.019531,77.00213414,24878.66016,26123.55078,98.11463734,-1.88536266,360.2485957,336.99253239999996,0.028821891000000002,3794300,1,-0.5106
BSESN,7/8/2014,25582.10938,26190.43945,25495.03906,26166.91992,12700,-517.9707030000001,517.9707030000001,0.0,51.22245101,24878.66016,26190.43945,53.62557715,-46.37442285,332.4534867,336.0847233,0.010601718000000001,3781600,-1,0.4404
BSESN,7/9/2014,25444.81055,25683.9707,25364.76953,25615.2793,10500,-137.29882800000001,137.29882800000001,0.0,46.46464256,24878.66016,26190.43945,43.15896678,-56.84103322,295.9354351,328.0548657,0.015247403,3771100,-1,-0.7906
BSESN,7/10/2014,25372.75,25920.46094,25239.89063,25513.74023,16900,-72.060547,72.060547,0.0,43.99017956,24878.66016,26190.43945,37.66562295,-62.33437705,258.2035227,314.08459710000005,0.010869759,3754200,-1,0.0
BSESN,7/11/2014,25024.34961,25548.33008,24978.33008,25488.85938,18600,-348.400391,348.400391,0.0,33.91452824,24978.33008,26190.43945,3.7966483839999996,-96.20335162,197.90636899999998,290.8489514,-0.015323565,3735600,-1,0.4019
BSESN,7/14/2014,25006.98047,25095.75977,24892.0,25093.16016,11400,-17.369139999999998,17.369139999999998,0.0,33.47350029,24892.0,26190.43945,8.855281525,-91.14471847,147.0240936,262.08397990000003,-0.019962461,3724200,-1,0.1531
BSESN,7/15/2014,25228.65039,25254.48047,25020.32031,25100.90039,8100,221.669922,0.0,221.669922,44.16550795,24892.0,26190.43945,25.9273076,-74.07269240000001,123.1666455,234.300513,-0.023704793,3732300,1,0.0
BSESN,7/16/2014,25549.7207,25602.7793,25246.75,25322.16992,9600,321.070312,0.0,321.070312,55.98731226,24892.0,26190.43945,50.65470719,-49.34529281,128.6837507,213.17716049999999,-0.010611522,3741900,1,0.6124
BSESN,7/17/2014,25561.16016,25613.0293,25494.46094,25540.91992,21900,11.439453,0.0,11.439453,56.36710638,24892.0,26190.43945,51.53572271,-48.46427729,132.4523364,197.0321957,-0.015441779,3763800,1,0.5719
BSESN,7/18/2014,25641.56055,25713.40039,25441.24023,25558.48047,8300,80.400391,0.0,80.400391,59.22081537,24892.0,26190.43945,57.72780127,-42.27219873,140.3092102,185.6875986,-0.017567744,3772100,1,0.0
BSESN,7/21/2014,25715.16992,25861.15039,25677.71094,25776.53906,7600,73.609375,0.0,73.609375,61.85619144,24892.0,26190.43945,63.39686615,-36.60313385,150.7378881,178.6976565,0.005201313,3779700,1,0.0
BSESN,7/22/2014,26025.80078,26050.38086,25780.39063,25784.48047,8500,310.630859,0.0,310.630859,70.98614984,24892.0,26190.43945,87.32026575,-12.67973425,181.97036369999998,179.3521979,0.022833349,3788200,1,0.5267
BSESN,7/23/2014,26147.33008,26188.64063,26000.40039,26130.25977,8200,121.529297,0.0,121.529297,73.81542137,24892.0,26190.43945,96.67990872,-3.3200912760000003,214.06116040000003,186.2939904,0.03052803,3796400,1,0.0
BSESN,7/24/2014,26271.84961,26292.66016,26077.69922,26188.5,7800,124.519531,0.0,124.519531,76.52207886,24892.0,26292.66016,98.51423296,-1.4857670440000001,246.697261,198.37464450000002,0.049851445,3804200,1,-0.3182
BSESN,7/25/2014,26126.75,26300.16992,26007.31055,26257.14063,11100,-145.09960900000002,145.09960900000002,0.0,67.18451525,24892.0,26300.16992,87.68473042,-12.31526958,257.8805931,210.27583419999996,0.044778278,3793100,-1,0.0
BSESN,7/28/2014,25991.23047,26181.83008,25900.25,26173.4707,7400,-135.519531,135.519531,0.0,59.37643153,24892.0,26300.16992,78.06092516,-21.93907484,252.89297799999997,218.799263,0.030226749,3785700,-1,0.0
BSESN,7/30/2014,26087.41992,26113.48047,25850.03906,26005.14063,9200,96.189453,0.0,96.189453,62.906970799999996,24892.0,26300.16992,84.89173809,-15.10826191,253.77656380000002,225.7947232,0.021045209,3794900,1,0.0
BSESN,7/31/2014,25894.9707,26118.88086,25853.68945,26105.89063,9200,-192.449219,192.449219,0.0,52.39489356,24892.0,26300.16992,71.22511902,-28.77488098,236.2247168,227.8807219,0.013059288,3785700,-1,-0.8271
BSESN,8/1/2014,25480.83984,25862.67969,25459.13086,25753.91992,12700,-414.130859,414.130859,0.0,37.03041823,24892.0,26300.16992,41.81596516,-58.18403484,186.7451702,219.6536116,-0.006267976999999999,3773000,-1,-0.3182
BSESN,8/4/2014,25723.16016,25754.41992,25531.38086,25631.67969,7400,242.320312,0.0,242.320312,47.43701897,25020.32031,26300.16992,54.91581496,-45.08418504,165.1813889,208.759167,0.00031072099999999997,3780400,1,-0.25
BSESN,8/5/2014,25908.00977,25928.32031,25562.35938,25817.83984,8800,184.84961,0.0,184.84961,54.11205104,25246.75,26300.16992,62.77266569,-37.22733431,161.1501173,199.2373571,-0.004525932,3789200,1,-0.8934
BSESN,8/6/2014,25665.26953,25901.67969,25621.84961,25892.55078,6800,-242.740235,242.740235,0.0,45.38012256,25441.24023,26300.16992,26.08237905,-73.91762095,136.79135159999998,186.748156,-0.01843632,3782400,-1,-0.4588
BSESN,8/7/2014,25589.00977,25778.05078,25526.05078,25668.71094,7100,-76.259765,76.259765,0.0,42.87231226,25441.24023,26300.16992,17.20391483,-82.79608517,110.0645727,171.4114393,-0.025991312000000003,3775300,-1,0.0
BSESN,8/8/2014,25329.14063,25406.86914,25232.82031,25406.86914,7500,-259.869141,259.869141,0.0,35.21952461,25232.82031,26300.16992,9.024251397,-90.97574859999999,67.14018976,150.5571894,-0.030528457000000002,3767800,-1,-0.5106
BSESN,8/11/2014,25519.24023,25553.43945,25437.05078,25476.86914,6000,190.09960900000002,0.0,190.09960900000002,43.70178839,25232.82031,26300.16992,26.83468646,-73.16531354,47.90948598,130.0276487,-0.018159596,3773800,1,0.0
BSESN,8/12/2014,25880.76953,25904.98047,25645.78906,25703.7793,8100,361.52929700000004,0.0,361.52929700000004,56.26738852,25232.82031,26300.16992,60.70637142,-39.29362858,61.13666213,116.2494514,-0.007921458000000001,3781900,1,0.29600000000000004
BSESN,8/13/2014,25918.94922,25972.61914,25791.78906,25861.4707,8800,38.179688,0.0,38.179688,57.42530429999999,25232.82031,26300.16992,64.28342693,-35.71657307,73.84879335,107.76931979999999,0.000925991,3790700,1,0.0
BSESN,8/14/2014,26103.23047,26135.0,25945.34961,25948.30078,10100,184.28125,0.0,184.28125,62.89650958,25232.82031,26300.16992,81.54873986,-18.45126014,97.66735721,105.7489273,0.024425829,3800800,1,0.0
BSESN,8/18/2014,26390.96094,26413.10938,26075.2793,26123.68945,8200,287.73046899999997,0.0,287.73046899999997,69.87173426,25232.82031,26413.10938,98.1234735,-1.876526498,138.1684648,112.2328348,0.025961071000000002,3809000,1,0.0
BSESN,8/19/2014,26420.66992,26530.66992,26387.83984,26482.56055,10400,29.708984,0.0,29.708984,70.5317401,25232.82031,26530.66992,91.52444172,-8.47555828,170.69547980000002,123.9253638,0.019787709,3819400,1,-0.6705
BSESN,8/20/2014,26314.28906,26504.51953,26277.60938,26496.28906,8900,-106.38085900000002,106.38085900000002,0.0,64.67774796,25232.82031,26530.66992,83.32774017,-16.67225983,185.74813840000002,136.2899187,0.025287852000000003,3810500,-1,0.0
BSESN,8/21/2014,26360.10938,26464.80078,26262.51953,26322.66016,6500,45.820312,0.0,45.820312,66.07702567,25232.82031,26530.66992,86.85821949,-13.14178051,199.0799256,148.84792009999998,0.030134015,3817000,1,0.0
BSESN,8/22/2014,26419.55078,26508.26953,26383.16016,26419.5293,6700,59.44140600000001,0.0,59.44140600000001,67.97596265,25232.82031,26530.66992,91.43821131,-8.561788687,211.9981055,161.4779572,0.043049631,3823700,1,0.0
BSESN,8/25/2014,26437.01953,26630.74023,26401.64063,26490.31055,10000,17.46875,0.0,17.46875,68.57251279,25232.82031,26630.74023,86.14221744,-13.85778256,221.09677230000003,173.40172019999997,0.035964209,3833700,1,-0.4404
BSESN,8/26/2014,26442.81055,26481.9707,26314.89063,26349.86914,9500,5.791016,0.0,5.791016,68.79486313,25232.82031,26630.74023,86.55647694,-13.44352306,226.16769739999998,183.9549156,0.02171655,3843200,1,-0.5719
BSESN,8/27/2014,26560.15039,26599.11914,26492.5,26553.24023,6600,117.339844,0.0,117.339844,73.22394215,25232.82031,26630.74023,94.95036576,-5.049634242,236.92367819999996,194.5486681,0.024738702,3849800,1,0.2732
BSESN,8/28/2014,26638.10938,26674.38086,26573.68945,26620.17969,6700,77.958984,0.0,77.958984,75.85146606,25232.82031,26674.38086,97.4838737,-2.516126298,248.86969399999998,205.4128733,0.020490908000000002,3856500,1,-0.6705
BSESN,9/1/2014,26867.55078,26900.30078,26732.39063,26733.17969,9200,229.441406,0.0,229.441406,81.8872946,25437.05078,26900.30078,97.76183154,-2.238168461,273.6960044,219.0694995,0.018058829,3865700,1,0.0
BSESN,9/2/2014,27019.39063,27082.84961,26886.2207,26888.210939999997,8000,151.839844,0.0,151.839844,84.79019217,25645.78906,27082.84961,95.58411201,-4.415887986,302.1403547,235.68367059999997,0.022661072,3873700,1,0.0
BSESN,9/3/2014,27139.93945,27225.84961,27067.01953,27128.06055,9700,120.548828,0.0,120.548828,86.73736053,25791.78906,27225.84961,94.00930761,-5.99069239,330.59905019999997,254.6667465,0.031376504,3883400,1,-0.4404
BSESN,9/4/2014,27085.929689999997,27169.11914,26972.39063,27164.94922,7400,-54.009765,54.009765,0.0,81.35327420000002,25945.34961,27225.84961,89.07302452,-10.92697548,344.81976710000004,272.6973506,0.027534799,3876000,-1,0.0
BSESN,9/5/2014,27026.69922,27178.80078,26920.56055,27127.25977,7100,-59.23046899999999,59.23046899999999,0.0,75.42862307,26075.2793,27225.84961,82.69115864,-17.30884136,347.3068467,287.61924980000003,0.022981027999999997,3868900,-1,-0.6486
BSESN,9/8/2014,27319.84961,27354.99023,27144.56055,27145.11914,7300,293.15039,0.0,293.15039,82.64601366,26262.51953,27354.99023,96.78338056,-3.2166194389999996,368.6827169,303.83194330000003,0.033393707,3876200,1,-0.7717
BSESN,9/9/2014,27265.320310000003,27328.26953,27177.089839999997,27316.429689999997,7600,-54.529295999999995,54.529295999999995,0.0,77.74473894,26262.51953,27354.99023,91.7920068,-8.207993199,376.8787657,318.4413078,0.031105232000000003,3868600,-1,0.0
BSESN,9/10/2014,27057.410160000003,27251.43945,27018.10938,27230.93945,5900,-207.910157,207.910157,0.0,61.65793312,26262.51953,27354.99023,72.76081847,-27.23918153,362.4198312,327.23701239999997,0.018722024,3862700,-1,-0.4576
BSESN,9/11/2014,26995.86914,27150.7793,26904.5,27143.2207,7600,-61.541015,61.541015,0.0,57.58817165,26314.89063,27354.99023,65.47243265,-34.52756735,342.0522108,330.2000521,0.013430373999999998,3855100,-1,0.0
BSESN,9/12/2014,27061.039060000003,27096.86914,26965.910160000003,27048.15039,8000,65.169922,0.0,65.169922,60.75345017,26314.89063,27354.99023,71.73817119,-28.26182881,327.3953828,329.6391183,0.00720156,3863100,1,0.0
BSESN,9/15/2014,26816.56055,26998.070310000003,26790.91016,26998.070310000003,6000,-244.478516,244.478516,0.0,45.91932764,26314.89063,27354.99023,48.23287286,-51.76712714,292.67855180000004,322.247005,-0.007506834,3857100,-1,0.0
BSESN,9/16/2014,26492.50977,26861.289060000003,26464.0293,26854.90039,9400,-324.05078100000003,324.05078100000003,0.0,33.43400861,26464.0293,27354.99023,3.196601312,-96.80339869,236.2931826,305.0562405,-0.023855237,3847700,-1,0.0
BSESN,9/17/2014,26631.28906,26682.64063,26511.71094,26627.21094,7600,138.77929699999999,0.0,138.77929699999999,41.31835859,26464.0293,27354.99023,18.77296288,-81.22703712,200.4945246,284.14389730000005,-0.016785122,3855300,1,0.34
BSESN,9/18/2014,27112.210939999997,27132.19922,26503.08008,26573.89063,7000,480.921875,0.0,480.921875,60.178026,26464.0293,27354.99023,72.75084845,-27.24915155,208.5264433,269.0204065,0.003163972,3862300,1,0.4588
BSESN,9/19/2014,27090.41992,27247.16992,27047.679689999997,27139.39063,7300,-21.791016,21.791016,0.0,59.18357401,26464.0293,27354.99023,70.30506041,-29.69493959,210.7045727,257.3572398,-0.008397911999999999,3855000,-1,0.3818
BSESN,9/22/2014,27206.74023,27254.80078,26918.929689999997,27008.11914,7100,116.32031200000002,0.0,116.32031200000002,62.95417942,26464.0293,27354.99023,83.3606622,-16.6393378,219.2890058,249.743593,-0.00214852,3862100,1,-0.5859
BSESN,9/23/2014,26775.68945,27256.86914,26744.07031,27244.98047,7900,-431.050781,431.050781,0.0,45.12844988,26464.0293,27354.99023,34.98022675,-65.01977325,189.129864,237.62084720000001,-0.010411960999999999,3854200,-1,0.0
BSESN,9/24/2014,26744.68945,26844.69922,26560.0,26817.93945,12300,-31.0,31.0,0.0,44.09243033,26464.0293,27354.99023,31.50083739,-68.49916261,160.8726462,222.27120699999998,-0.009304375,3841900,-1,0.0
BSESN,9/25/2014,26468.35938,26814.19922,26349.55078,26808.66016,11000,-276.33007799999996,276.33007799999996,0.0,35.67003788,26349.55078,27354.99023,11.81658365,-88.18341635,114.85706869999999,200.7883793,-0.021901587,3830900,-1,0.0
BSESN,9/26/2014,26626.32031,26721.0293,26220.49023,26429.30078,10000,157.960938,0.0,157.960938,42.86815836,26220.49023,27328.26953,36.6345607,-63.36543929999999,90.09693826,178.6500911,-0.007094133000000001,3840900,1,0.0
BSESN,9/29/2014,26597.10938,26715.76953,26518.00977,26694.41016,6500,-29.210938,29.210938,0.0,41.868533,26220.49023,27256.86914,36.33990797,-63.66009203,67.34101262,156.3882754,0.003948271,3834400,-1,0.0
BSESN,9/30/2014,26630.50977,26851.33008,26481.31055,26610.71094,8200,33.400391,0.0,33.400391,43.60356716,26220.49023,27256.86914,39.56270523,-60.43729477,51.40929566,135.39247949999998,-2.9299999999999997e-05,3842600,1,-0.9477
BSESN,10/1/2014,26567.99023,26683.69922,26548.2207,26681.4707,7900,-62.519532,62.519532,0.0,40.96298082,26220.49023,27256.86914,33.53020769,-66.46979231,33.35400722,114.984785,-0.0200729,3834700,-1,0.25
BSESN,10/7/2014,26271.9707,26570.38086,26250.24023,26487.50977,10200,-296.01953100000003,296.01953100000003,0.0,30.77956663,26220.49023,27256.86914,4.967340483,-95.03265952,-4.78607033,91.03061394,-0.030211758,3824500,-1,0.0
BSESN,10/8/2014,26246.78906,26338.31055,26150.08984,26229.66992,8600,-25.181639999999998,25.181639999999998,0.0,30.04639479,26150.08984,27256.86914,8.736992033,-91.26300797,-36.62214715,65.50006173,-0.035283579,3815900,-1,-0.34
BSESN,10/9/2014,26637.2793,26688.69922,26394.21094,26394.36914,7500,390.490234,0.0,390.490234,50.95118684,26150.08984,27256.86914,44.01866337,-55.98133663,-29.99737788,46.40057381,-0.005169247,3823400,1,0.2023
BSESN,10/10/2014,26297.38086,26555.91992,26261.60938,26551.74023,9200,-339.898438,339.898438,0.0,39.1890259,26150.08984,27256.86914,13.30807464,-86.69192536,-51.57958643,26.80454176,-0.016725137,3814200,-1,0.0
BSESN,10/13/2014,26384.07031,26443.16016,26092.68945,26275.07031,6400,86.689454,0.0,86.689454,43.05745542,26092.68945,27256.86914,25.0288562,-74.9711438,-60.98552459,9.246528489,-0.003184522,3820600,1,0.0
BSESN,10/14/2014,26349.33008,26550.78906,26212.00977,26537.41992,11900,-34.740235,34.740235,0.0,41.82711572,26092.68945,27256.86914,22.04476059,-77.95523941,-70.43115842,-6.689008894,-0.010402873,3808700,-1,-0.7783
BSESN,10/16/2014,25999.33984,26462.08008,25933.98047,26260.34961,10700,-349.990234,349.990234,0.0,31.39795932,25933.98047,27256.86914,4.940655732,-95.05934427,-104.94839840000002,-26.34088679,-0.022474981,3798000,-1,0.0
BSESN,10/17/2014,26108.5293,26248.53906,25910.76953,25950.0,9400,109.189453,0.0,109.189453,37.04826135,25910.76953,26851.33008,21.02573477,-78.97426523,-122.0855571,-45.48982085,-0.019600844,3807400,1,0.3818
BSESN,10/20/2014,26429.84961,26517.90039,26368.93945,26434.16016,9300,321.320312,0.0,321.320312,50.8061264,25910.76953,26851.33008,55.1883746,-44.8116254,-108.488428,-58.08954228,-0.0051995140000000006,3816700,1,0.0
BSESN,10/21/2014,26575.65039,26615.41016,26407.0,26552.44922,8400,145.800782,0.0,145.800782,55.857085999999995,25910.76953,26851.33008,70.68985214,-29.31014786,-84.96823962,-63.46528175,0.011559075,3825100,1,-0.29600000000000004
BSESN,10/22/2014,26787.23047,26818.33008,26712.21094,26782.57031,6000,211.580078,0.0,211.580078,62.33281754,25910.76953,26851.33008,93.18495665,-6.815043349,-48.69425973,-60.51107734,0.020590763,3831100,1,-0.29600000000000004
BSESN,10/27/2014,26752.90039,26994.960939999997,26726.83984,26959.570310000003,6500,-34.330078,34.330078,0.0,60.66662347,25910.76953,26994.960939999997,77.67363351,-22.32636649,-22.4581363,-52.90048914,0.004340574,3824600,-1,0.0
BSESN,10/28/2014,26880.820310000003,26907.14063,26764.15039,26788.73047,6800,127.919922,0.0,127.919922,64.72110313,25910.76953,26994.960939999997,89.47228098,-10.52771902,8.557602455,-40.60887082,0.022186219,3831400,1,0.0
BSESN,10/29/2014,27098.16992,27126.30078,26971.160160000003,27017.43945,8100,217.349609,0.0,217.349609,70.65200703,25910.76953,27126.30078,97.68571487,-2.3142851330000003,50.09859049,-22.46737856,0.027065559,3839500,1,-0.4767
BSESN,10/30/2014,27346.33008,27390.59961,27088.65039,27098.93945,7000,248.160156,0.0,248.160156,75.97333956,25910.76953,27390.59961,97.00847201,-2.9915279910000003,101.87027629999999,2.400152415,0.037837774,3846500,1,-0.4404
BSESN,10/31/2014,27865.83008,27894.320310000003,27438.2793,27439.06055,11600,519.5,0.0,519.5,83.29125314,25910.76953,27894.320310000003,98.56367504,-1.436324961,182.712819,38.46268573,0.071789909,3858100,1,0.0
BSESN,11/3/2014,27860.38086,27969.820310000003,27785.40039,27943.039060000003,9500,-5.449219,5.449219,0.0,82.9853444,25910.76953,27969.820310000003,94.68495605,-5.315043949,243.53410060000002,79.4769687,0.067098822,3848600,-1,0.0
BSESN,11/5/2014,27915.88086,28010.39063,27857.65039,27907.18945,8700,55.5,0.0,55.5,83.6893411,25910.76953,28010.39063,95.49872278,-4.501277218999999,292.8381349,122.14920190000001,0.05622549,3857300,1,-0.29600000000000004
BSESN,11/7/2014,27868.63086,27980.929689999997,27739.56055,27902.710939999997,10500,-47.25,47.25,0.0,80.42066524,25910.76953,28010.39063,93.24831674,-6.751683262999999,324.36023430000006,162.5914084,0.048652825,3846800,-1,-0.6124
BSESN,11/10/2014,27874.73047,28027.960939999997,27764.75,27919.44922,7900,6.09961,0.0,6.09961,80.53391271,25910.76953,28027.960939999997,92.76255947,-7.237440531,345.8472014,199.24256699999998,0.040597702,3854700,1,0.29600000000000004
BSESN,11/11/2014,27910.06055,27996.91992,27790.40039,27911.25,7000,35.330078,0.0,35.330078,81.25839508,25910.76953,28027.960939999997,94.43128332,-5.568716679,361.55879500000003,231.70581260000003,0.043253634000000006,3861700,1,-0.2732
BSESN,11/12/2014,28008.90039,28126.48047,27958.64063,27958.64063,7000,98.839844,0.0,98.839844,83.26850274,26368.93945,28126.48047,93.30996677,-6.69003323,377.63277989999995,260.8912061,0.041965984000000005,3868700,1,0.0
BSESN,11/13/2014,27940.64063,28098.74023,27822.69922,28048.56055,8700,-68.259766,68.259766,0.0,76.71221905,26407.0,28126.48047,89.19209335,-10.80790665,380.4776268,284.8084902,0.031089579,3860000,-1,-0.2263
BSESN,11/14/2014,28046.660160000003,28093.23047,27912.90039,27949.539060000003,9900,106.019531,0.0,106.019531,79.59192424,26712.21094,28126.48047,94.35607490000001,-5.643925097,386.8279666,305.2123855,0.025609655,3869900,1,-0.5994
BSESN,11/17/2014,28177.88086,28205.710939999997,27921.339839999997,28018.679689999997,6700,131.22070300000001,0.0,131.22070300000001,82.65500525,26726.83984,28205.710939999997,98.11815383,-1.881846167,397.8627565,323.7424597,0.011198331,3876600,1,-0.2263
BSESN,11/18/2014,28163.289060000003,28282.84961,28119.94922,28209.0293,7300,-14.591795999999999,14.591795999999999,0.0,81.09331191,26764.15039,28282.84961,92.12743744,-7.872562557999999,400.8101808,339.1560039,0.010872363999999999,3869300,-1,0.0
BSESN,11/19/2014,28032.84961,28294.00977,27963.50977,28193.90039,6800,-130.439454,130.439454,0.0,67.86713707,26971.160160000003,28294.00977,80.25775908,-19.74224092,388.14635239999996,348.9540736,0.004190043,3862500,-1,0.0516
BSESN,11/20/2014,28067.56055,28118.5293,27915.23047,28100.839839999997,8700,34.710938,0.0,34.710938,69.39957188,27088.65039,28294.00977,81.21313662,-18.78686338,376.570193,354.4772975,0.007138121999999999,3871200,1,-0.5719
BSESN,11/21/2014,28334.63086,28360.660160000003,28038.40039,28100.09961,10100,267.070312,0.0,267.070312,78.50171373,27438.2793,28360.660160000003,97.17803153,-2.821968468,384.5139084,360.4846197,0.016498828,3881300,1,0.0
BSESN,11/24/2014,28499.539060000003,28541.960939999997,28394.48047,28413.00977,9700,164.908204,0.0,164.908204,82.26103134,27739.56055,28541.960939999997,94.71312882,-5.286871178,399.5107626,368.2898483,0.021120646,3891000,1,0.0
BSESN,11/25/2014,28338.05078,28541.2207,28217.5,28520.75977,10800,-161.488282,161.488282,0.0,68.68915197,27739.56055,28541.960939999997,74.58748035,-25.41251965,393.8253494,373.3969485,0.011751636000000001,3880200,-1,-0.34
BSESN,11/26/2014,28386.18945,28470.15039,28261.31055,28321.58008,8700,48.138672,0.0,48.138672,70.37054961,27739.56055,28541.960939999997,80.58681342,-19.41318658,388.7230497,376.4621687,0.015946263999999998,3888900,1,-0.5994
BSESN,11/27/2014,28438.910160000003,28498.30078,28307.58008,28397.80078,11900,52.720703,0.0,52.720703,72.25341851,27764.75,28541.960939999997,86.74095063,-13.25904937,384.50126919999997,378.06998880000003,0.013985622,3900800,1,0.0
BSESN,11/28/2014,28693.99023,28822.36914,28483.99023,28490.710939999997,14600,255.080078,0.0,255.080078,79.51925341,27790.40039,28822.36914,87.55980673,-12.44019327,397.1600939,381.8880098,0.018316117,3915400,1,0.4019
BSESN,12/1/2014,28559.61914,28809.64063,28538.43945,28748.2207,8300,-134.371093,134.371093,0.0,68.60033776,27822.69922,28822.36914,73.71632434,-26.28367566,391.832874,383.8769827,0.014072578,3907100,-1,-0.34
BSESN,12/2/2014,28444.00977,28576.39063,28386.460939999997,28522.460939999997,11200,-115.609375,115.609375,0.0,60.37090313,27822.69922,28822.36914,62.15156957,-37.84843043,373.9713941,381.895865,0.014667083999999999,3895900,-1,0.0
BSESN,12/3/2014,28442.710939999997,28504.65039,28370.73047,28472.320310000003,10100,-1.298828,1.298828,0.0,60.27716785,27912.90039,28822.36914,58.25494796,-41.74505204,355.6119646,376.6390849,0.013365978,3885800,-1,0.0
BSESN,12/4/2014,28562.820310000003,28808.7793,28448.94922,28616.929689999997,10400,120.109375,0.0,120.109375,65.92279893,27915.23047,28822.36914,71.38818617,-28.61181383,346.7566128,370.66259049999996,0.008053376999999999,3896200,1,0.0
BSESN,12/5/2014,28458.09961,28651.75,28409.05078,28604.5,7700,-104.720704,104.720704,0.0,57.67623972,27915.23047,28822.36914,59.8441183,-40.1558817,327.5132285,362.0327181,-0.0014540389999999999,3888500,-1,0.0
BSESN,12/8/2014,28119.40039,28494.84961,28097.11914,28433.0,9500,-338.69921800000003,338.69921800000003,0.0,39.32010144,27915.23047,28822.36914,22.50702437,-77.49297563,281.68541739999995,345.9632579,-0.007715788,3879000,-1,0.0
BSESN,12/9/2014,27797.00977,28157.5293,27763.820310000003,28134.2207,9600,-322.390625,322.390625,0.0,29.13586601,27763.820310000003,28822.36914,3.135372892,-96.86462711,216.85257620000002,320.1411216,-0.020755857,3869400,-1,0.4449
BSESN,12/10/2014,27831.09961,27905.25,27710.0293,27711.960939999997,9900,34.089843,0.0,34.089843,31.30666158,27710.0293,28822.36914,10.88429158,-89.11570842,166.3057785,289.374053,-0.021372497999999997,3879300,1,-0.6249
BSESN,12/11/2014,27602.00977,27796.339839999997,27539.4707,27796.339839999997,9800,-229.08984300000003,229.08984300000003,0.0,25.29766876,27539.4707,28822.36914,4.8748257189999995,-95.12517428,106.5333908,252.8059205,-0.038056069,3869500,-1,0.7096
BSESN,12/12/2014,27350.679689999997,27692.320310000003,27320.05078,27598.960939999997,10900,-251.330078,251.330078,0.0,20.35260891,27320.05078,28822.36914,2.038776055,-97.96122394,38.43999369,209.9327352,-0.042330377,3858600,-1,-0.7178
BSESN,12/15/2014,27319.56055,27392.179689999997,27105.039060000003,27136.2793,9100,-31.119141,31.119141,0.0,19.79966641,27105.039060000003,28822.36914,12.49156972,-87.50843028,-17.83003514,164.3801811,-0.039532022,3849500,-1,-0.29600000000000004
BSESN,12/16/2014,26781.43945,27199.36914,26736.23047,27181.179689999997,14300,-538.1210940000001,538.1210940000001,0.0,12.83961755,26736.23047,28822.36914,2.167113079,-97.83288692,-104.64008759999999,110.5761274,-0.058407635,3835200,-1,0.0
BSESN,12/17/2014,26710.13086,26871.910160000003,26469.41992,26724.00977,16600,-71.308594,71.308594,0.0,12.18471089,26469.41992,28822.36914,10.23017985,-89.76982015,-177.1496167,53.03097854,-0.06486367400000001,3818600,-1,0.0
BSESN,12/18/2014,27126.570310000003,27180.91992,26900.570310000003,27053.85938,11200,416.439454,0.0,416.439454,34.64687443,26469.41992,28809.64063,28.08070154,-71.91929846,-198.7200364,2.680775546,-0.046789115,3829800,1,0.0
BSESN,12/19/2014,27371.839839999997,27497.11914,27292.14063,27292.55078,11800,245.269531,0.0,245.269531,44.32481132,26469.41992,28808.7793,38.5755148,-61.42448520000001,-193.7896615,-36.61331187,-0.026585223999999998,3841600,1,-0.3384
BSESN,12/22/2014,27701.789060000003,27725.26953,27382.320310000003,27479.86914,7400,329.94921899999997,0.0,329.94921899999997,54.73055266,26469.41992,28808.7793,52.67977012,-47.32022988,-161.3976676,-61.57018302,-0.0034255740000000002,3849000,1,0.5859
BSESN,12/23/2014,27506.460939999997,27851.09961,27475.13086,27733.11914,8600,-195.328125,195.328125,0.0,48.53434347,26469.41992,28808.7793,44.33012846,-55.66987154,-149.7617659,-79.20849959,-0.011664601,3840400,-1,0.0
BSESN,12/24/2014,27208.60938,27571.25,27146.51953,27530.25977,10600,-297.851563,297.851563,0.0,40.47242389,26469.41992,28651.75,33.87156968,-66.12843032,-162.6988705,-95.90657377,-0.0142526,3829800,-1,-0.6908
BSESN,12/30/2014,27403.539060000003,27478.30078,27312.289060000003,27478.30078,6100,194.929688,0.0,194.929688,47.10700452,26469.41992,28494.84961,46.11955414,-53.88044586,-155.4307139,-107.8114018,0.0019326529999999999,3835900,1,0.0
BSESN,12/31/2014,27499.41992,27527.24023,27346.0,27358.30078,6500,95.880859,0.0,95.880859,50.25372168,26469.41992,28157.5293,61.01500384,-38.98499616,-140.3163835,-114.3123981,0.006583538000000001,3842400,1,0.0772
BSESN,1/2/2015,27887.90039,27937.4707,27519.25977,27521.2793,7400,388.48046899999997,0.0,388.48046899999997,61.07879804,26469.41992,27937.4707,96.62339255,-3.376607447,-95.88572953,-110.62706440000001,0.041314469,3849800,1,0.0
BSESN,1/5/2015,27842.320310000003,28064.49023,27786.84961,27978.429689999997,9200,-45.580078,45.580078,0.0,59.33094302,26469.41992,28064.49023,86.07146536,-13.92853464,-63.61869088,-101.2253897,0.042388015999999994,3840600,-1,-0.3612
BSESN,1/6/2015,26987.460939999997,27698.929689999997,26937.06055,27694.23047,14100,-854.859375,854.859375,0.0,36.64047221,26469.41992,28064.49023,32.47762886,-67.52237114,-105.8071584,-102.1417434,-0.005128159,3826500,-1,-0.34
BSESN,1/7/2015,26908.820310000003,27051.59961,26776.11914,26983.429689999997,12200,-78.640625,78.640625,0.0,35.21111044,26469.41992,28064.49023,27.54739949,-72.45260051,-143.9283477,-110.49906429999999,-0.016915908,3814300,-1,0.0
BSESN,1/8/2015,27274.710939999997,27316.410160000003,27101.93945,27178.76953,8200,365.890625,0.0,365.890625,46.43010905,26469.41992,28064.49023,50.48623938,-49.51376062,-142.9673111,-116.99271370000001,-0.015416987,3822500,1,-0.4767
BSESN,1/9/2015,27458.38086,27507.66992,27119.63086,27404.18945,11100,183.669921,0.0,183.669921,51.31324741,26469.41992,28064.49023,62.00108732,-37.99891268,-125.93337360000001,-118.7808456,-0.0017479560000000002,3833600,1,-0.8225
BSESN,1/12/2015,27585.26953,27620.660160000003,27323.74023,27523.85938,7500,126.888672,0.0,126.888672,54.61130818,26776.11914,28064.49023,62.80414039,-37.19585961,-101.03038459999999,-115.2307534,0.013843418,3841100,1,0.0
BSESN,1/13/2015,27425.73047,27670.18945,27324.58008,27611.56055,7800,-159.539062,159.539062,0.0,49.724653,26776.11914,28064.49023,50.42113499,-49.57886501,-93.09491509,-110.80358580000001,0.0008098010000000001,3833300,-1,0.0
BSESN,1/14/2015,27346.820310000003,27512.80078,27203.25,27432.14063,10200,-78.910156,78.910156,0.0,47.30872422,26776.11914,28064.49023,44.29633474,-55.70366526,-92.11158349,-107.06518529999998,-0.005549194,3823100,-1,0.0516
BSESN,1/15/2015,28075.55078,28194.60938,27703.69922,27831.160160000003,16700,728.730468,0.0,728.730468,65.28259332,26776.11914,28194.60938,91.60666805,-8.393331949,-32.1591173,-92.08397171,0.006728739,3839800,1,0.0
BSESN,1/16/2015,28121.89063,28176.09961,27945.31055,28056.60938,12100,46.339844,0.0,46.339844,66.1303079,26776.11914,28194.60938,94.87351070000001,-5.126489295,18.87529951,-69.89211746,0.0100412,3851900,1,0.0
BSESN,1/19/2015,28262.00977,28334.06055,28197.35938,28249.839839999997,10900,140.11914099999998,0.0,140.11914099999998,68.78918517,26776.11914,28334.06055,95.37525733,-4.624742671,69.82202137,-41.94928970000001,0.047227445,3862800,1,-0.7351
BSESN,1/20/2015,28784.66992,28829.289060000003,28324.84961,28324.84961,11100,522.6601559999999,0.0,522.6601559999999,76.67136319,26776.11914,28829.289060000003,97.82681694,-2.173183063,150.6355393,-3.432323896,0.069711328,3873900,1,0.4019
BSESN,1/21/2015,28888.85938,28958.09961,28792.570310000003,28843.089839999997,15400,104.189453,0.0,104.189453,77.95210206,26776.11914,28958.09961,96.82672531,-3.173274693,220.5457386,41.36328861,0.059181138,3889300,1,-0.3182
BSESN,1/22/2015,29006.01953,29060.410160000003,28892.23047,28957.789060000003,11100,117.160156,0.0,117.160156,79.41818642,26776.11914,29060.410160000003,97.61892751,-2.381072492,282.1514544,89.52092176,0.056363070999999994,3900400,1,-0.4767
BSESN,1/23/2015,29278.839839999997,29408.73047,29165.56055,29189.44922,11900,272.820313,0.0,272.820313,82.53801085,26776.11914,29408.73047,95.06609185,-4.933908155,348.96608330000004,141.4099541,0.06139401,3912300,1,0.0
BSESN,1/27/2015,29571.039060000003,29618.589839999997,29286.089839999997,29451.65039,11300,292.19921899999997,0.0,292.19921899999997,85.29300517,26776.11914,29618.589839999997,98.32713206,-1.672867937,420.64624510000004,197.25721230000002,0.078222478,3923600,1,0.0
BSESN,1/28/2015,29559.179689999997,29786.320310000003,29417.66992,29565.7207,11200,-11.859375,11.859375,0.0,84.66743782,27101.93945,29786.320310000003,91.53843524,-8.461564765,471.0661795,252.0190057,0.08090005900000001,3912400,-1,-0.5106
BSESN,1/29/2015,29681.76953,29740.63086,29378.30078,29516.49023,12700,122.58984299999999,0.0,122.58984299999999,85.9008133,27119.63086,29786.320310000003,96.07937918,-3.920620822,514.9799484,304.6111943,0.057210587,3925100,1,-0.4404
BSESN,1/30/2015,29182.94922,29844.160160000003,29070.48047,29801.59961,15800,-498.820312,498.820312,0.0,62.35202035,27203.25,29844.160160000003,74.96276291,-25.03723709,503.7246718,344.43388980000003,0.037730699,3909300,-1,-0.5106
BSESN,2/2/2015,29122.26953,29268.13086,28958.51953,29143.63086,18000,-60.679688,60.679688,0.0,60.04170374,27203.25,29844.160160000003,72.66508202,-27.33491798,484.3254381,372.4121994,0.030438733,3891300,-1,-0.5859
BSESN,2/3/2015,29000.14063,29253.06055,28900.410160000003,29217.40039,16600,-122.128906,122.128906,0.0,55.284544,27203.25,29844.160160000003,68.04058142,-31.95941858,453.86475319999994,388.7027102,0.007485606,3874700,-1,-0.5994
BSESN,2/4/2015,28883.10938,29133.61914,28824.679689999997,29129.84961,15800,-117.03125,117.03125,0.0,50.83148161,27703.69922,29844.160160000003,55.1007559,-44.8992441,415.4914702,394.0604622,-0.000199039,3858900,-1,0.4939
BSESN,2/5/2015,28850.9707,29277.83008,28753.289060000003,28912.38086,12800,-32.138672,32.138672,0.0,49.56640604,27945.31055,29844.160160000003,47.69520196,-52.30479804,378.1282179,390.8740133,-0.005345402,3846100,-1,0.0
BSESN,2/6/2015,28717.910160000003,28922.84961,28647.14063,28892.210939999997,11400,-133.06054699999999,133.06054699999999,0.0,44.29954078,28197.35938,29844.160160000003,31.60982112,-68.39017888,333.93134460000005,379.4854796,-0.019158194,3834700,-1,0.0
BSESN,2/9/2015,28227.39063,28566.5,28183.320310000003,28566.5,11700,-490.519531,490.519531,0.0,30.50973564,28183.320310000003,29844.160160000003,2.653495591,-97.34650441,256.368916,354.8621669,-0.045437985,3823000,-1,0.0
BSESN,2/10/2015,28355.61914,28633.7207,28044.49023,28122.48047,14600,128.22851599999998,0.0,128.22851599999998,36.47437349,28044.49023,29844.160160000003,17.28810951,-82.71189049,202.90810390000001,324.47135430000003,-0.040716981,3837600,1,0.0
BSESN,2/11/2015,28533.9707,28618.910160000003,28424.39063,28450.25977,13800,178.351562,0.0,178.351562,44.16570237,28044.49023,29844.160160000003,27.19834693,-72.80165307,172.9379841,294.16468019999996,-0.038670162,3851400,1,0.25
BSESN,2/12/2015,28805.09961,28838.51953,28406.25,28650.25,13800,271.12890600000003,0.0,271.12890600000003,53.94626974,28044.49023,29844.160160000003,42.26382659,-57.73617341,169.1148346,269.1547111,-0.012947616,3865200,1,0.5106
BSESN,2/13/2015,29094.929689999997,29154.66992,28835.69922,28888.99023,17600,289.830079,0.0,289.830079,62.12879967,28044.49023,29844.160160000003,58.36845086,-41.63154914,187.3126031,252.7862895,-0.000938795,3882800,1,-0.7269
BSESN,2/16/2015,29135.88086,29325.34961,29083.40039,29170.76953,10500,40.951171,0.0,40.951171,63.19490832,28044.49023,29844.160160000003,60.64393318,-39.35606682,202.7022576,242.76948309999997,0.004680675,3893300,1,0.8074
BSESN,2/18/2015,29320.25977,29411.320310000003,29126.910160000003,29136.070310000003,11000,184.378907,0.0,184.378907,67.89076823,28044.49023,29844.160160000003,70.88908452,-29.11091548,227.15797080000002,239.64718059999998,0.015135157,3904300,1,0.7269
BSESN,2/19/2015,29462.26953,29522.85938,29108.15039,29434.910160000003,11900,142.009765,0.0,142.009765,71.16075500000001,28044.49023,29844.160160000003,78.77996291,-21.22003709,255.05814930000003,242.72937439999998,0.021188155,3916200,1,0.0
BSESN,2/20/2015,29231.410160000003,29462.089839999997,29178.25977,29446.210939999997,11500,-230.859375,230.859375,0.0,59.74742254,28044.49023,29522.85938,80.28576146,-19.71423854,255.5944855,245.3023966,0.017880828,3904700,-1,0.0
BSESN,2/23/2015,28975.10938,29362.960939999997,28913.160160000003,29316.58008,8800,-256.30078100000003,256.30078100000003,0.0,49.56410065,28044.49023,29522.85938,62.94903723,-37.05096277,232.65628790000002,242.7731749,0.02648912,3895900,-1,0.0
BSESN,2/24/2015,29004.660160000003,29130.66992,28875.93945,29016.55078,10200,29.550781,0.0,29.550781,50.68235241,28044.49023,29522.85938,64.94791425,-35.05208575,214.3907392,237.0966877,0.022889326,3906100,1,0.0
BSESN,2/25/2015,29007.99023,29269.83008,28967.60938,29115.320310000003,8000,3.330078,0.0,3.330078,50.82412272,28044.49023,29522.85938,65.17316773,-34.82683227,197.902572,229.25786459999998,0.016612463,3914100,1,-0.5994
BSESN,2/26/2015,28746.65039,29069.13086,28693.820310000003,29051.90039,10700,-261.33984300000003,261.33984300000003,0.0,40.3268523,28044.49023,29522.85938,47.49559075,-52.50440925,161.8815695,215.78260559999998,-0.002029127,3903400,-1,0.0
BSESN,2/27/2015,29220.11914,29254.01953,28837.06055,28865.11914,16500,473.46875,0.0,473.46875,58.32175545,28044.49023,29522.85938,79.52201344,-20.47798656,169.584769,206.5430383,0.004302793,3919900,1,0.128
BSESN,3/2/2015,29459.14063,29576.320310000003,29259.76953,29533.41992,15300,239.021484,0.0,239.021484,64.54895927,28044.49023,29576.320310000003,92.35034684,-7.649653157,192.75469019999997,203.7853687,0.011094903,3935200,1,0.1027
BSESN,3/3/2015,29593.73047,29636.85938,29364.86914,29500.18945,12200,134.589844,0.0,134.589844,67.68585175,28406.25,29636.85938,96.49532119,-3.50467881,219.44763959999997,206.9178228,0.009327021999999999,3947400,1,0.0
BSESN,3/4/2015,29380.73047,30024.74023,29289.05078,29937.26953,17000,-213.0,213.0,0.0,58.27053622,28406.25,30024.74023,60.20922762,-39.79077238,220.8686381,209.7079859,-0.002767576,3930400,-1,0.0
BSESN,3/5/2015,29448.94922,29518.320310000003,29162.4707,29436.76953,13400,68.21875,0.0,68.21875,60.31077795,28693.820310000003,30024.74023,56.73736594,-43.26263406,224.90688619999997,212.7477659,0.007441963,3943800,1,-0.6249
BSESN,3/9/2015,28844.7793,29321.06055,28799.75977,29316.539060000003,11800,-604.1699219999999,604.1699219999999,0.0,40.21730402,28693.820310000003,30024.74023,11.34245431,-88.65754569,177.311823,205.6605774,-0.004498001,3932000,-1,-0.5574
BSESN,3/10/2015,28709.86914,28949.10938,28584.49023,28924.06055,11200,-134.910156,134.910156,0.0,37.03793922,28584.49023,30024.74023,8.705357195,-91.29464281,127.2395324,189.9763684,-0.010163574,3920800,-1,0.0
BSESN,3/11/2015,28659.16992,28843.23047,28608.179689999997,28725.75,12500,-50.699219,50.699219,0.0,35.81038432,28584.49023,30024.74023,5.185189238,-94.81481076,82.51469995,168.4840347,-0.012024973000000001,3908300,-1,-0.3182
BSESN,3/12/2015,28930.410160000003,28971.00977,28772.710939999997,28798.60938,11100,271.240234,0.0,271.240234,46.7126962,28584.49023,30024.74023,24.01804701,-75.98195299,68.17093593,148.4214149,0.006392389,3919400,1,0.0
BSESN,3/13/2015,28503.30078,29183.75977,28448.48047,29134.929689999997,11500,-427.109375,427.109375,0.0,35.69687409,28448.48047,30024.74023,3.477872951,-96.52212705,22.08466428,123.1540648,-0.024531671,3907900,-1,-0.4019
BSESN,3/16/2015,28437.710939999997,28581.820310000003,28384.089839999997,28546.31055,11100,-65.589843,65.589843,0.0,34.26508456,28384.089839999997,30024.74023,3.268282769,-96.73171723,-19.50672878,94.62190609,-0.034672759,3896800,-1,-0.2732
BSESN,3/17/2015,28736.38086,28784.34961,28435.44922,28595.0,11000,298.669921,0.0,298.669921,45.70693259,28384.089839999997,30024.74023,21.47264385,-78.52735615,-28.04475838,70.08857320000001,-0.02897065,3907800,1,-0.6369
BSESN,3/18/2015,28622.11914,28806.9707,28546.75977,28766.86914,9700,-114.26171799999999,114.26171799999999,0.0,42.4456361,28384.089839999997,30024.74023,14.50822786,-85.49177214,-43.5293943,47.3649797,-0.02582003,3898100,-1,0.0
BSESN,3/19/2015,28469.66992,28978.74023,28411.69922,28805.2207,11400,-152.449219,152.449219,0.0,38.24464989,28384.089839999997,30024.74023,5.216228791,-94.78377121,-67.32636135,24.42671149,-0.033253455,3886700,-1,-0.29600000000000004
BSESN,3/20/2015,28261.08008,28484.35938,28209.660160000003,28465.43945,13900,-208.589844,208.589844,0.0,33.0763094,28209.660160000003,30024.74023,2.832928565,-97.16707144,-101.8431025,-0.827251301,-0.020235871000000002,3872800,-1,0.0
BSESN,3/23/2015,28192.01953,28385.14063,28163.90039,28317.289060000003,10000,-69.060547,69.060547,0.0,31.45255223,28163.90039,30024.74023,1.511099416,-98.48890058,-133.2346315,-27.30872735,-0.018037338,3862800,-1,0.0
BSESN,3/24/2015,28161.7207,28455.320310000003,28130.089839999997,28209.33008,9700,-30.298828000000004,30.298828000000004,0.0,30.68987141,28130.089839999997,30024.74023,1.6694826219999999,-98.33051738,-158.7277915,-53.59254018,-0.017357419,3853100,-1,-0.3182
BSESN,3/25/2015,28111.83008,28249.59961,28031.41992,28216.089839999997,17400,-49.890625,49.890625,0.0,29.33822887,28031.41992,29518.320310000003,5.407904691000001,-94.59209531,-180.8720802,-79.04844819,-0.028294797000000003,3835700,-1,-0.2235
BSESN,3/26/2015,27457.58008,27997.14063,27384.86914,27937.61914,12700,-654.25,654.25,0.0,17.60568153,27384.86914,29321.06055,3.755358937,-96.24464106,-248.35125699999998,-112.90901000000001,-0.036687705,3823000,-1,0.4019
BSESN,3/27/2015,27458.64063,27694.410160000003,27248.44922,27649.7793,11400,1.060547,0.0,1.060547,17.66726513,27248.44922,29183.75977,10.86086191,-89.13913809,-298.30474219999996,-149.9881564,-0.034428591,3834400,1,-0.8316
BSESN,3/30/2015,27975.85938,28017.9707,27624.75977,27655.789060000003,11100,517.21875,0.0,517.21875,42.04332482,27248.44922,29183.75977,37.58622393,-62.41377607,-292.7829885,-178.5471228,-0.026465457999999997,3845500,1,-0.29600000000000004
BSESN,3/31/2015,27957.49023,28180.64063,27868.210939999997,28069.84961,11100,-18.369141,18.369141,0.0,41.53934505,27248.44922,29183.75977,36.63706665,-63.36293335,-286.5856145,-200.1548211,-0.023220814,3834400,-1,0.0
BSESN,4/1/2015,28260.14063,28298.339839999997,27889.01953,27954.85938,8100,302.650391,0.0,302.650391,52.38915715,27248.44922,29183.75977,52.27540394,-47.72459606,-254.32113790000002,-210.9880845,-0.007359737,3842500,1,0.0
BSESN,4/6/2015,28504.460939999997,28530.81055,28221.99023,28351.93945,8300,244.320313,0.0,244.320313,59.40661829,27248.44922,28978.74023,72.58962268,-27.41037732,-206.6545158,-210.12137080000002,0.008611874,3850800,1,0.0
BSESN,4/7/2015,28516.589839999997,28641.08008,28274.35938,28582.33008,11900,12.128906,0.0,12.128906,59.74646893,27248.44922,28978.74023,73.29059759,-26.70940241,-165.9862865,-201.2943539,0.011512844,3862700,1,-0.6124
BSESN,4/8/2015,28707.75,28763.06055,28566.60938,28601.49023,9800,191.160156,0.0,191.160156,65.06527164,27248.44922,28978.74023,84.33845916,-15.66154084,-116.9828888,-184.4320609,0.01938906,3872500,1,0.0
BSESN,4/9/2015,28885.210939999997,28906.710939999997,28622.43945,28858.41992,13100,177.460938,0.0,177.460938,69.39670285,27248.44922,28978.74023,94.59459159,-5.4054084079999996,-63.10034693,-160.1657181,0.027510867999999997,3885600,1,0.5574
BSESN,4/10/2015,28879.38086,28907.81055,28756.75,28889.26953,8000,-5.8300790000000005,5.8300790000000005,0.0,69.07206729,27248.44922,28907.81055,98.28670902,-1.713290983,-20.6306655,-132.25870759999998,0.051781722,3877600,-1,0.0
BSESN,4/13/2015,29044.43945,29072.50977,28843.93945,28955.13086,8500,165.058594,0.0,165.058594,73.17183966,27248.44922,29072.50977,98.46110848,-1.5388915159999998,26.04547606,-100.5978708,0.05775227,3886100,1,0.0
BSESN,4/15/2015,28799.68945,29094.60938,28721.63086,29087.25,10500,-244.75,244.75,0.0,59.64451714,27248.44922,29094.60938,84.02522549,-15.97477451,42.79407157,-71.91948236,0.029447892000000003,3875600,-1,-0.3818
BSESN,4/16/2015,28666.039060000003,28876.23047,28497.69922,28876.23047,8400,-133.65039,133.65039,0.0,53.42177736,27248.44922,29094.60938,76.78585411,-23.21414589,44.76693926,-48.58219804,0.025343792,3867200,-1,0.2732
BSESN,4/17/2015,28442.09961,28696.18945,28403.75977,28682.9707,13900,-223.939454,223.939454,0.0,44.45493759,27248.44922,29094.60938,64.65584181,-35.34415819,27.93835278,-33.27808787,0.006438715,3853300,-1,-0.5267
BSESN,4/20/2015,27886.210939999997,28539.460939999997,27802.36914,28525.65039,19000,-555.888671,555.888671,0.0,30.02175137,27248.44922,29094.60938,34.54530838,-65.45469162,-29.90921839,-32.60431398,-0.021689588,3834300,-1,0.0
BSESN,4/21/2015,27676.039060000003,27976.929689999997,27598.210939999997,27860.50977,20700,-210.171875,210.171875,0.0,26.2971066,27598.210939999997,29094.60938,5.201029557,-94.79897044,-91.65639132,-44.41472945,-0.029475852,3813600,-1,-0.4588
BSESN,4/22/2015,27890.13086,27947.25977,27385.48047,27756.679689999997,11700,214.091796,0.0,214.091796,35.67682202,27385.48047,29094.60938,29.52675999,-70.47324001,-121.9107409,-59.91393174,-0.028480781,3825300,1,-0.4939
BSESN,4/23/2015,27735.01953,28087.7793,27621.179689999997,27977.26953,11400,-155.11132800000001,155.11132800000001,0.0,32.24618433,27385.48047,29094.60938,20.45129895,-79.54870105,-156.59854819999998,-79.25085502,-0.039819387000000005,3813900,-1,0.4767
BSESN,4/24/2015,27437.93945,27829.10938,27344.69922,27804.58008,12000,-297.08007799999996,297.08007799999996,0.0,26.5947088,27344.69922,29094.60938,5.328286923,-94.67171308,-205.689702,-104.5386244,-0.049912476,3801900,-1,0.0
BSESN,4/27/2015,27176.99023,27567.2793,27141.55078,27565.49023,12100,-260.94921899999997,260.94921899999997,0.0,22.58326565,27141.55078,29094.60938,1.8145616880000002,-98.18543831,-262.6238519,-136.1556699,-0.064296273,3789800,-1,-0.2263
BSESN,4/28/2015,27396.38086,27482.14063,27073.25,27215.60938,10300,219.390625,0.0,219.390625,32.46522038,27073.25,29094.60938,15.98581939,-84.01418061,-286.7362688,-166.2717897,-0.048726517999999996,3800100,1,0.7159
BSESN,4/29/2015,27225.929689999997,27438.960939999997,27176.539060000003,27395.710939999997,9500,-170.451171,170.451171,0.0,29.13169616,27073.25,29094.60938,7.553317331000001,-92.44668267,-315.9573581,-196.2089034,-0.050237473,3790600,-1,0.0
BSESN,4/30/2015,27011.31055,27242.05078,26897.539060000003,27242.05078,10900,-214.619141,214.619141,0.0,25.35005334,26897.539060000003,29094.60938,5.1783269469999995,-94.82167305,-352.3713356,-227.4413898,-0.050305325,3779700,-1,0.4767
BSESN,5/4/2015,27490.589839999997,27537.84961,27159.44922,27204.63086,8300,479.279297,0.0,479.279297,44.06105801,26897.539060000003,29094.60938,26.99279935,-73.00720065,-338.652071,-249.6835261,-0.014186978999999999,3788000,1,0.0
BSESN,5/5/2015,27440.14063,27603.710939999997,27338.23047,27561.320310000003,11300,-50.449219,50.449219,0.0,42.75935347,26897.539060000003,29094.60938,24.69659524,-75.30340476,-328.0685157,-265.360524,-0.008523562,3776700,-1,0.34
BSESN,5/6/2015,26717.36914,27501.15039,26677.64063,27473.35938,14200,-722.771484,722.771484,0.0,28.72891612,26677.64063,28876.23047,1.806999887,-98.19300011,-373.69486839999996,-287.02739289999994,-0.042049344,3762500,-1,0.0
BSESN,5/7/2015,26599.10938,26850.36914,26423.99023,26721.33984,12500,-118.25976599999998,118.25976599999998,0.0,27.05304671,26423.99023,28696.18945,7.707032884,-92.29296712,-414.6172073,-312.54535580000004,-0.040955808999999996,3750000,-1,0.0
BSESN,5/8/2015,27105.39063,27196.2793,26814.38086,26814.38086,8800,506.28125,0.0,506.28125,43.37090883,26423.99023,28539.460939999997,32.210344,-67.78965600000001,-401.5667781,-330.34964019999995,-0.012120037,3758800,1,-0.6808
BSESN,5/11/2015,27507.30078,27544.24023,27231.2793,27249.41992,11300,401.91015600000003,0.0,401.91015600000003,53.00098829,26423.99023,28087.7793,65.11105110000001,-34.8889489,-354.7046143,-335.220635,0.012154052,3770100,1,0.0
BSESN,5/12/2015,26877.48047,27502.910160000003,26837.39063,27502.910160000003,12400,-629.8203120000001,629.8203120000001,0.0,40.53655132,26423.99023,28087.7793,27.256474100000005,-72.74352590000001,-364.1891022,-341.01432850000003,-0.018940472,3757700,-1,0.0
BSESN,5/13/2015,27251.09961,27299.80078,26750.00977,27023.710939999997,13600,373.61914,0.0,373.61914,48.78130308,26423.99023,28087.7793,49.71239404,-50.28760596,-337.66528969999996,-340.3445207,0.000924483,3771300,1,0.0
BSESN,5/14/2015,27206.06055,27293.99023,26948.61914,27290.16992,8900,-45.039062,45.039062,0.0,47.8583214,26423.99023,27829.10938,55.65864774,-44.34135226,-316.6293471,-335.60148599999997,0.007209943000000001,3762400,-1,-0.29600000000000004
BSESN,5/15/2015,27324.0,27379.570310000003,27159.75977,27233.90039,9300,117.939453,0.0,117.939453,50.67799037,26423.99023,27603.710939999997,76.29007128,-23.70992872,-287.1316084,-325.9075105,-0.006059886,3771700,1,-0.7184
BSESN,5/18/2015,27687.30078,27725.9707,27370.2793,27416.9707,7800,363.30078100000003,0.0,363.30078100000003,58.62964476,26423.99023,27725.9707,97.02991535,-2.970084646,-231.76743050000002,-307.0794945,0.009007248,3779500,1,0.0
BSESN,5/19/2015,27645.5293,27872.23047,27574.070310000003,27663.08008,10600,-41.771484,41.771484,0.0,57.40190999,26423.99023,27872.23047,84.34643877,-15.65356123,-189.08191169999998,-283.47997789999994,0.034739953,3768900,-1,0.0
BSESN,5/20/2015,27837.210939999997,27903.00977,27743.99023,27749.30078,16400,191.68164099999998,0.0,191.68164099999998,61.65358959,26423.99023,27903.00977,95.551186,-4.448814,-138.1932187,-254.4226261,0.04654673,3785300,1,0.0
BSESN,5/21/2015,27809.34961,27911.43945,27712.73047,27885.35938,8400,-27.861328999999998,27.861328999999998,0.0,60.63853749,26423.99023,27911.43945,93.13658290000001,-6.863417097,-98.97086469,-223.3322738,0.02597118,3776900,-1,0.6249
BSESN,5/22/2015,27957.5,28071.160160000003,27828.60938,27849.539060000003,17800,148.15039099999998,0.0,148.15039099999998,64.24978691,26423.99023,28071.160160000003,93.09967026,-6.90032974,-55.29496225,-189.7248115,0.016366536,3794700,1,0.6249
BSESN,5/25/2015,27643.88086,27903.289060000003,27614.320310000003,27893.25,8300,-313.619141,313.619141,0.0,52.48754329,26423.99023,28071.160160000003,74.05979242,-25.94020758,-45.46385948,-160.8726211,0.028514592000000002,3786400,-1,-0.4019
BSESN,5/26/2015,27531.410160000003,27675.93945,27473.539060000003,27633.660160000003,7100,-112.470703,112.470703,0.0,48.79141808,26423.99023,28071.160160000003,67.23167459999999,-32.768325399999995,-46.21534377,-137.9411656,0.010286211,3779300,-1,0.0
BSESN,5/27/2015,27564.660160000003,27595.80078,27363.7207,27447.40039,8600,33.25,0.0,33.25,49.99264339,26750.00977,28071.160160000003,61.66219956,-38.33780044,-43.62502128,-119.0779368,0.013180872,3787900,1,-0.743
BSESN,5/28/2015,27506.710939999997,27666.36914,27354.34961,27619.31055,9000,-57.949218,57.949218,0.0,47.74061644,26750.00977,28071.160160000003,57.27592996,-42.72407004,-45.72114473,-104.40657840000001,0.00668683,3778900,-1,0.0
BSESN,5/29/2015,27828.43945,27888.320310000003,27467.23047,27553.0293,12500,321.728515,0.0,321.728515,59.44402175,26750.00977,28071.160160000003,81.62807922,-18.37192078,-21.17741525,-87.76074573,0.005097595999999999,3791400,1,0.0
BSESN,6/1/2015,27848.99023,27959.429689999997,27737.58008,27770.789060000003,9600,20.550781,0.0,20.550781,60.10255802,26750.00977,28071.160160000003,83.18360092,-16.81639908,-0.067280956,-70.22205278,0.007359633000000001,3801000,1,0.0
BSESN,6/2/2015,27188.38086,27902.5293,27146.679689999997,27890.73047,14500,-660.609375,660.609375,0.0,37.51094856,26948.61914,28071.160160000003,21.358838100000003,-78.6411619,-36.22541898,-63.42272602,-0.023308013,3786500,-1,-0.3818
BSESN,6/3/2015,26837.19922,27276.2207,26698.25977,27230.679689999997,14000,-351.18164,351.18164,0.0,30.48275902,26698.25977,28071.160160000003,10.12014084,-89.87985916,-92.15610901,-69.16940261,-0.034957682000000004,3772500,-1,-0.4767
BSESN,6/4/2015,26813.41992,26948.839839999997,26551.9707,26940.64063,11600,-23.779297,23.779297,0.0,30.04297099,26551.9707,28071.160160000003,17.20978371,-82.79021629,-136.8231621,-82.70015451,-0.040922117,3760900,-1,0.1506
BSESN,6/5/2015,26768.49023,27014.41992,26718.43945,26819.82031,11900,-44.929688,44.929688,0.0,29.1268252,26551.9707,28071.160160000003,14.25230609,-85.74769391,-173.84361289999998,-100.92884620000001,-0.031666705,3749000,-1,-0.6124
BSESN,6/8/2015,26523.08984,26827.06055,26472.86914,26814.31055,7900,-245.40039,245.40039,0.0,24.43153704,26472.86914,28071.160160000003,3.142150117,-96.85784988,-220.44321519999997,-124.83171999999999,-0.036624361,3741100,-1,0.0
BSESN,6/9/2015,26481.25,26604.65039,26438.32031,26510.28906,11000,-41.839844,41.839844,0.0,23.68056481,26438.32031,28071.160160000003,2.629142545,-97.37085746,-257.77835319999997,-151.4210466,-0.039304318,3730100,-1,-0.128
BSESN,6/10/2015,26840.5,26934.74023,26493.28906,26517.32031,8400,359.25,0.0,359.25,41.4965294,26438.32031,28071.160160000003,24.63068798,-75.36931202,-255.43376490000003,-172.2235903,-0.024219942,3738500,1,0.0
BSESN,6/11/2015,26370.98047,27000.14063,26348.92969,26959.98047,11300,-469.519531,469.519531,0.0,30.69203092,26348.92969,27959.429689999997,1.369188513,-98.63081149,-288.1404602,-195.40696430000003,-0.052373004,3727200,-1,0.0
BSESN,6/12/2015,26425.30078,26489.58008,26307.07031,26340.32031,9600,54.320312,0.0,54.320312,33.02008948,26307.07031,27959.429689999997,7.155251442000001,-92.84474856,-306.14846769999997,-217.55526490000003,-0.051121762,3736800,1,0.0
BSESN,6/15/2015,26586.55078,26728.59961,26307.83984,26498.66992,11000,161.25,0.0,161.25,39.93116031,26307.07031,27959.429689999997,16.91402441,-83.08597559,-303.9051861,-234.8252492,-0.022135562,3747800,1,-0.29600000000000004
BSESN,6/16/2015,26686.50977,26731.34961,26379.92969,26586.85938,13100,99.958985,0.0,99.958985,44.059692299999995,26307.07031,27959.429689999997,22.96349443,-77.03650557,-290.7103863,-246.0022766,-0.0056149469999999995,3760900,1,0.0
BSESN,6/17/2015,26832.66016,26983.48047,26728.89063,26815.41016,23000,146.15039,0.0,146.15039,49.87205082,26307.07031,27959.429689999997,31.80844621,-68.19155379,-265.4009207,-249.8820054,0.00071756,3783900,1,-0.7269
BSESN,6/18/2015,27115.83008,27175.39063,26910.25977,26916.99023,10500,283.16992200000004,0.0,283.16992200000004,59.32116506,26307.07031,27959.429689999997,48.94575461,-51.05424539,-219.9580018,-243.89720469999997,0.012975698,3794400,1,0.5423
BSESN,6/19/2015,27316.16992,27404.59961,27202.38086,27207.75977,8100,200.339844,0.0,200.339844,64.74601246,26307.07031,27902.5293,63.24823259,-36.75176741,-165.8664054,-228.29104480000004,0.029901496,3802500,1,0.1531
BSESN,6/22/2015,27730.210939999997,27782.31055,27417.0293,27427.18945,8100,414.041016,0.0,414.041016,73.25214167,26307.07031,27782.31055,96.46839831,-3.5316016880000003,-88.56782111,-200.34640009999998,0.047163972,3810600,1,0.0
BSESN,6/23/2015,27804.36914,27882.660160000003,27666.589839999997,27760.10938,8600,74.158203,0.0,74.158203,74.52255026,26307.07031,27882.660160000003,95.03100281,-4.968997188,-21.08117825,-164.49335569999997,0.035910998,3819200,1,-0.1027
BSESN,6/24/2015,27729.66992,27948.24023,27647.289060000003,27852.320310000003,9400,-74.699219,74.699219,0.0,70.62392895,26307.07031,27948.24023,86.68204254,-13.31795746,26.07430143,-126.3798243,0.051522144000000006,3809800,-1,-0.29600000000000004
BSESN,6/25/2015,27895.9707,27968.75,27635.75977,27660.2207,10100,166.300781,0.0,166.300781,74.10395799,26307.07031,27968.75,95.62013681,-4.379863193,75.98849395,-85.90616064,0.055653857,3819900,1,0.0
BSESN,6/26/2015,27811.839839999997,27921.85938,27675.160160000003,27880.7207,9600,-84.130859,84.130859,0.0,69.31103467,26307.07031,27968.75,90.55713582,-9.442864183,107.5177957,-47.22136937,0.046086801,3810300,-1,-0.7003
BSESN,6/29/2015,27645.15039,27695.320310000003,27209.18945,27451.070310000003,10900,-166.68945300000001,166.68945300000001,0.0,60.38266688,26307.07031,27968.75,80.52575286,-19.47424714,117.6978017,-14.23753515,0.035922293,3799400,-1,-0.4404
BSESN,6/30/2015,27780.83008,27814.5293,27570.94922,27627.39063,9500,135.679687,0.0,135.679687,64.65839935,26307.07031,27968.75,88.69096593,-11.30903407,135.1557553,15.64112293,0.035336412000000005,3808900,1,0.0
BSESN,7/1/2015,28020.86914,28099.25,27799.910160000003,27823.65039,18400,240.039063,0.0,240.039063,71.03890697,26307.07031,28099.25,95.62650667,-4.373493326,166.4418178,45.80126191,0.033376779,3827300,1,0.128
BSESN,7/2/2015,27945.80078,28115.960939999997,27906.34961,28100.38086,6800,-75.06836,75.06836,0.0,66.69401679,26307.83984,28115.960939999997,90.5891172,-9.410882798,183.0685581,73.25472116,0.023049748999999998,3820500,-1,-0.8225
BSESN,7/3/2015,28092.789060000003,28135.429689999997,27897.44922,27973.11914,6000,146.988282,0.0,146.988282,70.73759823,26379.92969,28135.429689999997,97.57102677,-2.4289732269999997,205.73451609999998,99.75068015,0.013075203,3826500,1,0.0
BSESN,7/6/2015,28208.75977,28235.31055,27774.80078,27857.19922,8300,115.970703,0.0,115.970703,73.64991999,26728.89063,28235.31055,98.23749138,-1.7625086209999998,230.39941659999997,125.8804274,0.01454414,3834800,1,-0.8225
BSESN,7/7/2015,28171.68945,28335.23047,28084.35938,28220.10938,8000,-37.070313,37.070313,0.0,71.04213801,26910.25977,28335.23047,88.52320152,-11.47679848,244.14095849999998,149.5325337,0.01594031,3826800,-1,-0.1695
BSESN,7/8/2015,27687.7207,28031.44922,27635.7207,28031.44922,13700,-483.96875,483.96875,0.0,46.33037279999999,27202.38086,28335.23047,42.84238964,-57.15761036,213.5176969,162.3295663,-0.007465236,3813100,-1,-0.8481
BSESN,7/9/2015,27573.660160000003,27798.13086,27540.59961,27681.49023,8200,-114.060547,114.060547,0.0,42.32661901,27209.18945,28335.23047,32.36744469,-67.63255531,177.9930159,165.46225619999998,-0.008563966999999999,3804900,-1,0.0
BSESN,7/10/2015,27661.40039,27729.460939999997,27530.90039,27705.35938,10800,87.740235,0.0,87.740235,46.43520398,27209.18945,28335.23047,40.15936645,-59.84063355,155.1310992,163.39602480000002,0.000587807,3815700,1,-0.2732
BSESN,7/13/2015,27961.18945,28005.16992,27635.06055,27739.320310000003,7800,299.789062,0.0,299.789062,58.18042877,27209.18945,28335.23047,66.78264729,-33.21735271,159.36626230000002,162.59007230000003,0.006492224,3823500,1,0.5106
BSESN,7/14/2015,27932.90039,28018.589839999997,27853.960939999997,27986.91992,6900,-28.289062,28.289062,0.0,56.82379451,27209.18945,28335.23047,64.27038871,-35.72961129,158.6115929,161.7943764,-0.0031394009999999996,3816600,-1,-0.5106
BSESN,7/15/2015,28198.289060000003,28218.36914,27986.48047,28022.14063,6000,265.38867200000004,0.0,265.38867200000004,65.52535920000001,27209.18945,28335.23047,87.83868402,-12.16131598,177.3833946,164.91218,0.009034927,3822600,1,0.4767
BSESN,7/16/2015,28446.11914,28478.429689999997,28245.81055,28259.69922,8500,247.830078,0.0,247.830078,71.67607727,27209.18945,28478.429689999997,97.45433952,-2.545660475,209.8391041,173.8975649,0.012577251999999999,3831100,1,0.0
BSESN,7/17/2015,28463.31055,28576.320310000003,28417.460939999997,28480.91992,7300,17.191406,0.0,17.191406,72.07485129,27530.90039,28576.320310000003,89.1900122,-10.809987800000002,234.24743199999998,185.9675383,0.00902382,3838400,1,0.0
BSESN,7/20/2015,28420.11914,28549.13086,28319.83008,28544.2793,6600,-43.191406,43.191406,0.0,69.24855291,27530.90039,28576.320310000003,85.05852349999999,-14.941476500000002,247.25581110000002,198.2251929,0.008818415999999999,3831800,-1,-0.4767
BSESN,7/21/2015,28182.14063,28518.06055,28138.30078,28381.820310000003,11700,-237.978516,237.978516,0.0,55.42987562,27530.90039,28576.320310000003,62.2946072,-37.7053928,235.6457899,205.70931230000002,0.017857011000000002,3820100,-1,0.0
BSESN,7/22/2015,28504.929689999997,28546.41992,28070.910160000003,28159.41992,9500,322.789063,0.0,322.789063,66.036872,27530.90039,28576.320310000003,93.17110536,-6.8288946379999995,249.61375230000002,214.4902003,0.033773882000000005,3829600,1,0.0
BSESN,7/23/2015,28370.839839999997,28578.33008,28315.36914,28540.9707,8900,-134.089844,134.089844,0.0,59.27530504,27530.90039,28578.33008,80.1905334,-19.809466600000004,247.01608560000003,220.9953773,0.025647272000000002,3820700,-1,0.0
BSESN,7/24/2015,28112.31055,28402.64063,28083.75977,28390.5,9300,-258.52929700000004,258.52929700000004,0.0,48.27829606,27530.90039,28578.33008,55.50827547,-44.49172453,221.5424588,221.10479359999997,0.0054046730000000005,3811400,-1,0.0
BSESN,7/27/2015,27561.38086,28117.65039,27529.570310000003,28117.65039,9500,-550.9296879999999,550.9296879999999,0.0,33.15409896,27529.570310000003,28578.33008,3.0331585039999998,-96.9668415,155.11098169999997,207.9060313,-0.013300428000000001,3801900,-1,0.0
BSESN,7/28/2015,27459.23047,27676.65039,27416.39063,27630.210939999997,11800,-102.15039,102.15039,0.0,31.07164054,27416.39063,28578.33008,3.686925673,-96.31307433,93.14713261,184.9542515,-0.026209342000000004,3790100,-1,0.0
BSESN,7/29/2015,27563.429689999997,27609.289060000003,27470.089839999997,27540.460939999997,8600,104.199219,0.0,104.199219,35.81661693,27416.39063,28578.33008,12.65462349,-87.34537651,51.85063999,158.3335292,-0.031030224,3798700,1,0.1531
BSESN,7/30/2015,27705.34961,27854.460939999997,27649.9707,27685.820310000003,9400,141.919921,0.0,141.919921,42.08237552,27416.39063,28578.33008,24.86867825,-75.13132175,30.22619485,132.71206229999999,-0.026629402000000003,3808100,1,0.0
BSESN,7/31/2015,28114.56055,28161.16992,27814.50977,27814.50977,15000,409.210938,0.0,409.210938,56.28166088,27416.39063,28578.33008,60.08660092,-39.91339908,45.58311529,115.2862729,-0.010751489,3823100,1,-0.7351
BSESN,8/3/2015,28187.06055,28263.34961,28071.36914,28089.089839999997,10200,72.5,0.0,72.5,58.36816836,27416.39063,28578.33008,66.32616872,-33.67383128,62.87890064,104.8047985,0.000174576,3833300,1,-0.5267
BSESN,8/4/2015,28071.929689999997,28264.7207,27866.11914,28225.039060000003,13600,-115.13085900000002,115.13085900000002,0.0,53.6743654,27416.39063,28578.33008,56.41766112,-43.58233888,66.52893288,97.14962536,-0.015190355,3819700,-1,-0.4019
BSESN,8/5/2015,28223.08008,28315.710939999997,28135.679689999997,28138.039060000003,9800,151.15039,0.0,151.15039,58.704885600000004,27416.39063,28578.33008,69.42611777,-30.57388223,80.68806124,93.85731253,-0.005208155999999999,3829500,1,-0.29600000000000004
BSESN,8/6/2015,28298.13086,28359.960939999997,28163.68945,28291.88086,7500,75.050781,0.0,75.050781,61.1235309,27416.39063,28578.33008,75.88521344,-24.11478656,96.84883025,94.45561608,0.006609927,3837000,1,-0.1027
BSESN,8/7/2015,28236.39063,28335.66992,28193.929689999997,28327.10938,10300,-61.740233999999994,61.740233999999994,0.0,57.90434803,27416.39063,28578.33008,70.57166343,-29.42833657,103.4815642,96.2608057,0.024491145,3826700,-1,-0.9001
BSESN,8/10/2015,28101.7207,28417.589839999997,28017.84961,28250.7793,8700,-134.66992199999999,134.66992199999999,0.0,51.127303399999995,27416.39063,28578.33008,58.98156537,-41.01843463,96.75597372,96.35983929999999,0.023397968999999998,3818000,-1,0.0
BSESN,8/11/2015,27866.089839999997,28205.11914,27825.83008,28193.25977,14700,-235.630859,235.630859,0.0,41.35555115,27416.39063,28578.33008,38.70246576,-61.29753424,71.58724062,91.40531957,0.010980496999999999,3803300,-1,-0.5106
BSESN,8/12/2015,27512.25977,27883.33008,27479.429689999997,27880.75977,18200,-353.83007799999996,353.83007799999996,0.0,31.06744233,27416.39063,28417.589839999997,9.575431061,-90.42456894,22.82657752,77.68957116,-0.006969406,3785100,-1,-0.3818
BSESN,8/13/2015,27549.5293,27791.09961,27496.289060000003,27635.25,15900,37.269531,0.0,37.269531,33.0904473,27416.39063,28417.589839999997,13.29792008,-86.70207992,-12.66328515,59.61899989,-0.02009746,3801000,1,-0.2732
BSESN,8/14/2015,28067.31055,28100.64063,27643.19922,27668.06055,13200,517.78125,0.0,517.78125,54.49720619,27416.39063,28417.589839999997,65.01402614,-34.98597386,0.980065016,47.89121292,-0.0042484029999999996,3814200,1,0.0
BSESN,8/17/2015,27878.26953,28095.9707,27739.13086,28093.539060000003,12300,-189.04101599999998,189.04101599999998,0.0,48.02453442,27470.089839999997,28417.589839999997,43.07965034,-56.92034966,-3.4220643660000003,37.62855746,-0.0068987119999999996,3801900,-1,-0.8225
BSESN,8/18/2015,27831.539060000003,28040.73047,27747.40039,27949.13086,11800,-46.730468,46.730468,0.0,46.45092935,27479.429689999997,28417.589839999997,37.53190463,-62.46809537,-10.55981487,27.990883,-0.013873078999999998,3790100,-1,0.0
BSESN,8/19/2015,27931.64063,28021.39063,27721.25,27851.81055,10900,100.101562,0.0,100.101562,50.46284912,27479.429689999997,28417.589839999997,48.20189113,-51.79810887,-8.046419977000001,20.7834224,-0.01295104,3801000,1,0.0
BSESN,8/20/2015,27607.820310000003,27964.59961,27564.160160000003,27959.18945,14400,-323.820312,323.820312,0.0,39.43495098,27479.429689999997,28417.589839999997,13.68536323,-86.31463677,-31.81735861,10.2632662,-0.022261001000000002,3786600,-1,0.3818
BSESN,8/21/2015,27366.070310000003,27442.820310000003,27131.43945,27440.09961,14000,-241.75,241.75,0.0,33.18746413,27131.43945,28417.589839999997,18.24287903,-81.75712097,-69.36362269,-5.662111577999999,-0.026178126,3772600,-1,0.6124
BSESN,8/24/2015,25741.56055,26730.40039,25624.7207,26730.40039,26000,-1624.5097660000001,1624.5097660000001,0.0,14.89318351,25624.7207,28417.589839999997,4.183505854,-95.81649415,-227.5802654,-50.04574233,-0.076240668,3746600,-1,-0.4588
BSESN,8/25/2015,26032.38086,26124.83008,25298.41992,25916.25977,21200,290.820312,0.0,290.820312,23.5932633,25298.41992,28417.589839999997,23.53064935,-76.46935065,-325.746325,-105.18585890000001,-0.053789798,3767800,1,0.34
BSESN,8/26/2015,25714.66016,26156.60938,25657.56055,26063.26953,13400,-317.72070299999996,317.72070299999996,0.0,20.9000272,25298.41992,28417.589839999997,13.34458348,-86.65541652,-424.29008789999995,-169.00670469999997,-0.066602559,3754400,-1,0.29600000000000004
BSESN,8/27/2015,26231.18945,26302.76953,25943.75,26137.0293,18600,516.5292969999999,0.0,516.5292969999999,34.85065672,25298.41992,28417.589839999997,29.90441542,-70.09558458,-455.45690880000006,-226.29674550000001,-0.065418491,3773000,1,-0.1027
BSESN,8/28/2015,26392.38086,26687.33008,26270.16992,26542.83984,12100,161.191406,0.0,161.191406,38.74095183,25298.41992,28205.11914,37.63584928,-62.36415072,-461.8263924,-273.40267489999997,-0.053299172,3785100,1,0.0
BSESN,8/31/2015,26283.08984,26504.73047,26215.16016,26469.41992,10000,-109.29101499999999,109.29101499999999,0.0,37.01191386,25298.41992,28100.64063,35.13891397,-64.86108603,-470.27212130000004,-312.7765642,-0.055636492999999995,3775100,-1,-0.4019
BSESN,9/1/2015,25696.43945,26141.07031,25579.88086,26127.03906,14000,-586.650391,586.650391,0.0,28.99654795,25298.41992,28100.64063,14.20371816,-85.79628184,-518.3282406999999,-353.8868995,-0.080023984,3761100,-1,0.0
BSESN,9/2/2015,25453.56055,25939.36914,25395.08984,25891.94922,16200,-242.878906,242.878906,0.0,26.27802575,25298.41992,28100.64063,5.536345686000001,-94.46365431,-569.4471275000001,-396.9989451,-0.07803078,3744900,-1,-0.2732
BSESN,9/3/2015,25764.7793,25835.41016,25555.76953,25614.68945,11300,311.21875,0.0,311.21875,35.25294353,25298.41992,28095.9707,16.6702738,-83.3297262,-578.1815444,-433.2354649,-0.058513736,3756200,1,-0.8271
BSESN,9/4/2015,25201.90039,25775.38086,25119.06055,25772.58008,14100,-562.8789059999999,562.8789059999999,0.0,28.11112416,25119.06055,28040.73047,2.8353594419999997,-97.16464056,-623.337806,-471.25593319999996,-0.020964547,3742100,-1,-0.4939
BSESN,9/7/2015,24893.81055,25387.32031,24851.76953,25302.98047,12800,-308.08984399999997,308.08984399999997,0.0,24.92242148,24851.76953,28021.39063,1.326373555,-98.67362644,-676.1900463999999,-512.2427558,-0.043736695,3729300,-1,0.0
BSESN,9/8/2015,25317.86914,25411.0,24833.53906,24972.00977,12600,424.058594,0.0,424.058594,36.38297433,24833.53906,27964.59961,15.46856316,-84.53143684,-676.0645914,-545.0071228999999,-0.015430537,3741900,1,-0.8126
BSESN,9/9/2015,25719.58008,25820.56055,25553.60938,25682.86914,14400,401.710937,0.0,401.710937,45.47977439,24833.53906,27442.820310000003,33.95728287,-66.04271713,-636.2165437000001,-563.2490071000001,-0.019503857,3756300,1,0.0
BSESN,9/10/2015,25622.16992,25733.69922,25287.5,25522.96094,14600,-97.410156,97.410156,0.0,43.73018904,24833.53906,26730.40039,41.57556735,-58.42443265,-605.516843,-571.7025742999999,-0.029183079,3741700,-1,0.0
BSESN,9/11/2015,25610.21094,25875.96094,25530.41016,25793.76953,11800,-11.958984,11.958984,0.0,43.49317401,24833.53906,26687.33008,41.8964095,-58.1035905,-575.5178872,-572.4656369,-0.02560121,3729900,-1,-0.25
BSESN,9/14/2015,25856.69922,25891.73047,25531.07031,25706.86914,8800,246.488281,0.0,246.488281,49.94512173,24833.53906,26687.33008,55.19285333,-44.80714667,-525.7929406000001,-563.1310976,0.006236653000000001,3738700,1,0.0
BSESN,9/15/2015,25705.92969,25909.83008,25649.36914,25908.33984,11200,-150.769531,150.769531,0.0,46.22043963,24833.53906,26687.33008,47.05981515,-52.94018485,-492.8699058,-549.0788592,0.009914886,3727500,-1,-0.29600000000000004
BSESN,9/16/2015,25963.9707,26006.75,25816.5,25884.05078,9600,258.041015,0.0,258.041015,53.12395316,24833.53906,26687.33008,60.97945404,-39.02054596,-440.8742858,-527.4379445000001,0.0077311509999999995,3737100,1,0.1779
BSESN,9/18/2015,26218.91016,26471.82031,26130.35938,26130.35938,56600,254.939453,0.0,254.939453,59.10791004,24833.53906,26504.73047,82.89721261,-17.10278739,-374.77571789999996,-496.90549919999995,0.040354487,3793700,1,0.0
BSESN,9/21/2015,26192.98047,26233.46094,25972.53906,26107.98047,8100,-25.929687,25.929687,0.0,58.23547474,24833.53906,26471.82031,82.97973294,-17.02026706,-320.7866074,-461.68172089999996,0.05218847099999999,3785600,-1,0.0
BSESN,9/22/2015,25651.83984,26339.09961,25571.33984,26274.36914,13600,-541.140625,541.140625,0.0,42.96472314,24833.53906,26471.82031,49.94873627,-50.05126373,-317.99967200000003,-432.9453111,0.013191106000000001,3772000,-1,-0.3612
BSESN,9/23/2015,25822.99023,25934.01953,25386.48047,25526.5293,11700,171.15039,0.0,171.15039,47.94601969,24833.53906,26471.82031,60.39568426,-39.60431574,-298.5392251,-406.0640939,0.004020678,3783700,1,-0.0572
BSESN,9/24/2015,25863.5,25949.90039,25670.96094,25798.05078,11800,40.509766,0.0,40.509766,49.15869703,24833.53906,26471.82031,62.86838337,-37.13161663,-276.6587316,-380.1830214,0.009418799,3795500,1,0.2732
BSESN,9/28/2015,25616.83984,25936.89063,25593.56055,25922.71094,11700,-246.660156,246.660156,0.0,42.24440537,24833.53906,26471.82031,47.81235096,-52.18764904,-276.03968230000004,-359.3543536,0.000258838,3783800,-1,0.0
BSESN,9/29/2015,25778.66016,26054.36914,25287.33008,25496.38086,20700,161.820312,0.0,161.820312,47.80195684,24833.53906,26471.82031,57.6897949,-42.310205100000005,-259.500178,-339.3835185,-0.003018137,3804500,1,0.29600000000000004
BSESN,9/30/2015,26154.83008,26179.69922,25918.21094,25986.51953,27500,376.16992200000004,0.0,376.16992200000004,58.51042519,25287.33008,26471.82031,73.23825679,-26.76174321,-213.5767529,-314.22216539999994,0.017462912,3832000,1,0.0
BSESN,10/1/2015,26220.94922,26431.80078,26168.71094,26344.18945,11000,66.119141,0.0,66.119141,60.16771844,25287.33008,26471.82031,78.82033244,-21.17966756,-169.888477,-285.35542769999995,0.009897504,3843000,1,0.0
BSESN,10/5/2015,26785.55078,26822.41992,26375.31055,26379.41992,11400,564.6015620000001,0.0,564.6015620000001,71.41711484,25287.33008,26822.41992,97.59824214,-2.401757861,-88.68427889,-246.02119790000003,0.021611906,3854400,1,0.0
BSESN,10/6/2015,26932.88086,27010.26953,26751.25,26976.660160000003,13600,147.33007800000001,0.0,147.33007800000001,73.65714625,25287.33008,27010.26953,95.50833479,-4.49166521,-12.29928238,-199.2768148,0.028248041,3868000,1,0.4215
BSESN,10/7/2015,27035.84961,27082.2793,26877.50977,26966.85938,17100,102.96875,0.0,102.96875,75.22302542,25287.33008,27082.2793,97.41331468,-2.586685323,55.90070671,-148.2413105,0.053953626,3885100,1,-0.5267
BSESN,10/8/2015,26845.81055,27120.10938,26762.35938,27116.85938,14900,-190.039062,190.039062,0.0,66.77086427,25287.33008,27120.10938,85.03372291,-14.96627709,93.53689029,-99.88567036,0.039608903,3870200,-1,0.0
BSESN,10/9/2015,27079.50977,27200.43945,26910.589839999997,26974.91992,18800,233.699219,0.0,233.699219,71.34019409,25287.33008,27200.43945,93.67889319,-6.321106811,140.600654,-51.78840549,0.047016443,3889000,1,0.1027
BSESN,10/12/2015,26904.10938,27305.039060000003,26855.75,27242.59961,18400,-175.40039099999998,175.40039099999998,0.0,63.7487197,25287.33008,27305.039060000003,80.12945915,-19.87054085,161.87963249999999,-9.054797898,0.050250910999999995,3870600,-1,0.0
BSESN,10/13/2015,26846.5293,26918.51953,26719.09961,26874.289060000003,10800,-57.580078,57.580078,0.0,61.27875156,25287.33008,27305.039060000003,77.27572363,-22.72427637,172.1131321,27.1787881,0.04142454,3859800,-1,0.5046
BSESN,10/14/2015,26779.66016,26869.08008,26713.2793,26760.32031,10900,-66.869141,66.869141,0.0,58.25428251,25287.33008,27305.039060000003,73.96161137,-26.03838863,172.8351376,56.310058,0.023889663,3848900,-1,-0.5106
BSESN,10/15/2015,27010.14063,27037.94922,26836.76953,26842.18945,12700,230.480469,0.0,230.480469,65.10398043,25287.33008,27305.039060000003,85.38449101,-14.61550899,189.81708659999998,83.01146371,0.030097744,3861600,1,0.0
BSESN,10/16/2015,27214.59961,27239.2207,26917.11914,27062.80078,10200,204.45898400000002,0.0,204.45898400000002,70.12198652,25287.33008,27305.039060000003,95.51771565,-4.482284347,217.26899300000002,109.8629696,0.016017921,3871800,1,0.6369
BSESN,10/19/2015,27364.91992,27387.910160000003,27246.789060000003,27305.61914,8200,150.320313,0.0,150.320313,73.37045341,25287.33008,27387.910160000003,98.90552928,-1.094470725,248.292261,137.54882790000002,0.016041324,3880000,1,0.7096
BSESN,10/20/2015,27306.83008,27432.070310000003,27216.40039,27402.90039,9200,-58.08984399999999,58.08984399999999,0.0,69.9779642,25918.21094,27432.070310000003,91.72708925,-8.272910752,265.1347511,163.0660125,0.010023005,3870800,-1,0.0
BSESN,10/21/2015,27287.660160000003,27445.24023,27190.55078,27312.34961,9700,-19.169922,19.169922,0.0,68.76723539,26168.71094,27445.24023,87.65558468,-12.34441532,273.77973110000005,185.20875619999998,0.016458792,3861100,-1,0.34
BSESN,10/23/2015,27470.81055,27555.06055,27421.710939999997,27466.64063,9900,183.15039099999998,0.0,183.15039099999998,73.77008908,26375.31055,27555.06055,92.8586565,-7.141343505,292.0431542,206.57563580000001,0.014450069,3871000,1,0.0
BSESN,10/26/2015,27361.960939999997,27618.14063,27318.19922,27575.039060000003,11300,-108.84960900000002,108.84960900000002,0.0,66.46891212,26713.2793,27618.14063,71.68851413,-28.31148587,294.3408171,224.1286721,0.017017904,3859700,-1,0.0
BSESN,10/27/2015,27253.43945,27296.30078,27209.51953,27291.06055,10100,-108.52148500000001,108.52148500000001,0.0,59.67469338,26713.2793,27618.14063,59.69535213,-40.30464787,284.1296845,236.1288746,0.0151569,3849600,-1,0.0
BSESN,10/28/2015,27039.75977,27163.98047,26919.960939999997,27131.710939999997,10500,-213.679687,213.679687,0.0,48.42825114,26713.2793,27618.14063,36.08071855,-63.91928145,255.8458912,240.07227790000002,0.009712581,3839100,-1,0.0
BSESN,10/29/2015,26838.14063,27099.10938,26794.09961,27083.69922,9900,-201.61914099999998,201.61914099999998,0.0,40.18331729,26713.2793,27618.14063,13.79894622,-86.20105378,214.68702319999997,234.995227,-0.006367979,3829200,-1,0.0
BSESN,10/30/2015,26656.83008,26942.289060000003,26585.19922,26878.48047,14000,-181.31054699999999,181.31054699999999,0.0,34.15044689,26585.19922,27618.14063,6.934648817999999,-93.06535118,165.5299517,221.1021719,-0.020495232,3815200,-1,0.0
BSESN,11/2/2015,26559.15039,26824.30078,26378.25977,26641.68945,8800,-97.679687,97.679687,0.0,31.23534577,26378.25977,27618.14063,14.5893554,-85.4106446,117.3380835,200.3493542,-0.029445346,3806400,-1,0.0
BSESN,11/3/2015,26590.58984,26732.24023,26514.48047,26660.71094,8500,31.439453000000004,0.0,31.439453000000004,33.34828587,26378.25977,27618.14063,17.12503879,-82.87496121,80.75172632,176.42982859999998,-0.026229343999999998,3814900,1,0.0
BSESN,11/4/2015,26552.91992,26800.06055,26510.31055,26704.01953,8000,-37.669922,37.669922,0.0,31.98936194,26378.25977,27618.14063,14.08684994,-85.91315006,48.16194582,150.7762521,-0.026925732,3806900,-1,0.34
BSESN,11/5/2015,26304.19922,26557.80078,26243.19922,26557.80078,12300,-248.720703,248.720703,0.0,24.41104021,26243.19922,27618.14063,4.436552695,-95.56344731,2.2388201569999997,121.06876570000001,-0.042467305999999996,3794600,-1,-0.802
BSESN,11/6/2015,26265.24023,26438.85938,26190.17969,26284.00977,15600,-38.958985,38.958985,0.0,23.4087593,26190.17969,27618.14063,5.256484548,-94.74351545,-36.87418958,89.48017464,-0.040081948,3779000,-1,-0.29600000000000004
BSESN,11/9/2015,26121.40039,26193.16992,25656.90039,25809.0,13300,-143.839843,143.839843,0.0,19.92381973,25656.90039,27618.14063,23.68399301,-76.31600699,-78.57247027,55.86964566,-0.041537475,3765700,-1,0.0
BSESN,11/10/2015,25743.25977,26094.08984,25709.23047,26094.08984,12800,-378.140625,378.140625,0.0,13.72556785,25656.90039,27618.14063,4.403304272,-95.59669573,-140.5117147,16.59337358,-0.047947910999999996,3752900,-1,0.0
BSESN,11/13/2015,25610.5293,25724.08984,25540.73047,25724.08984,11500,-132.730469,132.730469,0.0,12.18969691,25540.73047,27618.14063,3.35989635,-96.64010365,-198.0265253,-26.33060619,-0.045741295999999994,3741400,-1,0.7003
BSESN,11/16/2015,25760.09961,25866.41992,25451.41992,25580.15039,11300,149.570312,0.0,149.570312,23.34289673,25451.41992,27618.14063,14.24639948,-85.75360052,-228.89973909999998,-66.84443279,-0.033639801000000004,3752700,1,-0.5267
BSESN,11/17/2015,25864.4707,25948.19922,25732.78906,25897.88086,10700,104.371094,0.0,104.371094,30.45506844,25451.41992,27296.30078,22.38902198,-77.61097802,-242.1537113,-101.9062885,-0.026155945,3763400,1,0.0
BSESN,11/18/2015,25482.51953,25890.35938,25453.32031,25837.71094,16100,-381.95117200000004,381.95117200000004,0.0,21.882339399999996,25451.41992,27163.98047,1.8159713569999998,-98.18402864,-280.24733039999995,-137.5744969,-0.041671521,3747300,-1,-0.7906
BSESN,11/19/2015,25841.91992,25884.51953,25603.09961,25640.33984,9900,359.400391,0.0,359.400391,40.16803187,25451.41992,27099.10938,23.69985432,-76.30014568,-278.2289401,-165.7053855,-0.026776716000000002,3757200,1,-0.4215
BSESN,11/20/2015,25868.49023,26058.75977,25769.81055,25856.13086,10000,26.570312,0.0,26.570312,41.33935054,25451.41992,26942.289060000003,27.97497785,-72.02502215,-271.35731089999996,-186.8357706,-0.016564237,3767200,1,0.0
BSESN,11/23/2015,25819.33984,25958.03906,25747.00977,25945.14063,10100,-49.15039,49.15039,0.0,39.68127022,25451.41992,26824.30078,26.79911513,-73.20088487,-266.8019936,-202.8290152,-0.016976825,3757100,-1,0.0
BSESN,11/24/2015,25775.74023,25901.56055,25703.85938,25785.60938,7500,-43.59961,43.59961,0.0,38.11647266,25451.41992,26800.06055,24.04794176,-75.95205824,-263.6705659,-214.9973253,-0.013232833999999999,3749600,-1,0.4939
BSESN,11/26/2015,25958.63086,26016.03906,25769.81055,25769.81055,8400,182.890625,0.0,182.890625,48.03486725,25451.41992,26800.06055,37.60905074,-62.39094926,-243.62280980000003,-220.7224222,0.008366116,3758000,1,0.0
BSESN,11/27/2015,26128.19922,26184.65039,25937.32031,26003.19922,10400,169.56836,0.0,169.56836,55.64078248,25451.41992,26557.80078,61.17055366,-38.82944634,-211.61272940000003,-218.9004837,0.020213168,3768400,1,0.0
BSESN,11/30/2015,26145.66992,26231.06055,26089.13086,26142.5293,8300,17.470703,0.0,17.470703,56.39943864,25451.41992,26438.85938,70.3081083,-29.691891700000003,-182.72839109999998,-211.6660651,0.014967734,3776700,1,-0.34
BSESN,12/1/2015,26169.41016,26246.01953,26121.51953,26201.26953,11000,23.740234,0.0,23.740234,57.53807057,25451.41992,26246.01953,90.35874494,-9.641255059,-156.1220289,-200.55725790000002,0.011789896999999999,3787700,1,0.128
BSESN,12/2/2015,26117.84961,26256.41992,26041.67969,26239.39063,10100,-51.560547,51.560547,0.0,54.00382879,25451.41992,26256.41992,82.78629652,-17.21370348,-137.610512,-187.96790869999998,0.024931996,3777600,-1,-0.8225
BSESN,12/3/2015,25886.61914,26123.85938,25857.34961,26123.85938,9500,-231.23046800000003,231.23046800000003,0.0,40.97886931,25451.41992,26256.41992,54.06201478,-45.93798522,-139.9847112,-178.37126919999997,0.0017297170000000002,3768100,-1,0.0
BSESN,12/4/2015,25638.10938,25810.06055,25623.71094,25810.06055,10500,-248.509766,248.509766,0.0,31.54435095,25451.41992,26256.41992,23.191236399999998,-76.80876359999999,-160.0737124,-174.71175780000002,-0.008905849,3757600,-1,0.0
BSESN,12/7/2015,25530.10938,25785.5293,25477.68945,25746.0293,8700,-108.0,108.0,0.0,28.27952472,25453.32031,26256.41992,9.561586276,-90.43841372,-182.604141,-176.2902345,-0.011202086000000002,3748900,-1,0.1779
BSESN,12/8/2015,25310.33008,25542.4707,25256.78906,25488.41992,12600,-219.779297,219.779297,0.0,22.75058377,25256.78906,26256.41992,5.356078648,-94.64392135,-215.707479,-184.17368340000002,-0.018056132,3736300,-1,0.0
BSESN,12/9/2015,25036.05078,25316.94922,25012.2207,25299.33984,11600,-274.27929700000004,274.27929700000004,0.0,17.75267969,25012.2207,26256.41992,1.915294403,-98.08470559999999,-261.06476769999995,-199.55190019999998,-0.035540398,3724700,-1,-0.6597
BSESN,12/10/2015,25252.32031,25289.58008,25034.14063,25136.71094,10900,216.26953199999997,0.0,216.26953199999997,31.45308736,25012.2207,26256.41992,19.29752136,-80.70247864,-276.3737376,-214.91626769999996,-0.03352236,3735600,1,-0.3182
BSESN,12/11/2015,25044.42969,25316.14063,24930.42969,25281.76953,14900,-207.890625,207.890625,0.0,26.54814999,24930.42969,26256.41992,8.597348387,-91.40265161,-301.802254,-232.293465,-0.042119412,3720700,-1,-0.836
BSESN,12/14/2015,25150.34961,25194.15039,24867.73047,24935.59961,11600,105.919921,0.0,105.919921,32.71650522,24867.73047,26256.41992,20.35150043,-79.64849957,-309.83608660000004,-247.8019893,-0.038940906000000004,3732300,1,-0.2732
BSESN,12/15/2015,25320.43945,25342.7793,25075.53906,25186.67969,9700,170.089844,0.0,170.089844,41.77624079,24867.73047,26256.41992,32.59972797,-67.40027203,-299.0310836,-258.0478082,-0.030531232999999998,3742000,1,-0.2732
BSESN,12/16/2015,25494.36914,25572.90039,25372.4707,25402.4707,10800,173.929688,0.0,173.929688,49.75829371,24867.73047,26256.41992,45.12446398,-54.87553602,-273.2831309,-261.0948727,-0.015152616,3752800,1,0.0
BSESN,12/17/2015,25803.7793,25831.31055,25448.32031,25596.63086,22700,309.41015600000003,0.0,309.41015600000003,60.79153179,24867.73047,26256.41992,67.40519459,-32.59480541,-225.31360409999996,-253.938619,0.006461862,3775500,1,-0.4588
BSESN,12/18/2015,25519.2207,25789.50977,25481.50977,25764.66992,10400,-284.55859399999997,284.55859399999997,0.0,49.30230329,24867.73047,26256.41992,46.91403341,-53.08596659,-207.862796,-244.72345440000004,-0.000426503,3765100,-1,-0.4767
BSESN,12/21/2015,25735.90039,25757.83984,25413.53906,25425.32031,8100,216.679688,0.0,216.679688,56.52189716,24867.73047,26256.41992,62.51721147,-37.48278853,-174.53671430000003,-230.68610640000003,0.016814096,3773200,1,0.0
BSESN,12/22/2015,25590.65039,25787.21094,25485.16992,25731.07031,8100,-145.25,145.25,0.0,50.91391204,24867.73047,26123.85938,57.551412,-42.448588,-158.0244086,-216.1537668,0.02215204,3765100,-1,0.6908
BSESN,12/23/2015,25850.30078,25875.26953,25689.69922,25697.66016,6900,259.65039,0.0,259.65039,59.25280796,24867.73047,25875.26953,97.52180824,-2.478191759,-122.5737173,-197.4377569,0.023680219,3772000,1,0.0
BSESN,12/24/2015,25838.71094,25922.4707,25763.40039,25893.83984,4900,-11.589843,11.589843,0.0,58.73886824,24867.73047,25922.4707,92.05873045,-7.941269547,-94.32665356,-176.8155362,0.031714887000000004,3767100,-1,0.0
BSESN,12/28/2015,26034.13086,26073.41016,25856.85938,25858.51953,6900,195.419921,0.0,195.419921,64.69634208,24867.73047,26073.41016,96.74214491,-3.257855086,-55.53176204,-152.55878140000002,0.035139919,3774000,1,0.0
BSESN,12/29/2015,26079.48047,26133.7793,25994.44922,26075.67969,6000,45.34961,0.0,45.34961,66.0104151,24867.73047,26133.7793,95.71115846,-4.2888415360000005,-20.886430700000002,-126.2243113,0.029977403,3780000,1,0.128
BSESN,12/30/2015,25960.0293,26130.19922,25939.25,26123.86914,6500,-119.451172,119.451172,0.0,59.30180613,24867.73047,26133.7793,86.27620072,-13.72379928,-3.033499007,-101.5861488,0.018265216,3773500,-1,0.0
BSESN,12/31/2015,26117.53906,26147.63086,25941.91016,25980.85938,6200,157.50976599999998,0.0,157.50976599999998,64.75208175,24867.73047,26147.63086,97.64889547,-2.351104526,23.55329205,-76.55826064,0.01215945,3779700,1,0.0
BSESN,1/4/2016,25623.34961,26116.51953,25596.57031,26116.51953,9100,-494.189454,494.189454,0.0,43.60948979,24867.73047,26147.63086,59.03733962,-40.96266038,4.692464864,-60.30811554,0.004080411,3770600,-1,0.0
BSESN,1/5/2016,25580.33984,25766.75977,25513.75,25744.69922,10300,-43.009765,43.009765,0.0,42.224981799999995,25075.53906,26147.63086,47.08559313,-52.91440687,-13.56899028,-50.96029049,-0.006044496,3760300,-1,-0.3182
BSESN,1/6/2016,25406.33008,25632.57031,25357.69922,25628.23047,13400,-174.00976599999998,174.00976599999998,0.0,36.77470981,25357.69922,26147.63086,6.156337655,-93.84366235,-41.60288672,-49.08880973,-0.007202643000000001,3746900,-1,-0.29600000000000004
BSESN,1/7/2016,24851.83008,25230.34961,24825.69922,25224.69922,11800,-554.5,554.5,0.0,24.93882875,24825.69922,26147.63086,1.9767178730000001,-98.02328213,-107.326277,-60.73630318,-0.03862511,3735100,-1,-0.6124
BSESN,1/8/2016,24934.33008,25083.55078,24887.2207,24969.01953,15900,82.5,0.0,82.5,28.86899213,24825.69922,26147.63086,8.217585215,-91.78241479,-151.0146736,-78.79197725,-0.035001005,3751000,1,0.4767
BSESN,1/11/2016,24825.03906,24961.88086,24598.90039,24787.10938,10600,-109.29101499999999,109.29101499999999,0.0,26.729710600000004,24598.90039,26147.63086,14.60155118,-85.39844882,-192.2408809,-101.481758,-0.046442564000000006,3740400,-1,0.4019
BSESN,1/12/2016,24682.0293,24882.30078,24597.10938,24862.92969,10300,-143.00976599999998,143.00976599999998,0.0,24.04003135,24597.10938,26147.63086,5.476862003,-94.523138,-233.7580233,-127.93701100000001,-0.053584318,3730100,-1,0.0
BSESN,1/13/2016,24854.10938,24956.53906,24387.68945,24804.64063,14000,172.08007800000001,0.0,172.08007800000001,33.35133512,24387.68945,26147.63086,26.50201424,-73.49798576,-249.89460409999998,-152.3285297,-0.042600873,3744100,1,0.7579
BSESN,1/14/2016,24772.9707,25018.46094,24473.2207,24606.19922,14900,-81.138672,81.138672,0.0,31.26614678,24387.68945,26147.63086,21.89170893,-78.10829107,-266.16202319999996,-175.0952284,-0.051481434000000006,3729200,-1,0.0
BSESN,1/15/2016,24455.03906,24912.64063,24421.5293,24881.75977,12700,-317.93164,317.93164,0.0,24.37575517,24387.68945,26147.63086,3.826809789,-96.17319021,-301.2360349,-200.32338969999998,-0.045595542999999995,3716500,-1,0.0
BSESN,1/18/2016,24188.36914,24524.84961,24141.99023,24400.7793,13600,-266.66992200000004,266.66992200000004,0.0,20.0907294,24141.99023,26147.63086,2.312423593,-97.68757641,-346.5555986,-229.5698315,-0.054415645,3702900,-1,0.0
BSESN,1/19/2016,24479.83984,24563.33984,24247.23047,24257.2793,9400,291.47070299999996,0.0,291.47070299999996,34.59169807,24141.99023,26147.63086,16.84497241,-83.15502759,-354.8618037,-254.62822590000002,-0.036466905,3712300,1,-0.2617
BSESN,1/20/2016,24062.03906,24325.76953,23839.75977,24325.76953,12800,-417.80078100000003,417.80078100000003,0.0,26.60615848,23839.75977,26147.63086,9.631356693999999,-90.36864331,-390.6543422,-281.8334492,-0.031779994,3699500,-1,-0.8481
BSESN,1/21/2016,23962.21094,24351.83008,23862.0,24194.75,13200,-99.828125,99.828125,0.0,25.01413507,23839.75977,26116.51953,5.378308852999999,-94.62169115,-422.20852520000005,-309.90846439999996,-0.038987177000000005,3686300,-1,0.0
BSESN,1/22/2016,24435.66016,24472.88086,24120.03906,24122.06055,10100,473.449218,0.0,473.449218,43.511046,23839.75977,25766.75977,30.92373586,-69.07626414,-404.3509415,-328.7969598,-0.015684926000000002,3696400,1,-0.6757
BSESN,1/25/2016,24485.94922,24650.57031,24433.66992,24540.9707,8900,50.289063,0.0,50.289063,45.16870927,23839.75977,25632.57031,36.04337637,-63.95662363,-381.74030600000003,-339.385629,-0.007944245,3705300,1,0.5106
BSESN,1/27/2016,24492.39063,24645.69922,24458.13086,24643.13086,8500,6.441406,0.0,6.441406,45.40548481,23839.75977,25230.34961,46.93194491,-53.06805509,-359.1612595,-343.3407551,-0.01455368,3713800,1,0.0
BSESN,1/28/2016,24469.57031,24587.19922,24400.51953,24481.85938,8400,-22.820312,22.820312,0.0,44.61788402,23839.75977,25083.55078,50.6363641,-49.3636359,-339.1985412,-342.5123123,-0.012247235,3705400,-1,-0.802
BSESN,1/29/2016,24870.68945,24911.90039,24340.06055,24347.31055,12400,401.11914,0.0,401.11914,59.03087785,23839.75977,25018.46094,87.46319351,-12.53680649,-287.6946164,-331.5487731,0.016996513,3717800,1,-0.4767
BSESN,2/1/2016,24824.83008,25002.32031,24788.58008,24982.2207,10100,-45.859375,45.859375,0.0,57.07155059,23839.75977,25018.46094,83.57252333,-16.42747667,-247.72226519999998,-314.7834716,0.026312685,3707700,-1,-0.29600000000000004
BSESN,2/2/2016,24539.0,24928.75,24460.5293,24868.21094,12700,-285.83007799999996,285.83007799999996,0.0,46.07368534,23839.75977,25018.46094,59.32294381,-40.67705619,-236.38311000000002,-299.1033992,0.002416689,3695000,-1,-0.5106
BSESN,2/3/2016,24223.32031,24409.25977,24187.53906,24393.58984,12200,-315.679687,315.679687,0.0,36.990040500000006,23839.75977,25018.46094,32.54094898,-67.45905102,-249.987757,-289.2802708,0.006702726,3682800,-1,0.6369
BSESN,2/4/2016,24338.42969,24514.00977,24224.74023,24386.44922,12200,115.109375,0.0,115.109375,41.81640082,23839.75977,25002.32031,42.8941033,-57.10589670000001,-248.615291,-281.1472748,0.015700501999999998,3695000,1,-0.6901
BSESN,2/5/2016,24616.9707,24672.90039,24345.78906,24360.35938,13400,278.541015,0.0,278.541015,52.06743294,23839.75977,25002.32031,66.85337284,-33.14662716,-222.48697830000003,-269.4152155,0.0074199159999999995,3708400,1,0.6124
BSESN,2/8/2016,24287.41992,24698.94922,24196.83984,24637.41016,11700,-329.55078100000003,329.55078100000003,0.0,41.97232182,23839.75977,25002.32031,38.50639497,-61.49360503,-225.7695651,-260.6860855,-0.008107886,3696700,-1,0.29600000000000004
BSESN,2/9/2016,24020.98047,24111.18945,23919.4707,24076.84961,11500,-266.43945299999996,266.43945299999996,0.0,35.54352715,23839.75977,25002.32031,15.588065799999999,-84.4119342,-247.0229492,-257.9534582,-0.019247208999999998,3685200,-1,0.4767
BSESN,2/10/2016,23758.90039,23938.32031,23636.7207,23938.32031,19400,-262.08007799999996,262.08007799999996,0.0,30.27970112,23636.7207,25002.32031,8.946962719,-91.05303728,-281.76605739999997,-262.715978,-0.029043008,3665800,-1,0.3818
BSESN,2/11/2016,22951.83008,23758.46094,22909.11914,23758.46094,23200,-807.0703129999999,807.0703129999999,0.0,19.83968692,22909.11914,25002.32031,2.040460209,-97.95953979,-370.1571096,-284.2042043,-0.077153445,3642600,-1,-0.6597
BSESN,2/12/2016,22986.11914,23161.15039,22600.39063,23060.39063,25100,34.289063,0.0,34.289063,21.17204788,22600.39063,25002.32031,16.05910939,-83.94089061,-432.4557339,-313.8545103,-0.074067413,3667700,1,0.1779
BSESN,2/15/2016,23554.11914,23622.64063,23197.66992,23223.42969,20400,568.0,0.0,568.0,40.17715043,22600.39063,25002.32031,39.70676247,-60.29323753,-431.0263856000001,-337.2888853,-0.04013533,3688100,1,0.5859
BSESN,2/16/2016,23191.9707,23692.08008,23164.53906,23688.60938,22200,-362.148438,362.148438,0.0,34.12453711,22600.39063,25002.32031,24.629367000000002,-75.370633,-453.8838783,-360.6078839,-0.042576723,3665900,-1,0.0
BSESN,2/17/2016,23381.86914,23434.91016,22920.83984,23237.23047,16600,189.898438,0.0,189.898438,39.62737293,22600.39063,25002.32031,32.53544514,-67.46455486,-451.4711112,-378.7805294,-0.039302476,3682500,1,0.0
BSESN,2/18/2016,23649.2207,23735.34961,23448.21094,23536.4707,15700,267.351562,0.0,267.351562,46.84093027,22600.39063,25002.32031,43.66614407,-56.33385593,-423.1086063999999,-387.64614480000006,-0.039312311,3698200,1,-0.29600000000000004
BSESN,2/19/2016,23709.15039,23774.48047,23508.35938,23640.32031,11600,59.929688,0.0,59.929688,48.43451698,22600.39063,24928.75,47.61978661,-52.38021339,-391.2848045,-388.3738767,-0.023809426,3709800,1,0.3612
BSESN,2/22/2016,23788.78906,23855.03906,23674.85938,23783.4707,9500,79.638672,0.0,79.638672,50.700570299999995,22600.39063,24698.94922,56.62927122,-43.37072878,-355.5395977,-381.8070209,-0.009666191999999999,3719300,1,-0.5994
BSESN,2/23/2016,23410.17969,23851.50977,23361.93945,23850.41016,16700,-378.609375,378.609375,0.0,40.852613399999996,22600.39063,24698.94922,38.58787004,-61.41212996,-353.6848178,-376.18258030000004,-0.014677477,3702600,-1,-0.2023
BSESN,2/24/2016,23088.92969,23338.89063,23057.44922,23332.93945,14000,-321.25,321.25,0.0,34.32513772,22600.39063,24698.94922,23.27974374,-76.72025626,-373.82782710000004,-375.7116297,0.005973363000000001,3688600,-1,0.0
BSESN,2/25/2016,22976.0,23142.96094,22948.09961,23105.16016,15900,-112.92968799999998,112.92968799999998,0.0,32.23594401,22600.39063,24698.94922,17.89844592,-82.10155408,-394.357877,-379.4408791,-0.00044022800000000003,3672700,-1,-0.5994
BSESN,2/26/2016,23154.30078,23227.91016,23021.93945,23141.08008,11500,178.300781,0.0,178.300781,38.99974885,22600.39063,24111.18945,36.66339593,-63.33660407,-391.7251429,-381.89773189999994,-0.016974456000000002,3684200,1,-0.34
BSESN,2/29/2016,23002.0,23343.2207,22494.60938,23238.5,58900,-152.300781,152.300781,0.0,35.50674307,22494.60938,23938.32031,35.14489027,-64.85510973,-397.34770530000003,-384.98772660000003,-0.008191226999999999,3625300,-1,0.0
BSESN,3/1/2016,23779.34961,23821.49023,23133.17969,23153.32031,15700,777.349609,0.0,777.349609,57.77778946,22494.60938,23855.03906,94.43635679,-5.563643213,-335.21387289999996,-375.0329558,0.016999516,3641000,1,0.0
BSESN,3/2/2016,24242.98047,24280.41992,24043.89063,24044.96094,22800,463.63086,0.0,463.63086,65.88506176,22494.60938,24280.41992,97.90350365,-2.096496354,-245.7286207,-349.17208880000004,0.025106947999999997,3663800,1,0.0
BSESN,3/3/2016,24606.99023,24640.50977,24383.2793,24386.66992,19500,364.009765,0.0,364.009765,70.94002137,22494.60938,24640.50977,98.43797354,-1.5620264640000001,-143.7809505,-308.0938612,0.037868917,3683300,1,0.8055
BSESN,3/4/2016,24646.48047,24719.05078,24531.80078,24704.58984,17500,39.490235,0.0,39.490235,71.46921117,22494.60938,24719.05078,96.73759391,-3.262406095,-59.11867223,-258.2988234,0.036054437,3700800,1,0.4019
BSESN,3/8/2016,24659.23047,24793.61914,24509.21094,24655.18945,26000,12.75,0.0,12.75,71.66145926,22494.60938,24793.61914,94.15449756,-5.845502441,8.902983682999999,-204.858462,0.053355027,3726800,1,-0.6249
BSESN,3/9/2016,24793.96094,24820.75977,24451.59961,24527.26953,11900,134.730469,0.0,134.730469,73.81294495,22494.60938,24820.75977,98.84793227,-1.15206773,72.84257506,-149.3182546,0.073846266,3738700,1,0.2023
BSESN,3/10/2016,24623.33984,24817.48047,24471.39063,24815.69922,14400,-170.621094,170.621094,0.0,66.44207158,22494.60938,24820.75977,91.51301985,-8.486980152000001,108.4967822,-97.75524721,0.071698287,3724300,-1,0.0
BSESN,3/11/2016,24717.99023,24817.80078,24552.25977,24620.39063,14800,94.65039,0.0,94.65039,68.45816636,22494.60938,24820.75977,95.58199107,-4.41800893,142.7450179,-49.65519419,0.067533434,3739100,1,-0.8126
BSESN,3/14/2016,24804.2793,24960.50977,24734.03906,24801.69922,30100,86.289063,0.0,86.289063,70.33303228,22494.60938,24960.50977,93.66436416,-6.335635842,174.8344154,-4.757272266,0.078353156,3769200,1,0.34
BSESN,3/15/2016,24551.16992,24840.76953,24517.2793,24832.03906,12100,-253.109375,253.109375,0.0,58.55330861,22494.60938,24960.50977,83.39998463,-16.60001537,177.792205,31.75262319,0.032457587,3757100,-1,-0.5106
BSESN,3/16/2016,24682.48047,24706.84961,24354.55078,24537.60938,11000,131.31054699999999,0.0,131.31054699999999,62.32999343,22494.60938,24960.50977,88.72503942,-11.27496058,188.558355,63.11376955,0.018128959,3768100,1,0.0
BSESN,3/17/2016,24677.36914,24948.30078,24576.51953,24852.17969,14600,-5.111328,5.111328,0.0,62.07593933,22494.60938,24960.50977,88.51775903,-11.48224097,194.43681830000003,89.37837931,0.002860118,3753500,-1,0.3818
BSESN,3/18/2016,24952.74023,24986.93945,24681.64063,24729.41016,14100,275.37109300000003,0.0,275.37109300000003,69.74241705,22494.60938,24986.93945,98.62782144,-1.372178561,218.79357259999998,115.26141799999999,0.012426105,3767600,1,0.6858
BSESN,3/21/2016,25285.36914,25327.44922,24988.26953,25007.56055,12400,332.62890699999997,0.0,332.62890699999997,76.39361745,23133.17969,25327.44922,98.08227397,-1.9177260319999998,261.9176254,144.5926595,0.025391655,3780000,1,-0.0516
BSESN,3/22/2016,25330.49023,25381.33008,25083.69922,25331.00977,12000,45.121093,0.0,45.121093,77.17880204,24043.89063,25381.33008,96.19871809,-3.8012819110000002,296.31886360000004,174.9379003,0.021639515,3792000,1,0.0
BSESN,3/23/2016,25337.56055,25367.81055,25156.82031,25322.09961,9500,7.0703130000000005,0.0,7.0703130000000005,77.31522384,24354.55078,25381.33008,95.73720164,-4.262798357,320.45856119999996,204.0420325,0.029005842,3801500,1,0.2063
BSESN,3/28/2016,24966.40039,25432.93945,24895.49023,25417.10938,10100,-371.16015600000003,371.16015600000003,0.0,56.76221973,24354.55078,25432.93945,56.73739217,-43.26260783,306.11126260000003,224.4558785,0.010049772,3791400,-1,0.0
BSESN,3/29/2016,24900.46094,25079.34961,24835.56055,24957.24023,11000,-65.939453,65.939453,0.0,53.82891095,24354.55078,25432.93945,50.62276442,-49.37723558,286.1219269,236.78908819999998,0.0038776229999999997,3780400,-1,0.0
BSESN,3/30/2016,25338.58008,25358.83984,25055.41992,25062.06055,10700,438.11914,0.0,438.11914,66.93043218,24354.55078,25432.93945,91.24996604,-8.750033958,302.14979260000007,249.86122909999997,0.032072205,3791100,1,0.0
BSESN,3/31/2016,25341.85938,25479.61914,25223.2207,25364.75,11500,3.279297,0.0,3.279297,67.01127725,24354.55078,25479.61914,87.7554315,-12.2445685,311.5255312,262.1940895,0.026714451,3802600,1,0.0
BSESN,4/1/2016,25269.64063,25354.93945,25119.34961,25301.69922,11400,-72.21875,72.21875,0.0,63.091911200000006,24354.55078,25479.61914,81.33637711,-18.66362289,309.56000689999996,271.667273,0.024000592999999997,3791200,-1,0.3182
BSESN,4/4/2016,25399.65039,25424.15039,25223.49023,25333.98047,7800,130.00976599999998,0.0,130.00976599999998,67.09014195,24354.55078,25479.61914,92.89209857,-7.107901426000001,314.8634663,280.3065116,0.017910264,3799000,1,0.0
BSESN,4/5/2016,24883.58984,25372.43945,24837.50977,25372.43945,14800,-516.0605469999999,516.0605469999999,0.0,44.84165368,24354.55078,25479.61914,47.02283717,-52.97716283,274.2631875,279.0978468,-0.015889794,3784200,-1,0.0
BSESN,4/6/2016,24900.63086,25000.65039,24834.16016,24978.85938,10300,17.041014999999998,0.0,17.041014999999998,45.52989809,24354.55078,25479.61914,48.53750202,-51.46249798,240.68774309999998,271.41582610000006,-0.016970038,3794500,1,-0.4019
BSESN,4/7/2016,24685.41992,25013.13086,24647.48047,24998.78906,19200,-215.210937,215.210937,0.0,38.52514922,24576.51953,25479.61914,12.05851379,-87.94148621,194.47149119999997,256.0269591,-0.025738097999999997,3775300,-1,0.0
BSESN,4/8/2016,24673.83984,24736.0293,24608.50977,24665.80078,9700,-11.580078,11.580078,0.0,38.160641600000005,24608.50977,25479.61914,7.499641248,-92.50035875,155.12221069999998,235.8460094,-0.011718171000000001,3765600,-1,0.0
BSESN,4/11/2016,25022.16016,25049.91992,24523.19922,24789.40039,25900,348.320312,0.0,348.320312,53.447560200000005,24523.19922,25479.61914,52.16965117,-47.83034883,150.3114637,218.7391003,0.004887428,3791500,1,-0.8934
BSESN,4/12/2016,25145.58984,25180.01953,24996.43945,25056.4707,11500,123.42968799999998,0.0,123.42968799999998,57.72091806,24523.19922,25479.61914,65.07503772,-34.92496228,154.67565159999998,205.9264105,-0.007616458,3803000,1,-0.8805
BSESN,4/13/2016,25626.75,25671.5,25358.41992,25358.41992,14600,481.160156,0.0,481.160156,70.07637784,24523.19922,25671.5,96.10293742,-3.897062576,194.715348,203.684198,0.011241899,3817600,1,-0.4404
BSESN,4/18/2016,25816.35938,25870.0293,25634.11914,25833.16016,8500,189.609375,0.0,189.609375,73.58617998,24523.19922,25870.0293,96.01509329999999,-3.9849066989999997,238.99203640000002,210.74576569999996,0.021635399,3826100,1,0.0
BSESN,4/20/2016,25844.17969,25956.33984,25716.81055,25942.33984,11300,27.820313,0.0,27.820313,74.10047275,24523.19922,25956.33984,92.17382063,-7.826179374,273.1774778,223.23210809999998,0.017501394,3837400,1,0.5574
BSESN,4/21/2016,25880.38086,26080.07031,25783.11914,25979.67969,18100,36.201171,0.0,36.201171,74.83611294,24523.19922,26080.07031,87.17366809,-12.82633191,299.7356523,238.532817,0.040058168,3855500,1,0.5574
BSESN,4/22/2016,25838.14063,25922.01953,25771.88086,25892.49023,13400,-42.240234,42.240234,0.0,72.07973726,24523.19922,26080.07031,84.46051899,-15.53948101,313.75795669999997,253.5778449,0.037650041,3842100,-1,0.0
BSESN,4/25/2016,25678.92969,25891.0293,25585.92969,25891.0293,8200,-159.210937,159.210937,0.0,62.12779957,24523.19922,26080.07031,74.23417863,-25.76582137,308.4679157,264.5558591,0.040246825,3833900,-1,0.5267
BSESN,4/26/2016,26007.30078,26055.0,25549.05078,25604.91992,11200,328.37109300000003,0.0,328.37109300000003,71.49411711,24523.19922,26080.07031,95.32591155,-4.674088451,327.0028379,277.0452548,0.054043510999999995,3845100,1,0.0772
BSESN,4/27/2016,26064.11914,26092.92969,25885.24023,25956.41992,11200,56.81836,0.0,56.81836,72.83540868,24523.19922,26092.92969,98.16461822,-1.835381779,342.3304913,290.10230210000003,0.041641448,3856300,1,0.2023
BSESN,4/28/2016,25603.09961,26100.53906,25561.16992,26078.2793,14600,-461.019532,461.019532,0.0,50.56182924,24523.19922,26100.53906,68.46339387,-31.53660613,313.6616475,294.8141712,0.018194434,3841700,-1,-0.4215
BSESN,4/29/2016,25606.61914,25755.42969,25424.0293,25612.91016,14600,3.519532,0.0,3.519532,50.69464666,24523.19922,26100.53906,68.68652473,-31.31347527,287.9065713,293.4326512,-0.0007855410000000001,3856300,1,0.4019
BSESN,5/2/2016,25436.9707,25565.43945,25341.14063,25565.43945,7700,-169.648438,169.648438,0.0,44.10458828,24523.19922,26100.53906,57.93117365,-42.06882635,250.9138974,284.9289005,-0.014695669,3848600,-1,0.6705
BSESN,5/3/2016,25229.69922,25705.96094,25192.93945,25500.14063,11000,-207.27148400000002,207.27148400000002,0.0,37.27383183,24523.19922,26100.53906,44.79060126,-55.20939874,202.5371384,268.450548,-0.023776357999999997,3837600,-1,0.0
BSESN,5/4/2016,25101.73047,25245.69922,25061.03906,25210.86914,15800,-127.96875,127.96875,0.0,33.57002006,24996.43945,26100.53906,9.536369277,-90.46363072,152.11867030000002,245.18417250000002,-0.030086512000000003,3821800,-1,0.0
BSESN,5/5/2016,25262.21094,25394.09961,25162.93945,25187.66016,11300,160.480469,0.0,160.480469,41.920877600000004,25061.03906,26100.53906,19.35275373,-80.64724627,123.6853361,220.88440519999997,-0.022289905,3833100,1,0.7783
BSESN,5/6/2016,25228.5,25260.48047,25057.92969,25223.66992,11300,-33.710938,33.710938,0.0,40.68134261,25057.92969,26100.53906,16.359944199999997,-83.6400558,97.30979629,196.1694834,-0.017540828,3821800,-1,0.0
BSESN,5/9/2016,25688.85938,25709.67969,25302.85938,25321.83008,11700,460.359375,0.0,460.359375,59.53459784,25057.92969,26100.53906,60.51448434,-39.48551566,112.2600808,179.38760290000002,-0.012244308,3833500,1,0.0
BSESN,5/10/2016,25772.5293,25809.92969,25614.24023,25682.98047,10500,83.669922,0.0,83.669922,62.06317545,25057.92969,26100.53906,68.53953419,-31.46046581,129.3684732,169.38377690000002,-0.011187405,3844000,1,-0.5106
BSESN,5/11/2016,25597.01953,25762.49023,25409.24023,25548.9707,9300,-175.50976599999998,175.50976599999998,0.0,53.90975863,25057.92969,26100.53906,51.70583115,-48.29416885,127.2974206,160.96650569999997,-0.00023747400000000002,3834700,-1,0.0
BSESN,5/12/2016,25790.2207,25827.0293,25620.26953,25684.59961,9800,193.20117199999999,0.0,193.20117199999999,60.50075176,25057.92969,26100.53906,70.23637352,-29.76362648,139.6361776,156.70044009999998,0.0071700819999999995,3844500,1,0.4404
BSESN,5/13/2016,25489.57031,25743.68945,25400.26953,25739.93945,12500,-300.65039,300.65039,0.0,48.13993207,25057.92969,26100.53906,41.40003297,-58.59996703,123.7284925,150.10605049999998,0.002067841,3832000,-1,0.0
BSESN,5/16/2016,25653.23047,25688.46094,25351.61914,25528.80078,12900,163.660156,0.0,163.660156,54.0380571,25057.92969,26100.53906,57.09720201,-42.90279799,122.9107061,144.66698169999998,0.016787011,3844900,1,0.4019
BSESN,5/17/2016,25773.60938,25927.31055,25733.75977,25756.14063,11400,120.378906,0.0,120.378906,58.08396869,25057.92969,26100.53906,68.64312792,-31.35687208,130.4721742,141.82802019999997,0.026766239,3856300,1,0.0
BSESN,5/18/2016,25704.60938,25747.0,25503.40039,25671.48047,9800,-69.0,69.0,0.0,54.88842066,25057.92969,25927.31055,74.38393429999999,-25.6160657,129.4052655,139.3434692,0.017512261,3846500,-1,0.0
BSESN,5/19/2016,25399.7207,25714.56055,25351.99023,25713.83984,14400,-304.88867200000004,304.88867200000004,0.0,42.86491444,25057.92969,25927.31055,39.31430183,-60.68569817,102.773061,132.0293876,0.006786797,3832100,-1,0.0
BSESN,5/20/2016,25301.90039,25506.06055,25251.90039,25428.41992,13600,-97.820312,97.820312,0.0,39.64959028,25057.92969,25927.31055,28.06258045,-71.93741955,72.93284097,120.2100783,-0.015063299999999998,3818500,-1,0.4588
BSESN,5/23/2016,25230.35938,25519.25977,25207.7793,25447.7207,11300,-71.541016,71.541016,0.0,37.28922036,25057.92969,25927.31055,19.83361897,-80.16638103,43.01563211,104.771189,-0.021036737000000003,3807200,-1,0.3818
BSESN,5/24/2016,25305.4707,25340.4707,25181.4707,25256.9707,10700,75.111328,0.0,75.111328,41.50754012,25057.92969,25927.31055,28.473253399999997,-71.5267466,25.07780366,88.83251196,-0.011389952,3817900,1,-0.4215
BSESN,5/25/2016,25881.16992,25897.86914,25430.58984,25432.09961,9500,575.6992190000001,0.0,575.6992190000001,63.32504223,25057.92969,25927.31055,94.69270291,-5.307297086,56.66288656,82.39858688,0.0035265,3827400,1,-0.5719
BSESN,5/26/2016,26366.67969,26398.93945,25941.50977,26008.25,13900,485.509766,0.0,485.509766,73.09162853,25181.4707,26398.93945,97.3502593,-2.649740702,119.493427,89.81755491,0.03441052,3841300,1,0.0
BSESN,5/27/2016,26653.59961,26677.42969,26405.2793,26415.92969,20800,286.919921,0.0,286.919921,77.22691561,25181.4707,26677.42969,98.40703661,-1.5929633930000002,190.2460843,109.9032608,0.038995835,3862100,1,0.0
BSESN,5/30/2016,26725.59961,26794.96094,26623.33008,26694.75,14800,72.0,0.0,72.0,78.19709557,25181.4707,26794.96094,95.70116215,-4.298837853999999,249.2546211,137.77353280000003,0.036936628,3876900,1,-0.743
BSESN,5/31/2016,26667.96094,26837.19922,26561.58008,26817.75,26500,-57.638670999999995,57.638670999999995,0.0,75.23643891,25181.4707,26837.19922,89.77862135,-10.22137865,288.0479155,167.8284094,0.037477775,3850400,-1,0.4215
BSESN,6/1/2016,26713.92969,26857.25,26671.85938,26684.46094,13400,45.96875,0.0,45.96875,76.07018425,25181.4707,26857.25,91.44754251,-8.55245749,318.8259477,198.027917,0.05174108,3863800,1,0.0
BSESN,6/2/2016,26843.14063,26885.160160000003,26641.01953,26694.2793,11100,129.210937,0.0,129.210937,78.42597146,25181.4707,26885.160160000003,97.53361559,-2.466384406,349.61387169999995,228.345108,0.060914011,3874900,1,-0.4767
BSESN,6/3/2016,26843.0293,27008.14063,26792.07031,26919.23047,13000,-0.111328,0.111328,0.0,78.41829666,25181.4707,27008.14063,90.96107479,-9.038925205,369.74237999999997,256.6245624,0.063917834,3861900,-1,0.0
BSESN,6/6/2016,26777.44922,26901.41992,26729.53906,26897.839839999997,8700,-65.580078,65.580078,0.0,73.52757537,25181.4707,27008.14063,87.37093094,-12.62906906,376.0675312,280.5131561,0.05816839099999999,3853200,-1,-0.3612
BSESN,6/7/2016,27009.66992,27082.63086,26829.5293,26833.53906,14800,232.220703,0.0,232.220703,78.90339802,25181.4707,27082.63086,96.16229402,-3.83770598,395.26219260000005,303.4629634,0.043603129000000004,3868000,1,0.0
BSESN,6/8/2016,27020.660160000003,27105.410160000003,26973.710939999997,27085.24023,12500,10.990234,0.0,10.990234,79.13477924,25181.4707,27105.410160000003,95.59497572,-4.405024278,406.6730463,324.10497999999995,0.024803292,3880500,1,0.3818
BSESN,6/9/2016,26763.46094,26994.910160000003,26692.34961,26994.48047,10100,-257.19921800000003,257.19921800000003,0.0,61.05325521,25181.4707,27105.410160000003,82.2266123,-17.773387699999997,390.4614067,337.3762653,0.00412182,3870400,-1,-0.5719
BSESN,6/10/2016,26635.75,26972.06055,26620.5,26742.25977,10100,-127.71093799999998,127.71093799999998,0.0,53.9859371,25181.4707,27105.410160000003,75.58862077,-24.41137923,363.12250980000005,342.5255142,-0.003361931,3860300,-1,-0.4404
BSESN,6/13/2016,26396.76953,26468.26953,26262.26953,26468.26953,9100,-238.980469,238.980469,0.0,43.19097654,25430.58984,27105.410160000003,57.68855799,-42.31144201,318.5010289,337.7206172,-0.010169184,3851200,-1,-0.3182
BSESN,6/14/2016,26395.71094,26485.44922,26264.81055,26482.5,7800,-1.0585930000000001,1.0585930000000001,0.0,43.14688002,25941.50977,27105.410160000003,39.02405875,-60.97594125,279.8270917,326.1419121,-0.011912091000000001,3843400,-1,0.6037
BSESN,6/15/2016,26726.33984,26752.58984,26446.58984,26500.78906,12300,330.62890600000003,0.0,330.62890600000003,58.43872472,26262.26953,27105.410160000003,55.04067759,-44.95932241,272.71304110000005,315.4561379,-0.004351234,3855700,1,0.4019
BSESN,6/16/2016,26525.46094,26686.0293,26314.91016,26686.0293,12600,-200.878906,200.878906,0.0,49.16771525,26262.26953,27105.410160000003,31.21560024,-68.78439976,248.0069858,301.9663075,-0.011830571000000002,3843100,-1,-0.0516
BSESN,6/17/2016,26625.91016,26730.55078,26538.50977,26653.84961,9300,100.449218,0.0,100.449218,53.43045143,26262.26953,27105.410160000003,43.12929708,-56.87070292,233.83714229999998,288.3404744,-0.005659205,3852400,1,0.0
BSESN,6/20/2016,26866.91992,26885.49023,26447.88086,26497.10938,9500,241.009766,0.0,241.009766,62.20490785,26262.26953,27105.410160000003,71.71406205,-28.28593795,239.2964526,278.53167010000004,-0.005285144,3861900,1,0.5994
BSESN,6/21/2016,26812.7793,26925.64063,26754.59961,26907.41992,7000,-54.140625,54.140625,0.0,59.30842402,26262.26953,27105.410160000003,65.29275778,-34.70724222,236.52775469999997,270.13088700000003,-0.007693404,3854900,-1,0.4404
BSESN,6/22/2016,26765.65039,26887.289060000003,26617.44922,26791.67969,7700,-47.128906,47.128906,0.0,56.65855766,26262.26953,27105.410160000003,59.70307266,-40.29692734,227.9035031,261.6854102,8.18e-05,3847200,-1,0.0
BSESN,6/23/2016,27002.2207,27060.98047,26736.51953,26753.19922,9300,236.570312,0.0,236.570312,65.56865367,26262.26953,27105.410160000003,87.76129984,-12.23870016,237.4211256,256.83255330000003,0.013758603000000001,3856500,1,-0.5859
BSESN,6/24/2016,26397.71094,26435.84961,25911.33008,26367.48047,24400,-604.509765,604.509765,0.0,40.82385158,25911.33008,27105.410160000003,40.73268359,-59.26731641,193.9492974,244.25590209999996,3.570000000000001e-05,3832100,-1,-0.6486
BSESN,6/27/2016,26402.96094,26493.50977,26262.7207,26347.81055,18300,5.25,0.0,5.25,41.04679723,25911.33008,27105.410160000003,41.1723526,-58.82764739999999,158.09872769999998,227.02446719999998,0.00027466599999999996,3850400,1,0.0
BSESN,6/28/2016,26524.55078,26583.33008,26378.46094,26410.66016,8100,121.58984299999999,0.0,121.58984299999999,46.43923328,25911.33008,27060.98047,53.33975509,-46.66024491,137.90845430000002,209.2012647,-0.0075501940000000005,3858500,1,0.106
BSESN,6/29/2016,26740.39063,26776.16992,26606.31055,26627.15039,7700,215.839844,0.0,215.839844,54.89059886,25911.33008,27060.98047,72.11414474,-27.88585526,137.736251,194.90826189999999,0.008102769000000001,3866200,1,0.2023
BSESN,6/30/2016,26999.7207,27069.23047,26872.589839999997,26926.16992,8600,259.33007799999996,0.0,259.33007799999996,62.9871767,25911.33008,27069.23047,93.99691316,-6.003086841,156.7189896,187.2704075,0.014039353000000001,3874800,1,0.0
BSESN,7/1/2016,27144.910160000003,27243.35938,27061.40039,27064.33008,10000,145.18945300000001,0.0,145.18945300000001,66.83285228,25911.33008,27243.35938,92.60908005,-7.390919946,181.3875989,186.0938457,0.010346934,3884800,1,0.0
BSESN,7/4/2016,27278.75977,27385.660160000003,27251.06055,27314.43945,8300,133.84961,0.0,133.84961,70.1337432,25911.33008,27385.660160000003,92.74922274,-7.250777257999999,209.32522350000002,190.74012130000003,0.017379044,3893100,1,0.0
BSESN,7/5/2016,27166.86914,27348.660160000003,27127.30078,27340.7207,10400,-111.890625,111.890625,0.0,63.99094733,25911.33008,27385.660160000003,85.15997074,-14.84002926,219.90245530000004,196.57258810000002,0.014990062,3882700,-1,0.29600000000000004
BSESN,7/7/2016,27201.49023,27288.2207,27146.94922,27209.9707,8800,34.621093,0.0,34.621093,65.08282295,25911.33008,27385.660160000003,87.50823003,-12.49176997,228.445246,202.9471197,0.0073797459999999995,3891500,1,0.1779
BSESN,7/8/2016,27126.90039,27294.820310000003,27034.14063,27292.19922,13900,-74.589843,74.589843,0.0,60.520844,25911.33008,27385.660160000003,82.44899369,-17.55100631,226.58476409999997,207.6746486,0.027623208,3877600,-1,0.128
BSESN,7/11/2016,27626.68945,27647.48047,27358.23047,27358.23047,23900,499.789062,0.0,499.789062,74.39624449,25911.33008,27647.48047,98.80246457,-1.197535427,262.4141719,218.62255319999997,0.046348155,3901500,1,0.0
BSESN,7/12/2016,27808.14063,27828.74023,27667.81055,27667.81055,12200,181.45117199999999,0.0,181.45117199999999,77.68212289,25911.33008,27828.74023,98.92565454,-1.0743454620000001,301.96990780000004,235.2920241,0.04839252,3913700,1,0.0
BSESN,7/13/2016,27815.179689999997,27928.75977,27752.14063,27912.14063,17600,7.0390630000000005,0.0,7.0390630000000005,77.80959525,25911.33008,27928.75977,94.37006015,-5.629939852000001,330.08113710000003,254.24984669999998,0.040193469,3931300,1,-0.4588
BSESN,7/14/2016,27942.10938,27967.76953,27763.15039,27857.80078,10500,126.92968700000002,0.0,126.92968700000002,80.16658115,25911.33008,27967.76953,98.75220464,-1.247795356,358.4694413,275.09376560000004,0.034903645,3941800,1,0.0
BSESN,7/15/2016,27836.5,28048.69922,27735.86914,27966.14063,16300,-105.609375,105.609375,0.0,72.74832338,26262.7207,28048.69922,88.11860181,-11.88139819,368.2011888,293.7152503,0.025477699,3925500,-1,0.5267
BSESN,7/18/2016,27746.660160000003,28013.5,27697.68945,27920.660160000003,20500,-89.839844,89.839844,0.0,66.69087915,26378.46094,28048.69922,81.91640879,-18.08359121,364.46304110000005,307.86480839999996,0.017152554,3905000,-1,0.0
BSESN,7/19/2016,27787.61914,27826.68945,27637.98047,27790.05078,16800,40.958985,0.0,40.958985,68.08866153,26606.31055,28048.69922,81.8994642,-18.1005358,360.6482514,318.42149700000004,0.022849522999999997,3921800,1,0.5574
BSESN,7/20/2016,27915.89063,27935.179689999997,27759.710939999997,27775.69922,12500,128.27148400000002,0.0,128.27148400000002,72.29045434,26872.589839999997,28048.69922,88.70780245,-11.29219755,363.7819875,327.49359510000005,0.026263281,3934300,1,-0.6705
BSESN,7/21/2016,27710.51953,27988.75977,27687.539060000003,27980.070310000003,12200,-205.371094,205.371094,0.0,58.146514399999994,27034.14063,28048.69922,66.66730833,-33.33269167,345.70865089999995,331.1366063,0.021514406,3922100,-1,-0.128
BSESN,7/22/2016,27803.24023,27832.44922,27646.210939999997,27721.7207,9500,92.720703,0.0,92.720703,62.01779724,27034.14063,28048.69922,75.80632736,-24.19367264,335.005453,331.9103756,0.006390588000000001,3931600,1,0.3818
BSESN,7/25/2016,28095.339839999997,28110.36914,27736.50977,27753.960939999997,15300,292.09961,0.0,292.09961,71.57491951,27034.14063,28110.36914,98.60352176,-1.3964782359999999,346.103424,334.7489853,0.010327883000000001,3946900,1,0.0
BSESN,7/26/2016,27976.51953,28149.5293,27927.13086,28121.36914,11100,-118.82031299999998,118.82031299999998,0.0,64.01470116,27034.14063,28149.5293,84.48883601,-15.51116399,341.3756735,336.07432289999997,0.005800424,3935800,-1,-0.171
BSESN,7/27/2016,28024.33008,28210.88086,27899.929689999997,27976.14063,10400,47.810547,0.0,47.810547,65.69693854,27034.14063,28210.88086,84.14681715,-15.85318285,337.5952211,336.3785026,0.0029425370000000003,3946200,1,-0.5719
BSESN,7/28/2016,28208.61914,28240.19922,28064.90039,28108.7793,14600,184.289063,0.0,184.289063,71.60142881,27358.23047,28240.19922,96.41936543,-3.580634575,345.4872111,338.2002443,0.013368028999999998,3960800,1,0.0
BSESN,7/29/2016,28051.85938,28233.4707,28037.86914,28232.86914,11500,-156.75976599999998,156.75976599999998,0.0,61.25329702,27637.98047,28240.19922,68.72567584,-31.27432416,335.22816539999997,337.60582850000003,0.010999493999999999,3949300,-1,0.0
BSESN,8/1/2016,28003.11914,28284.84961,27873.5293,28083.08008,13700,-48.740234,48.740234,0.0,58.23392097,27637.98047,28284.84961,56.44706934,-43.55293066,319.4820777,333.98107830000004,0.007755252,3935600,-1,0.0
BSESN,8/2/2016,27981.710939999997,28175.2207,27943.910160000003,28069.11914,10100,-21.408203,21.408203,0.0,56.81457583,27637.98047,28284.84961,53.13755870000001,-46.86244129999999,301.79680099999996,327.54422289999997,0.002357808,3925500,-1,0.0
BSESN,8/3/2016,27697.50977,28015.429689999997,27647.14063,28008.51953,11800,-284.20117200000004,284.20117200000004,0.0,41.36960963,27637.98047,28284.84961,9.202680004,-90.79732,261.8302167,314.4014216,-0.00046948800000000006,3913700,-1,-0.8126
BSESN,8/4/2016,27714.36914,27921.910160000003,27627.9707,27899.88086,14600,16.859375,0.0,16.859375,42.44065181,27627.9707,28284.84961,13.15287144,-86.84712856,228.87845299999998,297.2968279,-0.003196429,3928300,1,-0.29600000000000004
BSESN,8/5/2016,28078.34961,28110.36914,27795.74023,27810.55078,13700,363.98046800000003,0.0,363.98046800000003,60.44193154,27627.9707,28284.84961,68.56346001,-31.43653999,229.4887216,283.7352066,-0.000604735,3942000,1,-0.6908
BSESN,8/8/2016,28182.570310000003,28226.38086,28128.06055,28181.91992,20300,104.220704,0.0,104.220704,64.1465408,27627.9707,28284.84961,84.42950518,-15.57049482,235.66549840000002,274.121265,0.007365133,3962300,1,0.0
BSESN,8/9/2016,28085.160160000003,28289.960939999997,27956.76953,28289.2207,14200,-97.410157,97.410157,0.0,58.262267200000004,27627.9707,28289.960939999997,69.06286964,-30.93713036,230.048596,265.3067312,0.002170617,3948100,-1,0.0
BSESN,8/10/2016,27774.88086,28143.2793,27736.61914,28133.35938,15400,-310.27929700000004,310.27929700000004,0.0,43.57215486,27627.9707,28289.960939999997,22.19219382,-77.80780618,198.27462769999997,251.9003105,-0.015376091000000001,3932700,-1,-0.2023
BSESN,8/11/2016,27859.59961,27902.39063,27697.33008,27805.93945,9900,84.71875,0.0,84.71875,47.72465177,27627.9707,28289.960939999997,34.98977685,-65.01022315,177.879144,237.0960772,-0.006853726,3942600,1,0.0
BSESN,8/12/2016,28152.40039,28203.26953,27900.910160000003,27919.94922,21000,292.80078199999997,0.0,292.80078199999997,59.58503367,27627.9707,28289.960939999997,79.22015466,-20.77984534,183.22999099999998,226.32286000000002,0.005330879,3963600,1,0.0
BSESN,8/16/2016,28064.60938,28199.09961,27942.65039,28190.039060000003,14600,-87.791016,87.791016,0.0,55.24845133,27627.9707,28289.960939999997,65.95847626,-34.04152374,178.3308871,216.7244654,0.0029625940000000003,3949000,-1,-0.2263
BSESN,8/17/2016,28005.36914,28174.30078,27960.14063,28061.789060000003,11600,-59.240233999999994,59.240233999999994,0.0,52.28561781,27627.9707,28289.960939999997,57.00966843,-42.99033157,167.7345803,206.9264884,0.011115056000000002,3937400,-1,0.0
BSESN,8/18/2016,28123.43945,28214.16992,28077.0,28077.64063,12500,118.07031200000002,0.0,118.07031200000002,57.52405824,27627.9707,28289.960939999997,74.84532608,-25.15467392,166.9398397,198.9291586,0.014760225,3949900,1,0.0
BSESN,8/19/2016,28077.0,28212.30078,28026.11914,28167.660160000003,15600,-46.439453,46.439453,0.0,54.79395156,27627.9707,28289.960939999997,67.83019949,-32.16980051,160.7101596,191.2853588,-4.8100000000000004e-05,3934300,-1,-0.6249
BSESN,8/22/2016,27985.539060000003,28143.2793,27918.05078,28088.070310000003,12600,-91.460937,91.460937,0.0,49.45964964,27627.9707,28289.960939999997,54.01414418,-45.98585582,146.7018721,182.3686615,-0.006991245,3921700,-1,0.0
BSESN,8/23/2016,27990.210939999997,28028.98047,27854.429689999997,28012.56055,12400,4.671875,0.0,4.671875,49.74798765,27627.9707,28289.960939999997,54.71987589,-45.28012411,134.4275871,172.7804466,-0.003380761,3934100,1,0.0
BSESN,8/24/2016,28059.93945,28108.39063,27959.86914,28065.25,8100,69.728515,0.0,69.728515,54.24354116,27627.9707,28289.960939999997,65.25303957,-34.74696043,128.8414324,163.9926437,0.01026318,3942200,1,0.4019
BSESN,8/25/2016,27835.910160000003,28154.210939999997,27803.24023,28103.59961,6700,-224.029297,224.029297,0.0,40.7342691,27697.33008,28289.960939999997,23.38387812,-76.61612188,105.125254,152.2191658,-0.000850316,3935500,-1,-0.2023
BSESN,8/26/2016,27782.25,27935.88086,27696.99023,27882.75,9100,-53.66015600000001,53.66015600000001,0.0,38.11107665,27696.99023,28289.960939999997,14.37841118,-85.62158882,81.0656118,137.98845500000002,-0.013148093000000001,3926400,-1,-0.2263
BSESN,8/29/2016,27902.660160000003,27952.84961,27698.710939999997,27827.25977,11800,120.410156,0.0,120.410156,46.95550276,27696.99023,28289.960939999997,34.68466833,-65.31533167,70.89700868,124.57016570000002,-0.005770585,3938200,1,-0.5106
BSESN,8/30/2016,28343.00977,28478.01953,28010.660160000003,28012.460939999997,10600,440.34961,0.0,440.34961,66.90985988,27696.99023,28478.01953,82.71386675,-17.28613325,97.24981549,119.1060957,0.012056282,3948800,1,0.0
BSESN,8/31/2016,28452.16992,28532.25,28363.09961,28372.25,10400,109.160156,0.0,109.160156,70.12446433,27696.99023,28532.25,90.41255412,-9.587445877,125.4962741,120.3841314,0.011688843,3959200,1,-0.5267
BSESN,9/1/2016,28423.48047,28548.84961,28386.60938,28459.089839999997,16800,-28.689453000000004,28.689453000000004,0.0,68.11770644,27696.99023,28548.84961,85.28288309999999,-14.717116899999999,143.9079161,125.0888883,0.012340366,3942400,-1,0.2732
BSESN,9/2/2016,28532.10938,28581.58008,28427.63086,28498.7207,12000,108.628906,0.0,108.628906,71.66081039,27696.99023,28581.58008,94.40749819,-5.5925018060000005,165.35856919999998,133.14282450000002,0.019530455,3954400,1,0.1027
BSESN,9/6/2016,28978.01953,29013.40039,28631.26953,28631.26953,18200,445.910156,0.0,445.910156,81.43350206,27696.99023,29013.40039,97.31232247,-2.6876775310000003,215.8513889,149.6845374,0.035291216,3972600,1,-0.5106
BSESN,9/7/2016,28926.35938,29067.839839999997,28911.31055,29035.66992,19800,-51.660156,51.660156,0.0,77.84499566,27696.99023,29067.839839999997,89.67935885,-10.32064115,248.8304074,169.5137114,0.030877468999999998,3952800,-1,-0.2263
BSESN,9/8/2016,29045.2793,29077.2793,28854.56055,28929.460939999997,15000,118.919922,0.0,118.919922,80.16643914,27696.99023,29077.2793,97.68164504,-2.318354963,281.3194851,191.8748661,0.04344636599999999,3967800,1,0.0
BSESN,9/9/2016,28797.25,29062.90039,28755.08008,29062.90039,11700,-248.029297,248.029297,0.0,64.0223318,27696.99023,29077.2793,79.71227154,-20.28772846,283.7821578,210.2563245,0.036534118,3956100,-1,0.0
BSESN,9/12/2016,28353.539060000003,28481.10938,28251.31055,28481.089839999997,13700,-443.710937,443.710937,0.0,45.2235058,27696.99023,29077.2793,47.56603864,-52.43396136,247.0818732,217.62143419999998,0.016158994,3942400,-1,0.0
BSESN,9/14/2016,28372.23047,28416.410160000003,28259.38086,28345.49023,11500,18.691406,0.0,18.691406,45.99428276,27696.99023,29077.2793,48.92020469,-51.07979531,217.00339350000002,217.4978261,0.001030967,3953900,1,0.0
BSESN,9/15/2016,28412.89063,28454.01953,28311.10938,28398.33008,9600,40.660156,0.0,40.660156,47.83664483,27696.99023,29077.2793,51.86597577,-48.13402423,194.2082051,212.83990189999997,-0.001380538,3963500,1,-0.7783
BSESN,9/16/2016,28599.0293,28778.64063,28494.589839999997,28520.30078,13400,186.13867199999999,0.0,186.13867199999999,55.80119496,27696.99023,29077.2793,65.35146059,-34.64853941,188.9841971,208.06876090000003,0.00617619,3976900,1,-0.2732
BSESN,9/19/2016,28634.5,28714.76953,28552.55078,28626.59961,12600,35.470703,0.0,35.470703,57.23683853,27698.710939999997,29077.2793,67.88122299999999,-32.118777,185.567219,203.56845249999998,0.00358861,3989500,1,-0.3612
BSESN,9/20/2016,28523.19922,28698.81055,28480.5293,28690.660160000003,8000,-111.300781,111.300781,0.0,51.21400123,28010.660160000003,29077.2793,48.05267816,-51.94732184,171.89667849999998,197.2340977,-0.015695355,3981500,-1,-0.1779
BSESN,9/21/2016,28507.41992,28689.35938,28462.33008,28554.38086,12300,-15.779297,15.779297,0.0,50.34735961,28251.31055,29077.2793,31.00715069,-68.99284931,157.9684572,189.3809696,-0.014482965,3969200,-1,0.0
BSESN,9/22/2016,28773.13086,28871.91992,28693.070310000003,28766.93945,10700,265.710937,0.0,265.710937,62.63323315,28251.31055,29077.2793,63.17676207,-36.82323793,166.4521368,184.79520300000001,-0.009369799,3979900,1,-0.6908
BSESN,9/23/2016,28668.2207,28825.089839999997,28627.38086,28810.320310000003,13300,-104.910156,104.910156,0.0,56.28815842,28251.31055,29077.2793,50.47529413,-49.52470587,162.8331026,180.402783,-0.004480612,3966600,-1,-0.7184
BSESN,9/26/2016,28294.2793,28630.91992,28272.0293,28630.91992,16600,-373.94140600000003,373.94140600000003,0.0,39.73343436,28251.31055,29077.2793,5.20222466,-94.79777534,128.3119454,169.9846154,-0.002090031,3950000,-1,0.0
BSESN,9/27/2016,28223.69922,28432.74023,28179.339839999997,28373.01953,8800,-70.580078,70.580078,0.0,37.34163513,28179.339839999997,29077.2793,4.940129855,-95.05987014,94.17289065,154.8222705,-0.005235092,3941200,-1,-0.7003
BSESN,9/28/2016,28292.81055,28378.56055,28198.30078,28198.88086,10800,69.111328,0.0,69.111328,41.33176172,28179.339839999997,29077.2793,12.63678777,-87.36321223,71.86572705,138.2309618,-0.004226253,3952000,1,0.0
BSESN,9/29/2016,27827.5293,28475.570310000003,27719.91992,28423.14063,13600,-465.28125,465.28125,0.0,27.6526353,27719.91992,29062.90039,8.012728218,-91.98727178,16.45316893,113.87540320000001,-0.02697644,3938400,-1,-0.2023
BSESN,9/30/2016,27865.960939999997,27955.210939999997,27716.7793,27807.820310000003,10500,38.431641,0.0,38.431641,29.86487067,27716.7793,28871.91992,12.914587,-87.085413,-24.08295703,86.28373117,-0.026839619,3948900,1,-0.5267
BSESN,10/3/2016,28243.289060000003,28273.01953,27919.89063,27997.289060000003,10900,377.328125,0.0,377.328125,47.90941768,27716.7793,28871.91992,45.57971165,-54.42028835,-25.46733113,63.93351871,-0.009813421,3959800,1,-0.5859
BSESN,10/4/2016,28334.55078,28404.69922,28242.25,28377.64063,18300,91.261718,0.0,91.261718,51.39899632,27716.7793,28871.91992,53.48019718,-46.51980282,-18.98159167,47.35049663,-0.006064005,3978100,1,0.3612
BSESN,10/5/2016,28220.98047,28477.65039,28188.90039,28425.74023,11300,-113.57031200000002,113.57031200000002,0.0,46.88869072,27716.7793,28871.91992,43.64846678,-56.35153322,-22.74359742,33.33167782,-0.019189792,3966800,-1,0.0
BSESN,10/6/2016,28106.210939999997,28328.56055,28031.2207,28298.34961,9100,-114.769531,114.769531,0.0,42.53636492,27716.7793,28871.91992,33.71292054,-66.28707946,-34.58725571,19.74789112,-0.019603929,3957700,-1,-0.8625
BSESN,10/7/2016,28061.14063,28155.679689999997,27964.910160000003,28129.2207,12700,-45.070313,45.070313,0.0,40.81951244,27716.7793,28871.91992,29.81120398,-70.18879602,-47.06767101,6.384778692,-0.008239781,3945000,-1,-0.4767
BSESN,10/10/2016,28082.339839999997,28216.64063,28068.320310000003,28144.2793,6900,21.199219,0.0,21.199219,42.0880919,27716.7793,28871.91992,31.64641076,-68.35358924,-54.61828466,-5.815833979,-0.005008535,3951900,1,0.0
BSESN,10/13/2016,27643.10938,28042.61914,27563.839839999997,28042.61914,11900,-439.230469,439.230469,0.0,27.82758077,27563.839839999997,28871.91992,6.059990694,-93.94000931,-94.94990502,-23.64264819,-0.022963472000000002,3940000,-1,0.4215
BSESN,10/14/2016,27673.59961,27763.539060000003,27548.179689999997,27712.2207,14000,30.490234,0.0,30.490234,29.73450813,27548.179689999997,28825.089839999997,9.822141393999999,-90.17785861,-123.03443329999999,-43.52100521,-0.005531561,3954000,1,0.0
BSESN,10/17/2016,27529.9707,27803.210939999997,27488.30078,27776.14063,17100,-143.628906,143.628906,0.0,26.00051256,27488.30078,28630.91992,3.6468776430000003,-96.35312236,-155.0934559,-65.83549534,-0.012057371,3936900,-1,-0.5267
BSESN,10/18/2016,28050.88086,28064.39063,27652.75977,27656.89063,16200,520.9101559999999,0.0,520.9101559999999,51.49200425,27488.30078,28477.65039,56.86362761,-43.13637239,-136.88939030000003,-80.04627434,-0.006812528000000001,3953100,1,0.0
BSESN,10/19/2016,27984.36914,28131.070310000003,27926.16992,28112.35938,15200,-66.511718,66.511718,0.0,49.00492559,27488.30078,28477.65039,50.14085567,-49.85914433,-126.37273090000001,-89.31156565,-0.012358821,3937900,-1,0.0
BSESN,10/20/2016,28129.839839999997,28212.5,28031.570310000003,28031.570310000003,11300,145.47070300000001,0.0,145.47070300000001,54.54546697,27488.30078,28477.65039,64.84452579,-35.15547421,-105.08853729999998,-92.46695997,-0.003229534,3949200,1,0.0
BSESN,10/21/2016,28077.179689999997,28163.410160000003,27957.91992,28163.410160000003,8500,-52.66015600000001,52.66015600000001,0.0,52.17757245,27488.30078,28477.65039,59.52182131,-40.47817869,-91.416107,-92.25678938,-0.001032912,3940700,-1,0.0
BSESN,10/24/2016,28179.08008,28256.65039,28075.94922,28156.589839999997,15100,101.90039,0.0,101.90039,56.40327716,27488.30078,28477.65039,69.82155651,-30.17844349,-71.53350394,-88.11213229,0.004202946,3955800,1,-0.1531
BSESN,10/25/2016,28091.41992,28211.410160000003,28013.68945,28159.089839999997,11000,-87.660156,87.660156,0.0,51.85513918,27488.30078,28477.65039,60.96117438,-39.03882562,-62.13360227,-82.91642629,0.000323338,3944800,-1,0.6369
BSESN,10/26/2016,27836.50977,28050.55078,27759.56055,28050.55078,14100,-254.910156,254.910156,0.0,40.81285188,27488.30078,28477.65039,35.19574693,-64.80425307,-74.39564499,-81.21227003,0.006996333,3930700,-1,-0.3818
BSESN,10/27/2016,27915.90039,27958.13086,27665.59961,27808.63086,13600,79.390625,0.0,79.390625,45.02012743,27488.30078,28328.56055,50.8889783,-49.1110217,-76.82168964,-80.33415395,0.008755666,3944300,1,0.4019
BSESN,10/28/2016,27941.50977,28000.14063,27789.839839999997,27983.14063,11300,25.609375,0.0,25.609375,46.43727116,27488.30078,28256.65039,58.98473548,-41.01526452,-75.80406291,-79.42813574,0.014948765,3955600,1,0.0
BSESN,11/1/2016,27876.60938,28029.80078,27845.63086,27966.179689999997,10100,-64.900391,64.900391,0.0,43.18254366,27488.30078,28256.65039,50.53800886,-49.46199114,-79.32015222,-79.40653904,-0.006212692,3945500,-1,0.0
BSESN,11/2/2016,27527.2207,27679.320310000003,27500.81055,27679.320310000003,13000,-349.38867200000004,349.38867200000004,0.0,30.08463193,27488.30078,28256.65039,5.065392302,-94.9346077,-109.0424507,-85.33372137,-0.016335849,3932500,-1,-0.9246
BSESN,11/3/2016,27430.2793,27600.74023,27399.25977,27518.06055,10800,-96.941406,96.941406,0.0,27.42183106,27399.25977,28256.65039,3.6178994839999996,-96.38210052,-138.81972030000003,-96.03092117,-0.024868984,3921700,-1,0.4588
BSESN,11/4/2016,27274.15039,27498.910160000003,27193.60938,27465.55078,24300,-156.128906,156.128906,0.0,23.54854192,27193.60938,28256.65039,7.576473042000001,-92.42352696,-173.0222264,-111.4291822,-0.028600782,3897400,-1,0.0
BSESN,11/7/2016,27458.99023,27591.15039,27274.15039,27552.26953,11300,184.839843,0.0,184.839843,35.91391896,27193.60938,28256.65039,24.96431041,-75.03568959,-183.10223969999998,-125.7637937,-0.025554057999999998,3908700,1,0.4404
BSESN,11/8/2016,27591.14063,27646.839839999997,27406.75977,27537.25977,10200,132.15039099999998,0.0,132.15039099999998,43.45811004,27193.60938,28256.65039,37.39566433,-62.60433567,-178.3711393,-136.2852628,-0.017808972,3918900,1,0.0
BSESN,11/9/2016,27252.5293,27397.38086,25902.44922,26251.38086,21100,-338.61132799999996,338.61132799999996,0.0,32.23798319,25902.44922,28256.65039,57.34769373,-42.65230627,-199.643447,-148.9568997,-0.02097894,3897800,-1,-0.5095
BSESN,11/10/2016,27517.679689999997,27743.460939999997,27252.5293,27605.05078,16600,265.150391,0.0,265.150391,45.05516395,25902.44922,28256.65039,68.61055411,-31.38944589,-192.8830478,-157.74212930000002,-0.014265014,3914400,1,-0.5719
BSESN,11/11/2016,26818.82031,27344.84961,26777.17969,27344.84961,17100,-698.859375,698.859375,0.0,28.60203384,25902.44922,28256.65039,38.92492727,-61.07507273,-241.13780719999997,-174.4212649,-0.040179985,3897300,-1,0.2732
BSESN,11/15/2016,26304.63086,26809.60938,26253.63086,26809.60938,16400,-514.189454,514.189454,0.0,21.83333356,25902.44922,28211.410160000003,17.41829554,-82.58170446,-317.2141955,-202.979851,-0.056390592,3880900,-1,-0.29600000000000004
BSESN,11/16/2016,26298.68945,26621.40039,26239.21094,26508.93945,14200,-5.941406,5.941406,0.0,21.76466241,25902.44922,28050.55078,18.446066100000003,-81.5539339,-373.6771852,-237.1193179,-0.044629687,3866700,-1,0.0
BSESN,11/17/2016,26227.61914,26449.86914,26155.40039,26304.90039,11000,-71.070312,71.070312,0.0,20.85914336,25902.44922,28029.80078,15.28519911,-84.71480089,-419.32556739999995,-273.56056780000006,-0.043844255,3855700,-1,-0.4588
BSESN,11/18/2016,26150.24023,26349.01953,26106.7793,26270.19922,9600,-77.378907,77.378907,0.0,19.82305109,25902.44922,28029.80078,11.64786392,-88.35213608,-456.4840068,-310.14525560000004,-0.041207889,3846100,-1,-0.4588
BSESN,11/21/2016,25765.14063,26270.2793,25717.92969,26246.69922,9900,-385.099609,385.099609,0.0,15.423697599999999,25717.92969,28029.80078,2.042109404,-97.9578906,-511.1148441000001,-350.3391733,-0.061686522,3836200,-1,-0.8834
BSESN,11/22/2016,25960.7793,26039.69922,25765.50977,25928.16016,8100,195.63867199999999,0.0,195.63867199999999,25.15975439,25717.92969,27743.460939999997,11.98942791,-88.01057209,-532.4856077,-386.7684602,-0.05909003,3844300,1,0.34
BSESN,11/23/2016,26051.81055,26130.49023,25877.16016,26101.33008,8900,91.03125,0.0,91.03125,29.51596501,25717.92969,27743.460939999997,16.48361925,-83.51638075,-535.8991193,-416.594592,-0.044058984,3853200,1,-0.3612
BSESN,11/24/2016,25860.16992,26049.14063,25810.9707,26049.14063,8600,-191.640625,191.640625,0.0,25.8596671,25717.92969,27743.460939999997,7.022366798999999,-92.9776332,-547.7539818,-442.82647000000003,-0.060234357999999995,3844600,-1,0.0
BSESN,11/25/2016,26316.33984,26343.94922,25874.44922,25953.24023,11500,456.169922,0.0,456.169922,44.68085469,25717.92969,27743.460939999997,29.54336824,-70.45663176,-514.4101454,-457.14320499999997,-0.018736113999999998,3856100,1,-0.25
BSESN,11/28/2016,26350.16992,26413.99023,26183.2207,26303.51953,10900,33.830078,0.0,33.830078,45.85699493,25717.92969,27743.460939999997,31.21355121,-68.78644879,-479.7251375,-461.6595915,0.0017312179999999999,3867000,1,-0.4588
BSESN,11/29/2016,26394.00977,26587.07031,26354.66016,26408.61914,9600,43.839844,0.0,43.839844,47.52519593,25717.92969,27743.460939999997,33.37791397,-66.62208603,-443.5861251,-458.0448982,0.0036245270000000002,3876600,1,0.0
BSESN,11/30/2016,26652.81055,26680.55078,26395.5,26441.01953,7800,258.80078100000003,0.0,258.80078100000003,56.6277361,25717.92969,27743.460939999997,46.15484748,-53.84515252,-389.57189489999996,-444.3502976,0.01621159,3884400,1,-0.1779
BSESN,12/1/2016,26559.91992,26769.32031,26540.82031,26756.66016,11300,-92.890625,92.890625,0.0,52.83226884,25717.92969,27344.84961,51.75363723,-48.24636277,-350.2235662,-425.52495130000005,0.015666383,3873100,-1,-0.5719
BSESN,12/2/2016,26230.66016,26463.06055,26182.92969,26437.36914,9600,-329.259766,329.259766,0.0,41.46548737,25717.92969,26809.60938,46.96711628,-53.03288372,-341.6696882,-408.7538987,0.018067805,3863500,-1,-0.1027
BSESN,12/5/2016,26349.09961,26390.80078,26125.34961,26253.48047,12800,118.439453,0.0,118.439453,46.26402614,25717.92969,26769.32031,60.03191449,-39.96808551,-321.6260987,-391.3283387,0.014957961,3876300,1,-0.5267
BSESN,12/6/2016,26392.75977,26502.42969,26356.01953,26403.61914,7600,43.660157,0.0,43.660157,48.07458957,25717.92969,26769.32031,64.18452495,-35.81547505,-298.7743155,-372.81753399999997,0.013087352,3883900,1,0.7506
BSESN,12/7/2016,26236.86914,26540.83008,26164.82031,26456.21094,10500,-155.890625,155.890625,0.0,42.21463473,25717.92969,26769.32031,49.35743582,-50.64256418,-289.90138060000004,-356.2343034,0.014566773,3873400,-1,-0.0772
BSESN,12/8/2016,26694.2793,26733.86914,26357.34961,26366.51953,8200,457.410156,0.0,457.410156,59.095191299999996,25717.92969,26769.32031,92.86268926,-7.13731074,-243.1573721,-333.61891710000003,0.014361398999999999,3881600,1,0.5664
BSESN,12/9/2016,26747.17969,26803.75977,26707.81055,26787.14063,9800,52.900391000000006,0.0,52.900391000000006,60.62993554,25765.50977,26803.75977,94.55043795,-5.449562052,-199.5435751,-306.80384869999995,0.015066686999999999,3891400,1,0.0
BSESN,12/12/2016,26515.24023,26725.31055,26468.58984,26725.31055,8500,-231.939454,231.939454,0.0,50.95754551,25810.9707,26803.75977,70.93848605,-29.06151395,-181.60151299999998,-281.7633816,0.004593105,3882900,-1,0.128
BSESN,12/13/2016,26697.82031,26724.9707,26494.23047,26607.65039,7000,182.580079,0.0,182.580079,57.16448303,25810.9707,26803.75977,89.32910757,-10.67089243,-150.91001640000002,-255.5927085,0.0016887439999999998,3889900,1,0.0
BSESN,12/14/2016,26602.83984,26736.33984,26547.05078,26707.91016,9900,-94.980469,94.980469,0.0,53.12839441,25874.44922,26803.75977,78.37967915,-21.62032085,-132.7209892,-231.01836469999998,0.0016159660000000001,3880000,-1,0.0
BSESN,12/15/2016,26519.07031,26737.85938,26407.58008,26497.71094,12700,-83.769531,83.769531,0.0,49.56694908,26125.34961,26803.75977,58.03579147,-41.96420853,-123.64030679999999,-209.5427531,0.010995153999999998,3867300,-1,0.4019
BSESN,12/16/2016,26489.56055,26594.55078,26455.21094,26548.66992,7600,-29.509766,29.509766,0.0,48.25219581,26125.34961,26803.75977,53.68595005,-46.31404995,-117.47086100000001,-191.1283747,0.0053307680000000005,3859700,-1,0.5574
BSESN,12/19/2016,26374.69922,26505.66016,26340.38086,26505.66016,7400,-114.861328,114.861328,0.0,43.11594781,26125.34961,26803.75977,36.75499363,-63.24500637,-120.4612774,-176.9949552,-0.000684299,3852300,-1,0.0
BSESN,12/20/2016,26307.98047,26435.56055,26241.42969,26374.58984,7300,-66.71875,66.71875,0.0,40.24476853,26125.34961,26803.75977,26.92041947,-73.07958053,-126.75371159999999,-166.9467065,0.0027103590000000003,3845000,-1,0.5267
BSESN,12/21/2016,26242.38086,26396.0,26213.50977,26368.88086,6100,-65.59961,65.59961,0.0,37.41791552,26125.34961,26803.75977,17.25081041,-82.74918959,-135.472212,-160.65180759999998,-0.016928662,3838900,-1,0.0
BSESN,12/22/2016,25979.59961,26248.44922,25940.14063,26224.07031,7600,-262.78125,262.78125,0.0,28.24708841,25940.14063,26803.75977,4.569026105,-95.43097390000001,-161.7217099,-160.8657881,-0.028697608,3831300,-1,0.128
BSESN,12/23/2016,26040.69922,26143.18945,25872.38086,25959.99023,7500,61.09961,0.0,61.09961,32.67402727,25872.38086,26803.75977,18.07195318,-81.92804682,-175.5705304,-163.8067365,-0.017896916000000002,3838800,1,0.0
BSESN,12/26/2016,25807.09961,26008.57031,25753.74023,25992.41016,5400,-233.59961,233.59961,0.0,25.68362843,25753.74023,26803.75977,5.081750708,-94.91824929,-203.0546689,-171.656323,-0.03336305,3833400,-1,0.0
BSESN,12/27/2016,26213.43945,26249.0293,25803.18945,25815.42969,8700,406.33984399999997,0.0,406.33984399999997,48.008783,25753.74023,26803.75977,43.78006361,-56.21993639,-189.85923799999998,-175.296906,-0.01463755,3842100,1,0.0
BSESN,12/28/2016,26210.67969,26415.05078,26191.7207,26243.18945,8500,-2.7597650000000002,2.7597650000000002,0.0,47.89602689,25753.74023,26803.75977,43.51723373,-56.48276627,-177.5774517,-175.75301509999997,-0.011629013,3833600,-1,-0.29600000000000004
BSESN,12/29/2016,26366.15039,26429.63086,26166.66992,26429.41016,6700,155.47070300000001,0.0,155.47070300000001,54.79700908,25753.74023,26737.85938,62.22926996,-37.77073004,-153.5290735,-171.30822680000003,-0.004658822,3840300,1,0.0
BSESN,12/30/2016,26626.46094,26678.59961,26406.5293,26441.50977,8600,260.31054700000004,0.0,260.31054700000004,64.00683147,25753.74023,26737.85938,88.68039119,-11.31960881,-112.17261869999999,-159.4811052,0.009545577,3848900,1,0.34
BSESN,1/2/2017,26595.44922,26720.98047,26447.06055,26711.15039,8000,-31.011719,31.011719,0.0,62.26303282,25753.74023,26737.85938,85.52917527,-14.47082473,-80.96638684,-143.7781615,0.010927055,3840900,-1,0.0
BSESN,1/3/2017,26643.24023,26724.40039,26488.36914,26616.91992,9800,47.791015,0.0,47.791015,64.00668622,25753.74023,26737.85938,90.38539776,-9.614602243,-51.78197733,-125.3789247,0.015275267,3850700,1,0.0
BSESN,1/4/2017,26633.13086,26723.36914,26606.06055,26677.2207,8100,-10.109375,10.109375,0.0,63.29289031,25753.74023,26724.40039,90.59716922,-9.402830779,-29.13303709,-106.12974720000001,0.025155555,3842600,-1,-0.1779
BSESN,1/5/2017,26878.24023,26917.210939999997,26738.41992,26738.41992,9800,245.109375,0.0,245.109375,72.02167751,25753.74023,26917.210939999997,96.65047827,-3.349521725,8.496744148,-83.20444891,0.03216277,3852400,1,0.0
BSESN,1/6/2017,26759.23047,27009.60938,26733.33008,26929.68945,7800,-119.00976499999999,119.00976499999999,0.0,63.55481071,25753.74023,27009.60938,80.06329658,-19.93670342,28.38828103,-60.88590292,0.036894144,3844600,-1,0.0
BSESN,1/9/2017,26726.55078,26860.88086,26701.17969,26860.81055,6400,-32.679688,32.679688,0.0,61.27253274,25753.74023,27009.60938,77.46113948,-22.53886052,41.04237861,-40.50024661,0.019574361000000002,3838200,-1,0.5267
BSESN,1/10/2017,26899.56055,26914.94922,26804.16992,26811.63086,8600,173.00976599999998,0.0,173.00976599999998,68.23955649,25753.74023,27009.60938,91.23723767,-8.76276233,64.29018707,-19.54215988,0.026282449,3846800,1,0.0
BSESN,1/11/2017,27140.410160000003,27174.86914,26978.43945,26978.43945,12000,240.849609,0.0,240.849609,75.35981031,25753.74023,27174.86914,97.57523861,-2.4247613869999998,100.9847045,4.563213008,0.029365673999999998,3858800,1,0.0516
BSESN,1/12/2017,27247.160160000003,27278.929689999997,27166.68945,27171.660160000003,11700,106.75,0.0,106.75,77.89426077,25753.74023,27278.929689999997,97.91701077,-2.082989226,137.098817,31.07033381,0.023311368,3870500,1,0.4767
BSESN,1/13/2017,27238.06055,27459.75,27143.070310000003,27378.00977,10200,-9.099609,9.099609,0.0,77.11411387,25803.18945,27459.75,86.61748565,-13.38251435,163.1050752,57.47728209,0.024162454,3860300,-1,0.0
BSESN,1/16/2017,27288.16992,27335.08008,27172.679689999997,27238.34961,12600,50.109375,0.0,50.109375,78.48338376,26166.66992,27459.75,86.73090082,-13.26909918,185.6189305,83.10561176,0.024206127999999997,3872900,1,0.1531
BSESN,1/17/2017,27235.660160000003,27381.429689999997,27179.18945,27331.820310000003,8100,-52.509766000000006,52.509766000000006,0.0,73.18876437,26166.66992,27459.75,82.67007219,-17.32992781,196.9538621,105.8752618,0.0226233,3864800,-1,0.4767
BSESN,1/18/2017,27257.64063,27422.66992,27217.65039,27261.75977,9500,21.980469,0.0,21.980469,74.03480909999999,26406.5293,27459.75,80.81034921,-19.18965079,205.3434459,125.7688987,0.014115522,3874300,1,-0.6908
BSESN,1/19/2017,27308.59961,27348.18945,27219.89063,27253.339839999997,10800,50.958984,0.0,50.958984,76.05598961,26447.06055,27459.75,85.07435912,-14.92564088,213.6414895,143.3434168,0.02053008,3885100,1,0.25
BSESN,1/20/2017,27034.5,27264.410160000003,27009.81055,27232.68945,8800,-274.099609,274.099609,0.0,51.28130202,26488.36914,27459.75,56.22211452,-43.77788548,195.842649,153.84326330000002,0.011522221000000001,3876300,-1,-0.6597
BSESN,1/23/2017,27117.339839999997,27167.789060000003,26963.58008,26990.929689999997,6600,82.839844,0.0,82.839844,56.25091433,26606.06055,27459.75,59.89054863,-40.10945137,186.2741701,160.3294446,0.008096016999999999,3882900,1,0.4215
BSESN,1/24/2017,27375.58008,27393.34961,27140.84961,27170.88086,6800,258.240234,0.0,258.240234,67.9941691,26701.17969,27459.75,88.90413708,-11.09586292,197.2550765,167.714571,0.008664936,3889700,1,0.0
BSESN,1/25/2017,27708.14063,27736.83008,27439.679689999997,27462.83008,12200,332.56054700000004,0.0,332.56054700000004,77.11996743,26701.17969,27736.83008,97.22981295,-2.770187051,230.13947620000002,180.199552,0.016918478,3901900,1,0.4588
BSESN,1/27/2017,27882.460939999997,27980.39063,27759.48047,27761.0293,14300,174.320313,0.0,174.320313,80.48530547,26701.17969,27980.39063,92.34452394,-7.6554760570000004,267.1868288,197.5970074,0.023658086000000002,3916200,1,0.0
BSESN,1/30/2017,27849.56055,27947.36914,27813.320310000003,27866.80078,8600,-32.900391,32.900391,0.0,77.98728035,26804.16992,27980.39063,88.87708083,-11.12291917,290.5431357,216.18623300000002,0.020572674,3907600,-1,0.0
BSESN,1/31/2017,27655.960939999997,27867.91992,27624.539060000003,27867.91992,10700,-193.59960900000002,193.59960900000002,0.0,64.41330357,26963.58008,27980.39063,68.09339872,-31.90660128,290.0873601,230.9664585,0.015432003,3896900,-1,-0.4215
BSESN,2/1/2017,28141.64063,28159.539060000003,27590.09961,27669.08008,18200,485.679687,0.0,485.679687,76.33582416,26963.58008,28159.539060000003,98.50342376,-1.4965762390000001,325.1681109,249.8067889,0.032431273999999996,3915100,1,0.6486
BSESN,2/2/2017,28226.60938,28299.91992,28070.81055,28167.83008,17200,84.96875,0.0,84.96875,77.83484728,26963.58008,28299.91992,94.51407908,-5.485920915,355.725544,270.99054,0.033616142,3932300,1,0.128
BSESN,2/3/2017,28240.51953,28280.58008,28127.179689999997,28270.66992,10800,13.910156,0.0,13.910156,78.09693252,26963.58008,28299.91992,95.55499364,-4.445006356,376.72234260000005,292.13690049999997,0.044610388,3943100,1,0.0
BSESN,2/6/2017,28439.2793,28487.2793,28340.39063,28340.39063,10000,198.75976599999998,0.0,198.75976599999998,81.67025799,26963.58008,28487.2793,96.84977196,-3.1502280369999998,404.7351736,314.65655510000005,0.048748862000000004,3953100,1,0.2732
BSESN,2/7/2017,28335.160160000003,28483.410160000003,28239.11914,28443.23047,10800,-104.119141,104.119141,0.0,74.33967833,26963.58008,28487.2793,90.01645869,-9.983541312,413.7643813,334.4781203,0.035052411,3942300,-1,0.0
BSESN,2/8/2017,28289.91992,28391.64063,28149.08008,28386.08008,10900,-45.240234,45.240234,0.0,71.13841961,26963.58008,28487.2793,87.04735341,-12.95264659,412.5143756,350.0853714,0.020996692,3931400,-1,0.0
BSESN,2/9/2017,28329.69922,28469.48047,28152.179689999997,28349.2207,10200,39.779297,0.0,39.779297,72.34659205,26963.58008,28487.2793,89.65805875,-10.34194125,410.0072852,362.0697542,0.016040129,3941600,1,-0.25
BSESN,2/10/2017,28334.25,28456.179689999997,28286.80078,28367.16992,13700,4.550781,0.0,4.550781,72.49855617,26963.58008,28487.2793,89.95672538,-10.04327462,403.7336182,370.402527,0.017403846,3955300,1,-0.34
BSESN,2/13/2017,28351.61914,28458.80078,28197.38086,28450.41992,9400,17.369141,0.0,17.369141,73.14839105,27140.84961,28487.2793,89.924453,-10.075547,395.6029716,375.4426159,0.025154006,3964700,1,0.0
BSESN,2/14/2017,28339.31055,28393.41992,28263.44922,28386.11914,11700,-12.308594,12.308594,0.0,71.7618925,27439.679689999997,28487.2793,85.87544815,-14.12455185,383.7426287,377.1026185,0.007024108,3953000,-1,0.4019
BSESN,2/15/2017,28155.56055,28382.320310000003,28102.23047,28270.10938,17800,-183.75,183.75,0.0,54.09872838,27590.09961,28487.2793,63.02649799,-36.97350201,355.4190823,372.76591119999995,-0.0025170870000000003,3935200,-1,0.3612
BSESN,2/16/2017,28301.26953,28327.839839999997,28146.18945,28223.84961,9700,145.70898400000002,0.0,145.70898400000002,62.53589889999999,27590.09961,28487.2793,79.26727851,-20.73272149,340.8014183,366.37301260000004,0.002151164,3944900,1,-0.5106
BSESN,2/17/2017,28468.75,28726.25977,28410.910160000003,28670.429689999997,15000,167.480469,0.0,167.480469,69.87883325,27590.09961,28726.25977,77.33508217,-22.66491783,338.8253211,360.8634743,0.0010362680000000001,3959900,1,0.3182
BSESN,2/20/2017,28661.58008,28696.5293,28419.26953,28481.910160000003,8900,192.83007800000001,0.0,192.83007800000001,76.10157893,27590.09961,28726.25977,94.30716809,-5.692831912999999,348.79829589999997,358.4504387,0.01151996,3968800,1,-0.4019
BSESN,2/21/2017,28761.589839999997,28801.0,28597.33008,28716.69922,8400,100.009766,0.0,100.009766,78.73106863,28070.81055,28801.0,94.60274921,-5.397250787000001,360.6149579,358.88334249999997,0.01667272,3977200,1,0.0
BSESN,2/22/2017,28864.710939999997,28963.51953,28789.30078,28822.40039,16300,103.121094,0.0,103.121094,81.19299425,28102.23047,28963.51953,88.52782447,-11.47217553,373.98963829999997,361.9046017,0.018885189,3993500,1,0.1027
BSESN,2/23/2017,28892.9707,29065.31055,28860.460939999997,28927.66992,18400,28.259765,0.0,28.259765,81.85705231,28102.23047,29065.31055,82.10534638,-17.89465362,382.46072660000004,366.0158266,0.019718916,4011900,1,0.0
BSESN,2/27/2017,28812.88086,28961.83008,28791.18945,28910.5,12000,-80.089844,80.089844,0.0,73.38391792,28102.23047,29065.31055,73.78933551,-26.21066449,378.3501589,368.4826931,0.016269325,3999900,-1,-0.5719
BSESN,2/28/2017,28743.320310000003,28876.539060000003,28721.11914,28825.18945,10700,-69.560546,69.560546,0.0,66.4869552,28102.23047,29065.31055,66.56661877,-33.43338123,365.2689565,367.8399458,0.014256161000000002,3989200,-1,0.0
BSESN,3/1/2017,28984.49023,29029.16992,28824.16992,28849.039060000003,14600,241.169921,0.0,241.169921,75.64424022,28102.23047,29065.31055,91.60814196,-8.391858044,370.0961682,368.2911903,0.029441065,4003800,1,-0.128
BSESN,3/2/2017,28839.789060000003,29145.61914,28784.31055,29117.38086,10800,-144.701171,144.701171,0.0,63.61101649,28102.23047,29145.61914,70.68876765,-29.31123235,358.1174381,366.2564398,0.019028105,3993000,-1,0.2023
BSESN,3/3/2017,28832.44922,28860.13086,28716.210939999997,28827.5,9300,-7.339844,7.339844,0.0,63.02423501,28102.23047,29145.61914,69.98530553,-30.01469447,344.0657682,361.8183055,0.012775383999999999,3983700,-1,-0.29600000000000004
BSESN,3/6/2017,29048.18945,29070.19922,28856.11914,28859.210939999997,12100,215.740234,0.0,215.740234,71.83550108,28102.23047,29145.61914,90.66218653,-9.337813473999999,346.34569480000005,358.7237834,0.013488766999999999,3995800,1,0.0
BSESN,3/7/2017,28999.56055,29098.16992,28957.679689999997,29092.160160000003,9700,-48.628906,48.628906,0.0,67.64316284,28102.23047,29145.61914,86.00151622,-13.99848378,340.3057737,355.0401814,0.008273906,3986100,-1,0.5574
BSESN,3/8/2017,28901.93945,29022.320310000003,28815.48047,29021.06055,16300,-97.621094,97.621094,0.0,59.588020400000005,28146.18945,29145.61914,75.61812592,-24.38187408,323.9080756,348.8137603,0.001289759,3969800,-1,-0.7003
BSESN,3/9/2017,28929.13086,28986.7207,28815.01953,28909.69922,401500,27.191406,0.0,27.191406,61.07766975,28410.910160000003,29145.61914,70.53414529999999,-29.4658547,309.5387311,340.9587544,0.001251521,4371300,1,0.0258
BSESN,3/10/2017,28946.23047,29076.63086,28851.039060000003,29006.0,15900,17.099610000000002,0.0,17.099610000000002,62.09160853,28419.26953,29145.61914,72.5492147,-27.4507853,296.11726219999997,331.990456,0.004628125,4387200,1,0.0
BSESN,3/14/2017,29442.63086,29561.929689999997,29356.05078,29437.23047,29200,496.40039,0.0,496.40039,79.75609475,28597.33008,29561.929689999997,87.63229554,-12.36770446,321.82620210000005,329.9576052,0.024329497999999998,4416400,1,-0.5106
BSESN,3/15/2017,29398.10938,29500.08008,29358.910160000003,29452.85938,392500,-44.521484,44.521484,0.0,76.08697895,28716.210939999997,29561.929689999997,80.62945713,-19.37054287,334.7494276,330.91596969999995,0.014270361,4023900,-1,0.5574
BSESN,3/16/2017,29585.84961,29614.789060000003,29482.83008,29482.83008,18400,187.74023400000002,0.0,187.74023400000002,80.46062666,28716.210939999997,29614.789060000003,96.77941704,-3.220582963,356.03608239999994,335.9399922,0.02586914,4042300,1,0.25
BSESN,3/17/2017,29648.99023,29824.61914,29601.85938,29755.74023,14500,63.140625,0.0,63.140625,81.75553747,28716.210939999997,29824.61914,84.15485319,-15.84514681,373.6931286,343.4906195,0.02832021,4056800,1,0.0
BSESN,3/20/2017,29518.74023,29699.48047,29482.40039,29653.539060000003,400800,-130.25,130.25,0.0,70.61640008,28716.210939999997,29824.61914,72.4037673,-27.596232699999998,372.87807230000004,349.3681101,0.016198971,3656000,-1,-0.4215
BSESN,3/21/2017,29485.44922,29585.05078,29380.14063,29525.88086,11500,-33.291015,33.291015,0.0,67.88850394,28716.210939999997,29824.61914,69.40026959,-30.59973041,365.3344791,352.56138389999995,0.016755036,3644500,-1,-0.1027
BSESN,3/22/2017,29167.679689999997,29341.410160000003,29137.48047,29341.410160000003,14700,-317.76953100000003,317.76953100000003,0.0,47.625791299999996,28716.210939999997,29824.61914,40.73127109,-59.26872891,329.9117642,348.0314599,0.009194546999999999,3629800,-1,-0.0258
BSESN,3/23/2017,29332.160160000003,29373.789060000003,29198.08008,29201.00977,26000,164.480468,0.0,164.480468,55.549492,28716.210939999997,29824.61914,55.57061165,-44.42938835,311.5201957,340.72920710000005,0.013931608,3655800,1,-0.8271
BSESN,3/24/2017,29421.40039,29539.84961,29350.16992,29350.59961,21000,89.240235,0.0,89.240235,59.39524803,28815.01953,29824.61914,60.06151884,-39.93848116,300.67963860000003,332.71929339999997,0.016415606,3676800,1,-0.4404
BSESN,3/27/2017,29237.15039,29420.69922,29163.539060000003,29395.679689999997,15100,-184.25,184.25,0.0,49.24528706,28815.01953,29824.61914,41.81170989,-58.18829011,274.0617704,320.98778880000003,-0.006979012,3661700,-1,0.0
BSESN,3/28/2017,29409.51953,29442.179689999997,29301.2207,29301.2207,33500,172.36914,0.0,172.36914,57.14965149,28815.01953,29824.61914,58.88472956,-41.11527044,263.83434900000003,309.5571008,0.000388126,3695200,1,-0.6705
BSESN,3/29/2017,29531.429689999997,29554.39063,29439.41992,29463.00977,41600,121.91015700000001,0.0,121.91015700000001,61.98150524,28815.01953,29824.61914,70.95982902,-29.04017098,262.53977940000004,300.1536365,-0.00183939,3736800,1,-0.4019
BSESN,3/30/2017,29647.41992,29684.539060000003,29521.65039,29538.0293,15700,115.99023400000002,0.0,115.99023400000002,66.16942405,28851.039060000003,29824.61914,81.79921477,-18.20078523,267.7863915,293.6801875,-5.3e-05,3752500,1,0.0
BSESN,3/31/2017,29620.5,29687.64063,29552.60938,29633.910160000003,11800,-26.919921999999996,26.919921999999996,0.0,64.27343796,29137.48047,29824.61914,70.29433078,-29.70566922,266.69782999999995,288.283716,0.003447294,3740700,-1,0.0
BSESN,4/3/2017,29910.2207,29926.93945,29705.7207,29737.73047,10100,289.72070299999996,0.0,289.72070299999996,73.64949713,29137.48047,29926.93945,97.88225223,-2.117747766,285.9173,287.8104328,0.014406138999999998,3750800,1,-0.5574
BSESN,4/5/2017,29974.24023,30007.48047,29817.68945,29996.0293,11200,64.019531,0.0,64.019531,75.30210536,29137.48047,30007.48047,96.17928333,-3.8207166669999997,302.8239436,290.813135,0.027652543999999998,3762000,1,0.128
BSESN,4/6/2017,29927.339839999997,29954.25,29817.589839999997,29946.89063,11300,-46.90039,46.90039,0.0,71.51100105,29137.48047,30007.48047,90.78843391,-9.211566092,308.8775627,294.4260205,0.020291028,3750700,-1,-0.25
BSESN,4/7/2017,29706.60938,29886.11914,29668.44922,29850.710939999997,14700,-220.730469,220.730469,0.0,56.15770276,29137.48047,30007.48047,65.41711563,-34.58288437,292.4923258,294.03928160000004,0.00969393,3736000,-1,0.3182
BSESN,4/10/2017,29575.74023,29831.320310000003,29553.039060000003,29752.61914,10700,-130.86914099999998,130.86914099999998,0.0,48.96578917,29137.48047,30007.48047,50.37468563,-49.62531437,265.8819401,288.4078133,0.011580809,3725300,-1,0.128
BSESN,4/11/2017,29788.34961,29804.50977,29570.58008,29630.06055,10800,212.609375,0.0,212.609375,58.84552365,29137.48047,30007.48047,74.81254483,-25.18745517,258.9636457,282.5189798,0.012881206000000001,3736100,1,-0.7845
BSESN,4/12/2017,29643.48047,29838.820310000003,29549.74023,29838.820310000003,8500,-144.86914,144.86914,0.0,51.07215242,29163.539060000003,30007.48047,56.86904358,-43.13095642,239.03566439999997,273.8223167,0.003794289,3727600,-1,-0.29600000000000004
BSESN,4/13/2017,29461.44922,29660.48047,29442.25977,29637.11914,10700,-182.03125,182.03125,0.0,42.86302858,29163.539060000003,30007.48047,35.29986251,-64.70013749,206.17750900000001,260.2933551,-0.006272745,3716900,-1,-0.3612
BSESN,4/17/2017,29413.660160000003,29494.08008,29363.2793,29470.26953,6700,-47.789063,47.789063,0.0,40.87291122,29163.539060000003,30007.48047,29.63725813,-70.36274187,174.27210580000002,243.08910530000003,-0.006982996,3710200,-1,0.29600000000000004
BSESN,4/18/2017,29319.09961,29701.18945,29286.38086,29487.7793,12100,-94.560547,94.560547,0.0,36.95545824,29286.38086,30007.48047,4.537341242,-95.46265876,139.7456966,222.4204235,-0.019763181,3698100,-1,-0.2263
BSESN,4/19/2017,29336.570310000003,29388.25,29241.48047,29369.90039,11600,17.470704,0.0,17.470704,38.21780848,29241.48047,30007.48047,12.41381775,-87.58618225,112.496222,200.4355832,-0.021273931,3709700,1,0.1027
BSESN,4/20/2017,29422.39063,29453.06055,29341.679689999997,29358.589839999997,14600,85.820312,0.0,85.820312,44.51485225,29241.48047,30007.48047,23.61751384,-76.38248616,96.71097503,179.6906616,-0.016872506000000002,3724300,1,-0.34
BSESN,4/21/2017,29365.30078,29584.339839999997,29259.41992,29575.660160000003,11300,-57.08984399999999,57.08984399999999,0.0,41.285002,29241.48047,30007.48047,16.16453159,-83.83546841,78.68732135,159.4899935,-0.011489315,3713000,-1,0.5574
BSESN,4/24/2017,29655.839839999997,29681.33008,29392.99023,29407.679689999997,8900,290.539063,0.0,290.539063,58.827127100000006,29241.48047,30007.48047,54.09391319,-45.90608681,86.84640886,144.9612766,0.0027082879999999997,3721900,1,-0.5267
BSESN,4/25/2017,29943.24023,29961.820310000003,29780.839839999997,29825.14063,8600,287.40039,0.0,287.40039,69.29705906,29241.48047,30007.48047,91.61354634,-8.386453655,115.1756805,139.0041574,0.005199705,3730500,1,-0.3818
BSESN,4/26/2017,30133.34961,30167.089839999997,29968.570310000003,30030.19922,10900,190.109375,0.0,190.109375,74.28752078,29241.48047,30167.089839999997,96.35480842,-3.64519158,151.22385569999997,141.448097,0.016525358,3741400,1,-0.5423
BSESN,4/27/2017,30029.74023,30184.2207,29973.40039,30141.39063,10700,-103.609375,103.609375,0.0,67.3985444,29241.48047,30184.2207,83.61367602,-16.38632398,169.4782438,147.0541264,0.01928931,3730700,-1,0.2263
BSESN,4/28/2017,29918.40039,30067.64063,29848.210939999997,30064.59961,11300,-111.33984299999999,111.33984299999999,0.0,60.44797987,29241.48047,30184.2207,71.80344040000001,-28.1965596,172.9669281,152.23668669999998,0.017160062,3719400,-1,0.4215
BSESN,5/2/2017,29921.179689999997,30069.24023,29804.11914,30021.49023,11700,2.779297,0.0,2.779297,60.56511372,29241.48047,30184.2207,72.09825087,-27.90174913,173.9508049,156.5795104,0.020535422,3731100,1,0.0
BSESN,5/3/2017,29894.80078,30020.589839999997,29846.570310000003,29984.94922,11300,-26.378907,26.378907,0.0,58.66252786,29241.48047,30184.2207,69.30014106,-30.69985894,170.635003,159.39060890000002,0.019028484,3719800,-1,0.0
BSESN,5/4/2017,30126.210939999997,30169.94922,30007.40039,30069.7207,22300,231.41015699999997,0.0,231.41015699999997,68.63565711,29241.48047,30184.2207,93.84668619,-6.153313809,184.5526635,164.42301980000002,0.023921248,3742100,1,-0.29600000000000004
BSESN,5/5/2017,29858.80078,30176.55078,29823.59961,30142.14063,15900,-267.41015699999997,267.41015699999997,0.0,51.93041675,29241.48047,30184.2207,65.48148575,-34.51851425,172.02178490000003,165.9427728,0.016805549,3726200,-1,-0.1779
BSESN,5/8/2017,29926.15039,30016.039060000003,29877.410160000003,29915.11914,10000,67.34961,0.0,67.34961,55.10581443,29241.48047,30184.2207,72.62551202,-27.37448798,165.6164011,165.8774985,0.009114918,3736200,1,-0.7579
BSESN,5/9/2017,29933.25,30017.820310000003,29911.43945,29977.5,8400,7.099609,0.0,7.099609,55.46365501,29241.48047,30184.2207,73.37859424,-26.62140576,159.27692230000002,164.5573832,-0.000333639,3744600,1,-0.5859
BSESN,5/10/2017,30248.16992,30271.59961,29987.43945,29988.7793,11000,314.91992200000004,0.0,314.91992200000004,68.36808002,29259.41992,30271.59961,97.68522454,-2.3147754590000003,177.6167896,167.1692645,0.003810407,3755600,1,0.5267
BSESN,5/11/2017,30250.98047,30366.429689999997,30207.10938,30309.710939999997,10700,2.810547,0.0,2.810547,68.46218105,29259.41992,30366.429689999997,89.57107493,-10.42892507,190.1857118,171.772554,0.007367371,3766300,1,0.29600000000000004
BSESN,5/12/2017,30188.15039,30299.74023,30111.44922,30285.60938,11100,-62.830078,62.830078,0.0,63.58312994,29392.99023,30366.429689999997,81.68563065,-18.31436935,192.8537134,175.9887859,0.009016191,3755200,-1,0.0
BSESN,5/15/2017,30322.11914,30357.960939999997,30273.61914,30287.36914,8000,133.96875,0.0,133.96875,69.01575112,29780.839839999997,30366.429689999997,92.433177,-7.566822999999999,203.43323080000002,181.47767480000002,0.013399854,3763200,1,0.2732
BSESN,5/16/2017,30582.59961,30591.55078,30363.36914,30391.48047,13600,260.48046800000003,0.0,260.48046800000003,76.78521479999999,29804.11914,30591.55078,98.86324456,-1.136755439,230.18276769999997,191.2186934,0.023007306,3776800,1,0.0
BSESN,5/17/2017,30658.76953,30692.44922,30519.14063,30616.5293,14900,76.169922,0.0,76.169922,78.59613197,29804.11914,30692.44922,96.20865162,-3.791348378,254.5934497,203.89364469999998,0.017677583,3791700,1,0.0
BSESN,5/18/2017,30434.789060000003,30575.83008,30393.7207,30466.820310000003,16200,-223.98046800000003,223.98046800000003,0.0,62.14742991,29804.11914,30692.44922,70.99499809999999,-29.005001899999996,252.9498903,213.7048938,0.019290401999999998,3775500,-1,0.0
BSESN,5/19/2017,30464.91992,30712.34961,30338.51953,30539.65039,13800,30.130859,0.0,30.130859,63.33837422,29804.11914,30712.34961,72.75694929,-27.24305071,251.18318280000003,221.20055159999998,0.018003302,3789300,1,0.34
BSESN,5/22/2017,30570.9707,30712.15039,30516.86914,30638.88086,11400,106.050781,0.0,106.050781,67.49207828,29823.59961,30712.34961,84.09238751,-15.90761249,255.39641519999998,228.03972430000002,0.02130476,3800700,1,0.4404
BSESN,5/23/2017,30365.25,30610.64063,30316.91992,30553.89063,18700,-205.72070300000001,205.72070300000001,0.0,53.83894305,29823.59961,30712.34961,60.94519167,-39.05480833,239.37611189999998,230.30700180000002,0.00387065,3782000,-1,0.4767
BSESN,5/24/2017,30301.64063,30534.15039,30247.59961,30446.76953,11300,-63.609375,63.609375,0.0,50.21482311,29823.59961,30712.34961,53.78801868,-46.21198132,219.02240730000003,228.05008289999998,0.0016746620000000002,3770700,-1,-0.7003
BSESN,5/25/2017,30750.0293,30793.429689999997,30352.25977,30374.81055,10000,448.388672,0.0,448.388672,67.82872887,29877.410160000003,30793.429689999997,95.26206708,-4.737932924,236.3486876,229.7098039,0.018612565,3780700,1,0.1027
BSESN,5/26/2017,31028.210939999997,31074.070310000003,30745.570310000003,30765.76953,14600,278.181641,0.0,278.181641,74.33005905,29911.43945,31074.070310000003,96.05555154,-3.944448455,269.4211044,237.65206400000002,0.02328636,3795300,1,0.0
BSESN,5/29/2017,31109.2793,31214.39063,30869.90039,30944.38086,14900,81.068359,0.0,81.068359,75.96340357,29987.43945,31214.39063,91.43312869,-8.566871315,298.7292077,249.86749269999996,0.017221547,3810200,1,0.0258
BSESN,5/30/2017,31159.40039,31220.38086,31064.039060000003,31111.73047,9600,50.121094,0.0,50.121094,77.00707597,30111.44922,31220.38086,94.5009714,-5.499028597000001,322.28533930000003,264.351062,0.016329124,3819800,1,0.0
BSESN,5/31/2017,31145.80078,31255.2793,31107.48047,31222.50977,13000,-13.59961,13.59961,0.0,75.97428679,30111.44922,31255.2793,90.42877801,-9.571221994,335.9833614,278.67752189999993,0.023361809,3806800,-1,-0.29600000000000004
BSESN,6/1/2017,31137.589839999997,31213.11914,31062.01953,31117.089839999997,8300,-8.210937,8.210937,0.0,75.27101533,30247.59961,31255.2793,88.32074771,-11.67925229,342.2315563,291.3883288,0.022080147,3798500,-1,0.0
BSESN,6/2/2017,31273.289060000003,31332.56055,31190.40039,31205.36914,8500,135.699219,0.0,135.699219,78.98120934,30247.59961,31332.56055,94.53699374,-5.463006264,354.0517999,303.921023,0.022973375,3807000,1,0.0772
BSESN,6/5/2017,31309.49023,31355.41992,31198.2207,31274.74023,9000,36.201171,0.0,36.201171,79.90907162,30247.59961,31355.41992,95.85404894,-4.145951059,362.16573880000004,315.5699662,0.03109608,3816000,1,-0.743
BSESN,6/6/2017,31190.56055,31430.320310000003,31172.55078,31420.84961,13600,-118.92968700000002,118.92968700000002,0.0,68.45417221,30247.59961,31430.320310000003,79.72811627,-20.27188373,354.9083002,323.437633,0.029335702999999998,3802400,-1,-0.5106
BSESN,6/7/2017,31271.2793,31346.99023,31172.98047,31252.710939999997,9500,80.71875,0.0,80.71875,71.63809582,30247.59961,31430.320310000003,86.55295240000001,-13.4470476,351.61683619999997,329.0734736,0.016951203,3811900,1,0.0
BSESN,6/8/2017,31213.35938,31354.50977,31193.76953,31316.910160000003,14000,-57.919922,57.919922,0.0,66.1133615,30247.59961,31430.320310000003,81.65577577,-18.34422423,340.4106318,331.34090530000003,0.0059671,3797900,-1,0.0
BSESN,6/9/2017,31262.06055,31289.99023,31087.2793,31196.85938,9800,48.701172,0.0,48.701172,68.47231206,30247.59961,31430.320310000003,85.77349957,-14.22650043,331.63651239999996,331.4000267,0.004911115,3807700,1,0.3182
BSESN,6/12/2017,31095.69922,31225.429689999997,31044.2793,31225.429689999997,6800,-166.36132800000001,166.36132800000001,0.0,53.72993443,30247.59961,31430.320310000003,71.70751363,-28.29248637,307.7118797,326.6623973,-0.002044364,3800900,-1,-0.5106
BSESN,6/13/2017,31103.49023,31260.76953,31062.339839999997,31091.09961,13300,7.791015,0.0,7.791015,54.26206555,30352.25977,31430.320310000003,69.68351361,-30.31648639,286.0823267,318.5463832,-0.0013584670000000001,3814200,1,0.0
BSESN,6/14/2017,31155.910160000003,31190.35938,31054.93945,31147.68945,12700,52.419922,0.0,52.419922,58.01097196,30745.570310000003,31430.320310000003,59.92549733,-40.07450267,270.0575445,308.8486155,0.000588366,3826900,1,0.3818
BSESN,6/15/2017,31075.73047,31229.43945,31026.48047,31222.89063,12700,-80.179687,80.179687,0.0,50.67971992,30869.90039,31430.320310000003,36.72783031,-63.27216969,248.0288365,296.6846597,-0.006317166999999999,3814200,-1,0.0
BSESN,6/16/2017,31056.40039,31182.73047,31017.179689999997,31160.4707,13300,-19.330078,19.330078,0.0,48.95858842,31017.179689999997,31430.320310000003,9.493305821,-90.50669418,226.4013372,282.6279952,-0.008083487,3800900,-1,0.0
BSESN,6/19/2017,31311.570310000003,31362.15039,31163.34961,31168.98047,7500,255.169922,0.0,255.169922,66.35987154,31017.179689999997,31430.320310000003,71.25676033,-28.74323967,227.23207850000003,271.5488118,0.003879692,3808400,1,-0.6908
BSESN,6/20/2017,31297.5293,31392.5293,31261.49023,31392.5293,8100,-14.041016,14.041016,0.0,64.95388651,31017.179689999997,31430.320310000003,67.85815579999999,-32.1418442,224.17332369999997,262.0737142,0.000839428,3800300,-1,-0.128
BSESN,6/21/2017,31283.64063,31336.43945,31193.60938,31302.179689999997,35700,-13.888672,13.888672,0.0,63.42028183,31017.179689999997,31430.320310000003,64.49642588,-35.50357412,218.1142534,253.28182200000003,0.00225164,3764600,-1,0.0
BSESN,6/22/2017,31290.74023,31522.86914,31255.63086,31351.5293,10200,7.099609,0.0,7.099609,63.92269839,31017.179689999997,31522.86914,54.09654965,-45.90345035,211.4478366,244.915025,0.000917396,3774800,1,-0.25
BSESN,6/23/2017,31138.210939999997,31365.39063,31110.39063,31352.570310000003,89700,-152.529296,152.529296,0.0,47.68646011,31017.179689999997,31522.86914,23.93390831,-76.06609169,191.64761940000002,234.2615438,0.001367125,3685100,-1,0.4019
BSESN,6/27/2017,30958.25,31294.960939999997,30847.08008,31194.679689999997,15300,-179.960938,179.960938,0.0,35.43399813,30847.08008,31522.86914,16.45038786,-83.54961214,159.5947519,219.32818540000002,-0.00466958,3669800,-1,0.0
BSESN,6/28/2017,30834.320310000003,31000.48047,30798.69922,30988.86914,9900,-123.92968700000002,123.92968700000002,0.0,29.42629028,30798.69922,31522.86914,4.918886151000001,-95.08111385,122.777234,200.01799509999998,-0.010321953,3659900,-1,0.4767
BSESN,6/29/2017,30857.51953,31097.91992,30794.60938,30910.9707,12300,23.199218,0.0,23.199218,31.91949154,30794.60938,31522.86914,8.638422571,-91.36157743,94.38307935,178.89101200000002,-0.007021909000000001,3672200,1,0.0
BSESN,6/30/2017,30921.60938,30965.44922,30680.660160000003,30824.9707,9200,64.089844,0.0,64.089844,38.8101048,30680.660160000003,31522.86914,28.60919597,-71.39080403,76.17393632,158.3475969,-0.004340201,3681400,1,0.0
BSESN,7/3/2017,31221.61914,31258.33008,31017.10938,31156.039060000003,8100,300.009766,0.0,300.009766,60.43777949,30680.660160000003,31522.86914,64.23096816,-35.76903184,84.97183766,143.67244499999998,-0.002872777,3689500,1,0.0
BSESN,7/4/2017,31209.789060000003,31353.460939999997,31166.36914,31331.210939999997,8700,-11.830078,11.830078,0.0,59.48122407,30680.660160000003,31522.86914,62.82631941,-37.17368059,89.95273035,132.9285021,-0.002803424,3680800,-1,0.0
BSESN,7/5/2017,31245.56055,31284.64063,31177.7793,31272.7207,6500,35.771484,0.0,35.771484,61.6015961,30680.660160000003,31522.86914,67.07365999,-32.92634001,95.68360249,125.4795222,-0.001217252,3687300,1,0.0
BSESN,7/6/2017,31369.339839999997,31460.69922,31264.85938,31298.41992,10100,123.779297,0.0,123.779297,68.23787036,30680.660160000003,31522.86914,81.77064129,-18.22935871,108.9573226,122.17508219999999,0.0025119129999999997,3697400,1,0.0
BSESN,7/7/2017,31360.63086,31426.289060000003,31286.61914,31373.51953,6200,-8.708985,8.708985,0.0,67.29369435,30680.660160000003,31522.86914,80.73657668,-19.26342332,117.42054809999999,121.2241754,0.00714299,3691200,-1,0.0
BSESN,7/10/2017,31715.64063,31768.39063,31471.410160000003,31510.61914,37900,355.009766,0.0,355.009766,80.1876137,30680.660160000003,31768.39063,95.15045303,-4.84954697,151.0330217,127.1859447,0.024464904,3729100,1,-0.8658
BSESN,7/11/2017,31747.089839999997,31885.10938,31718.48047,31789.5,9100,31.449219,0.0,31.449219,80.95506432,30680.660160000003,31885.10938,88.54085927,-11.45914073,178.15517649999998,137.37979099999998,0.029602389,3738200,1,0.0
BSESN,7/12/2017,31804.820310000003,31865.68945,31731.429689999997,31813.24023,8300,57.73046899999999,0.0,57.73046899999999,82.3991422,30680.660160000003,31885.10938,93.33396039,-6.666039607999999,201.9797491,150.2997826,0.030699188,3746500,1,0.128
BSESN,7/13/2017,32037.38086,32091.51953,31892.63086,31896.23047,10500,232.560546,0.0,232.560546,86.98588669,30680.660160000003,32091.51953,96.16271664,-3.837283358,236.89579959999998,167.618986,0.036083875,3757000,1,0.0
BSESN,7/14/2017,32020.75,32109.75,31897.86914,32099.929689999997,7200,-16.630859,16.630859,0.0,85.15481035,30680.660160000003,32109.75,93.77225999,-6.22774001,260.22533430000004,186.14025569999998,0.025595432999999997,3749800,-1,0.0
BSESN,7/17/2017,32074.7793,32131.91992,32037.210939999997,32053.98047,10300,54.029297,0.0,54.029297,86.24053975,30680.660160000003,32131.91992,96.06268799,-3.9373120060000004,279.8479582,204.8817962,0.02771535,3760100,1,-0.4019
BSESN,7/18/2017,31710.99023,31911.60938,31626.43945,31775.539060000003,21600,-363.789063,363.789063,0.0,54.99319931,30680.660160000003,32131.91992,70.99556552,-29.00443448,263.0124482,216.5079266,0.014895866,3738500,-1,0.5719
BSESN,7/19/2017,31955.34961,31978.89063,31793.7207,31882.80078,11300,244.359375,0.0,244.359375,64.86096268,30680.660160000003,32131.91992,87.83330751,-12.16669249,266.3179965,226.4699406,0.018680972,3749800,1,-0.4019
BSESN,7/20/2017,31904.40039,32057.11914,31859.5,32033.820310000003,11200,-50.949218,50.949218,0.0,61.61116426,31017.10938,32131.91992,79.59119318,-20.40880682,261.8085256,233.5376576,0.017339241000000002,3738600,-1,0.0
BSESN,7/21/2017,32028.89063,32062.23047,31808.929689999997,32035.88086,18000,124.49023400000002,0.0,124.49023400000002,66.36275588,31166.36914,32131.91992,89.32947919,-10.67052081,265.2227362,239.8746733,0.00987683,3756600,1,0.5859
BSESN,7/24/2017,32245.86914,32320.85938,32058.33008,32100.2207,11500,216.978516,0.0,216.978516,73.06698067,31177.7793,32320.85938,93.43963424,-6.560365756,282.1840337,248.33654539999998,0.015711024,3768100,1,-0.29600000000000004
BSESN,7/25/2017,32228.26953,32374.30078,32196.85938,32350.710939999997,14100,-17.599610000000002,17.599610000000002,0.0,71.72897788,31264.85938,32374.30078,86.83740762,-13.16259238,290.8530696,256.8398502,0.013313995,3754000,-1,0.29600000000000004
BSESN,7/26/2017,32382.460939999997,32413.63086,32226.08008,32255.99023,12400,154.191407,0.0,154.191407,76.14490624,31286.61914,32413.63086,97.23428599,-2.7657140119999997,306.6306537,266.7980109,0.01077117,3766400,1,-0.5994
BSESN,7/27/2017,32383.30078,32672.660160000003,32325.33008,32519.43945,10900,0.839843,0.0,0.839843,76.16830115,31471.410160000003,32672.660160000003,75.91181061,-24.08818939,315.5646383,276.55133639999997,0.01132237,3777300,1,0.3182
BSESN,7/28/2017,32309.88086,32381.35938,32104.660160000003,32381.35938,11300,-73.419922,73.419922,0.0,69.31167690000001,31626.43945,32672.660160000003,65.3247832,-34.675216799999994,313.1111608,283.86330130000005,0.007329795,3766000,-1,0.0
BSESN,7/31/2017,32514.93945,32546.5,32324.44922,32412.19922,13100,205.058594,0.0,205.058594,76.21245013,31626.43945,32672.660160000003,84.92471975,-15.07528025,323.9786527,291.8863716,0.025352385,3779100,1,-0.4767
BSESN,8/1/2017,32575.16992,32632.01953,32462.25,32579.80078,9000,60.23046899999999,0.0,60.23046899999999,77.89692117,31626.43945,32672.660160000003,90.68167608,-9.318323917999999,333.60571489999995,300.23024019999997,0.019396449,3788100,1,0.0
BSESN,8/2/2017,32476.74023,32686.48047,32394.89063,32641.58008,10500,-98.429688,98.429688,0.0,68.72078746,31626.43945,32686.48047,80.21395099,-19.78604901,329.4945695,306.0831061,0.017939213,3777600,-1,-0.4404
BSESN,8/3/2017,32237.88086,32502.55078,32194.58008,32502.55078,12600,-238.859375,238.859375,0.0,51.67597551,31626.43945,32686.48047,57.68091958,-42.31908042,303.46435360000004,305.55935560000006,0.006525054000000001,3765000,-1,-0.9022
BSESN,8/4/2017,32325.410160000003,32352.18945,32107.99023,32191.11914,11300,87.529297,0.0,87.529297,56.26281908,31626.43945,32686.48047,65.93808093,-34.06191907,286.5944207,301.7663686,0.002466704,3776300,1,0.0
BSESN,8/7/2017,32273.66992,32396.14063,32235.820310000003,32377.80078,10400,-51.740234,51.740234,0.0,52.84183111,31793.7207,32686.48047,53.76017572,-46.23982428,265.9837774,294.60985039999997,0.0014087129999999998,3765900,-1,0.0
BSESN,8/8/2017,32014.18945,32354.76953,31915.19922,32341.05078,9400,-259.48046899999997,259.48046899999997,0.0,39.08860877,31808.929689999997,32686.48047,23.39007263,-76.60992737,226.1053867,280.9089576,-0.01137256,3756500,-1,0.0
BSESN,8/9/2017,31797.839839999997,31967.2793,31731.910160000003,31926.14063,9300,-216.349609,216.349609,0.0,31.26100421,31731.910160000003,32686.48047,6.906739829,-93.09326017,175.0262754,259.7324212,-0.0180791,3747200,-1,0.0
BSESN,8/10/2017,31531.33008,31756.26953,31422.80078,31750.73047,13000,-266.509766,266.509766,0.0,24.33460045,31422.80078,32686.48047,8.588354947000001,-91.41164505,111.752389,230.1364147,-0.024096367999999996,3734200,-1,-0.5267
BSESN,8/11/2017,31213.589839999997,31379.19922,31128.01953,31355.91992,15200,-317.740234,317.740234,0.0,18.65009269,31128.01953,32686.48047,5.490693472999999,-94.50930653,35.55850044,191.2208319,-0.040023129,3719000,-1,0.0
BSESN,8/14/2017,31449.0293,31526.40039,31298.90039,31299.51953,9700,235.439453,0.0,235.439453,32.1926414,31128.01953,32686.48047,20.59787051,-79.40212949,-5.761296332000001,151.8244062,-0.034570522,3728700,1,0.0
BSESN,8/16/2017,31770.89063,31805.99023,31399.34961,31566.24023,12500,321.86132799999996,0.0,321.86132799999996,46.29509713,31128.01953,32686.48047,41.25038224,-58.74961776,-12.39315315,118.98089440000001,-0.021734003999999998,3741200,1,0.5773
BSESN,8/17/2017,31795.460939999997,31937.50977,31714.09961,31919.16992,8500,24.570313,0.0,24.570313,47.26123187,31128.01953,32686.48047,42.82695772,-57.17304228,-15.48779489,92.08715651,-0.013723603999999999,3749700,1,0.0
BSESN,8/18/2017,31524.679689999997,31729.88086,31349.13086,31729.88086,16400,-270.78125,270.78125,0.0,38.46254957,31128.01953,32686.48047,25.45204357,-74.54795643,-39.33665613,65.80239398,-0.02477093,3733300,-1,-0.9022
BSESN,8/21/2017,31258.84961,31641.81055,31220.5293,31609.929689999997,23600,-265.830079,265.830079,0.0,31.76399428,31128.01953,32686.48047,8.394825614,-91.60517439,-78.77919867,36.88607545,-0.031444217999999996,3709700,-1,0.2732
BSESN,8/22/2017,31291.84961,31484.2793,31241.5,31393.929689999997,10800,33.0,0.0,33.0,33.4247793,31128.01953,32686.48047,10.51229928,-89.48770072,-106.1512283,8.278614701,-0.022563115,3720500,1,0.0
BSESN,8/23/2017,31568.00977,31593.39063,31379.25,31407.4707,10000,276.16015699999997,0.0,276.16015699999997,46.09357518,31128.01953,32502.55078,32.01020239,-67.98979761,-104.35698000000001,-14.24850424,-0.007227852,3730500,1,0.1531
BSESN,8/24/2017,31596.06055,31678.18945,31546.05078,31673.43945,8900,28.050781,0.0,28.050781,47.26959774,31128.01953,32396.14063,36.90822731,-63.09177269,-99.52430741,-31.30366487,0.002052894,3739400,1,-0.3182
BSESN,8/28/2017,31750.820310000003,31809.69922,31701.66992,31756.86914,10100,154.75976599999998,0.0,154.75976599999998,53.69972679999999,31128.01953,32396.14063,49.11209071,-50.88790929,-82.25833694,-41.49459929,0.017211428,3749500,1,0.0
BSESN,8/29/2017,31388.39063,31739.80078,31360.81055,31724.839839999997,6800,-362.429688,362.429688,0.0,40.39053189,31128.01953,32354.76953,21.22446252,-78.77553748,-96.70522023,-52.53672348,-0.0019281570000000002,3742700,-1,0.1002
BSESN,8/30/2017,31646.460939999997,31727.98047,31533.01953,31534.570310000003,5400,258.070313,0.0,258.070313,50.47525825,31128.01953,31967.2793,61.77365197,-38.22634803,-86.33514405,-59.29640759,-0.003916468,3748100,1,-0.1027
BSESN,8/31/2017,31730.49023,31757.179689999997,31551.84961,31685.43945,17900,84.029296,0.0,84.029296,53.43496953,31128.01953,31937.50977,74.42593832,-25.57406168,-70.5233725,-61.54180057,-0.0020433960000000003,3766000,1,0.0
BSESN,9/1/2017,31892.23047,31944.09961,31707.26953,31769.339839999997,6600,161.740235,0.0,161.740235,58.89124959,31128.01953,31944.09961,93.64411148,-6.355888521000001,-44.42919231,-58.11927892,0.011659144,3772600,1,0.0
BSESN,9/4/2017,31702.25,31932.19922,31560.320310000003,31932.19922,7600,-189.980469,189.980469,0.0,50.82049012,31220.5293,31944.09961,66.57552072,-33.42447928,-38.63385559,-54.22219426,0.014184796000000001,3765000,-1,0.3612
BSESN,9/5/2017,31809.55078,31863.4707,31674.23047,31755.160160000003,8000,107.300781,0.0,107.300781,54.85264991,31220.5293,31944.09961,81.40487168,-18.59512832,-25.09347129,-48.39644966,0.016544282,3773000,1,0.0
BSESN,9/6/2017,31661.9707,31727.84961,31586.5293,31713.5,7400,-147.58007800000001,147.58007800000001,0.0,48.53724219,31220.5293,31944.09961,61.00877809,-38.99122191,-25.97171237,-43.91150220000001,0.0029764609999999997,3765600,-1,0.0
BSESN,9/7/2017,31662.74023,31814.960939999997,31620.43945,31738.74023,10200,0.7695310000000001,0.0,0.7695310000000001,48.57286617,31220.5293,31944.09961,61.11513002,-38.88486998,-26.30243196,-40.38968816,0.00211038,3775800,1,-0.5423
BSESN,9/8/2017,31687.51953,31763.69922,31619.0,31694.15039,7800,24.779297,0.0,24.779297,49.86237367,31220.5293,31944.09961,64.53971732,-35.46028268,-24.28510389,-37.168771299999996,-0.001993674,3783600,1,-0.128
BSESN,9/11/2017,31882.160160000003,31952.86914,31797.89063,31798.31055,8700,194.640625,0.0,194.640625,59.14671247,31241.5,31952.86914,90.06015570000001,-9.939844297999999,-6.900935404,-31.11520412,0.01573096,3792300,1,0.0
BSESN,9/12/2017,32158.660160000003,32172.460939999997,31950.24023,32029.15039,7000,276.5,0.0,276.5,68.65941407,31360.81055,32172.460939999997,98.29966422,-1.700335779,28.85476281,-19.12121074,0.016185039,3799300,1,-0.1531
BSESN,9/13/2017,32186.410160000003,32348.30078,32126.76953,32188.94922,8900,27.75,0.0,27.75,69.48230883,31360.81055,32348.30078,83.60585053,-16.39414947,58.75333249,-3.5463020889999997,0.014368512,3808200,1,0.3182
BSESN,9/14/2017,32241.929689999997,32328.60938,32186.839839999997,32289.25977,9100,55.519532,0.0,55.519532,71.22637319,31360.81055,32348.30078,89.22813722,-10.77186278,85.93749269,14.35045687,0.010965029,3817300,1,0.3612
BSESN,9/15/2017,32272.60938,32356.10938,32138.38086,32207.63086,8900,30.679687,0.0,30.679687,72.23798716,31360.81055,32356.10938,91.6105598,-8.389440201000001,108.70366170000001,33.22109783,0.017991132,3826200,1,0.0
BSESN,9/18/2017,32423.75977,32508.06055,32361.25,32361.36914,9500,151.15039099999998,0.0,151.15039099999998,76.86229509999998,31533.01953,32508.06055,91.35412976,-8.645870237,137.35919669999998,54.048717599999996,0.019308949,3835700,1,-0.5423
BSESN,9/19/2017,32402.36914,32524.10938,32358.63086,32522.43945,57400,-21.390625,21.390625,0.0,74.82705088,31551.84961,32524.10938,87.47863089,-12.52136911,156.5383928,74.54665263,0.023384471,3778300,-1,0.0
BSESN,9/20/2017,32400.50977,32499.88086,32383.820310000003,32467.09961,10500,-1.859375,1.859375,0.0,74.62885192,31560.320310000003,32524.10938,87.17565763,-12.82434237,169.6325889,93.56383989,0.023300874,3767800,-1,0.0
BSESN,9/21/2017,32370.039060000003,32462.60938,32164.41992,32406.41992,8700,-30.470703000000004,30.470703000000004,0.0,71.06935594,31560.320310000003,32524.10938,84.01410453,-15.98589547,175.5277283,109.9566176,0.021539065,3759100,-1,-0.4939
BSESN,9/22/2017,31922.43945,32342.81055,31886.089839999997,32339.5,9600,-447.59961,447.59961,0.0,39.29914976,31586.5293,32524.10938,35.82735639,-64.17264361,142.4401594,116.45332590000001,0.00126338,3749500,-1,0.3612
BSESN,9/25/2017,31626.63086,32016.51953,31474.56055,31986.40039,12200,-295.80859399999997,295.80859399999997,0.0,29.30838838,31474.56055,32524.10938,14.48911265,-85.51088735,91.29633402,111.42192759999999,-0.016543889,3737300,-1,0.0
BSESN,9/26/2017,31599.75977,31693.589839999997,31455.65039,31685.81055,10000,-26.871093,26.871093,0.0,28.54769621,31455.65039,32524.10938,13.48759074,-86.51240926,48.04240832,98.74602370000001,-0.018226648999999998,3727300,-1,-0.6124
BSESN,9/27/2017,31159.81055,31797.460939999997,31100.80078,31785.24023,9800,-439.949219,439.949219,0.0,19.15537704,31100.80078,32524.10938,4.145957261,-95.85404274,-21.48915104,74.69898876,-0.033562481,3717500,-1,0.0
BSESN,9/28/2017,31282.48047,31340.910160000003,31081.83008,31216.35938,8300,122.669922,0.0,122.669922,26.89359001,31081.83008,32524.10938,13.91203433,-86.08796567,-65.93491856,46.57220729,-0.030680162999999996,3725800,1,-0.8689
BSESN,9/29/2017,31283.7207,31523.86914,31243.710939999997,31367.25,7700,1.240234,0.0,1.240234,26.97513059,31081.83008,32524.10938,13.99802558,-86.00197442,-99.90676997,17.27641184,-0.035160607,3733500,1,0.5106
BSESN,10/3/2017,31497.38086,31615.2793,31440.48047,31537.81055,7100,213.660156,0.0,213.660156,40.2273507,31081.83008,32524.10938,28.81208805,-71.18791195,-108.3402392,-7.8469183629999995,-0.027929695,3740600,1,0.5574
BSESN,10/4/2017,31671.710939999997,31752.160160000003,31457.7793,31522.16992,5900,174.330079,0.0,174.330079,48.9493461,31081.83008,32524.10938,40.89921149,-59.10078851,-99.80633849,-26.23880239,-0.022493437,3746500,1,0.0
BSESN,10/5/2017,31592.0293,31772.410160000003,31562.25,31725.84961,5900,-79.681641,79.681641,0.0,45.45153948,31081.83008,32524.10938,35.37450895,-64.62549105,-98.33921002,-40.65888391,-0.024034873,3740600,-1,0.0644
BSESN,10/6/2017,31814.2207,31844.2793,31632.81055,31633.339839999997,8300,222.191406,0.0,222.191406,55.64856433,31081.83008,32524.10938,50.78008306,-49.21991694,-78.34440507,-48.19598815,-0.003390053,3748900,1,0.0
BSESN,10/9/2017,31846.89063,31935.63086,31781.75,31862.19922,5800,32.669922,0.0,32.669922,57.01191576,31081.83008,32524.10938,53.04524225,-46.95475775,-59.17999824,-50.39279016,0.006964377,3754700,1,0.0772
BSESN,10/10/2017,31924.410160000003,31994.76953,31896.90039,31910.820310000003,7200,77.519531,0.0,77.519531,60.34898621,31081.83008,32499.88086,59.41818793,-40.58181207,-37.30683944,-47.77560002,0.010273825,3761900,1,0.0
BSESN,10/11/2017,31833.99023,32098.460939999997,31769.40039,31975.589839999997,8600,-90.419922,90.419922,0.0,54.64035848,31081.83008,32462.60938,54.47359746,-45.52640254,-26.95758527,-43.61199707,0.021636192999999998,3753300,-1,0.2023
BSESN,10/12/2017,32182.2207,32209.0293,31813.66992,31887.4707,7800,348.23046899999997,0.0,348.23046899999997,68.06448888,31081.83008,32342.81055,87.26468427,-12.73531573,9.237082446,-33.04218117,0.028761792999999997,3761100,1,-0.5423
BSESN,10/13/2017,32432.68945,32508.589839999997,32247.74023,32247.74023,15500,250.46875,0.0,250.46875,74.36160929,31081.83008,32508.589839999997,94.68022629,-5.319773714,57.469875300000005,-14.93976987,0.036727368999999996,3776600,1,-0.8473
BSESN,10/16/2017,32633.64063,32687.320310000003,32445.429689999997,32488.23047,9200,200.95117199999999,0.0,200.95117199999999,78.31918037,31081.83008,32687.320310000003,96.6564924,-3.343507598,110.63446599999999,10.17507731,0.036074737999999995,3785800,1,0.0
BSESN,10/17/2017,32609.160160000003,32699.85938,32556.74023,32654.410160000003,5500,-24.480469,24.480469,0.0,76.65591805,31081.83008,32699.85938,94.39446374,-5.6055362639999995,149.07398590000003,37.95485902,0.029598945,3780300,-1,0.7845
BSESN,10/18/2017,32584.34961,32670.320310000003,32462.84961,32518.56055,14100,-24.810547,24.810547,0.0,74.79833158,31081.83008,32699.85938,92.86108316,-7.138916842,175.512381,65.46636342,0.031410464,3766200,-1,0.4215
BSESN,10/19/2017,32389.960939999997,32663.06055,32319.36914,32656.75,2500,-194.388671,194.388671,0.0,61.35680478,31243.710939999997,32699.85938,78.71793636,-21.28206364,178.71929369999998,88.11694947,0.018096946000000003,3763700,-1,-0.5106
BSESN,10/23/2017,32506.7207,32614.89063,32312.74023,32411.85938,8400,116.75976499999999,0.0,116.75976499999999,65.63659999,31440.48047,32699.85938,84.66397435,-15.33602565,188.50931430000003,108.19542240000001,0.020718823,3772100,1,0.6124
BSESN,10/24/2017,32607.339839999997,32670.36914,32502.08008,32619.25977,8400,100.619141,0.0,100.619141,69.04546315,31457.7793,32699.85938,92.55124266,-7.448757342,202.0579022,126.96791840000002,0.021392085,3780500,1,0.4019
BSESN,10/25/2017,33042.5,33117.32813,32804.60156,32995.28125,29900,435.160156,0.0,435.160156,79.29501358,31562.25,33117.32813,95.18814368,-4.811856318,245.08386919999998,150.59110859999998,0.037962874,3810400,1,0.0
BSESN,10/26/2017,33147.12891,33196.17188,32835.05859,33025.17188,15500,104.628906,0.0,104.628906,81.03697521,31632.81055,33196.17188,96.86297927,-3.1370207339999996,284.34715939999995,177.3423187,0.029982647999999997,3825900,1,0.0
BSESN,10/27/2017,33157.21875,33286.51172,33109.41016,33228.32031,18300,10.089844,0.0,10.089844,81.21285065,31769.40039,33286.51172,91.47768746,-8.522312543,312.67346069999996,204.4085471,0.022339476,3844200,1,0.7096
BSESN,10/30/2017,33266.16016,33340.17188,33206.92969,33260.10156,14000,108.941406,0.0,108.941406,83.15878199999999,31769.40039,33340.17188,95.28819311,-4.711806889,339.9936841,231.5255745,0.019382438000000002,3858200,1,-0.7579
BSESN,10/31/2017,33213.12891,33294.30078,33164.28125,33254.92969,11500,-53.03125,53.03125,0.0,78.58681478,31769.40039,33340.17188,91.91206549,-8.087934515,353.2934325,255.8791461,0.018521443999999998,3846700,-1,0.0
BSESN,11/1/2017,33600.26953,33651.51953,33340.62109,33344.23047,14200,387.140625,0.0,387.140625,85.36456343,31813.66992,33651.51953,97.21141492,-2.7885850810000004,390.5703401,282.8173849,0.031178156000000002,3860900,1,0.0
BSESN,11/2/2017,33573.21875,33657.57031,33527.0,33615.83984,12400,-27.050781,27.050781,0.0,83.24035524,32247.74023,33657.57031,94.01689861,-5.983101386,413.1670534,308.8873186,0.036531622,3848500,-1,0.0
BSESN,11/3/2017,33685.55859,33733.71094,33531.94141,33667.33984,199700,112.339844,0.0,112.339844,85.02586826,32312.74023,33733.71094,96.61130635,-3.388693649,435.12415760000005,334.13468639999996,0.036264436000000004,4048200,1,-0.34
BSESN,11/6/2017,33731.19141,33848.42188,33582.37891,33710.14844,13100,45.632812,0.0,45.632812,85.73801502,32312.74023,33848.42188,92.36622579,-7.633774206,451.00856150000004,357.50946139999996,0.034466214,4061300,1,-0.3612
BSESN,11/7/2017,33370.76172,33865.94922,33341.82031,33781.01172,16300,-360.429687,360.429687,0.0,59.81318089,32312.74023,33865.94922,68.11842419,-31.88157581,429.56168279999997,371.9199057,0.00993453,4045000,-1,-0.4404
BSESN,11/8/2017,33218.80859,33484.69922,33157.67969,33417.35156,283000,-151.953125,151.953125,0.0,52.14346253,32312.74023,33865.94922,58.335251,-41.664749,395.74166610000003,376.6842578,0.00216247,3762000,-1,-0.4404
BSESN,11/9/2017,33250.92969,33463.80078,33111.53906,33376.62109,14100,32.121094,0.0,32.121094,53.59483032,32312.74023,33865.94922,60.40329814,-39.59670186,367.296992,374.8068046,0.0028262609999999996,3776100,1,0.5574
BSESN,11/10/2017,33314.55859,33380.42188,33108.08984,33235.75,21200,63.62890600000001,0.0,63.62890600000001,56.60303642,32502.08008,33865.94922,59.57158877,-40.42841123,345.901368,369.0257173,0.001454885,3797300,1,0.5106
BSESN,11/13/2017,33033.55859,33417.30078,32999.98047,33397.41016,18200,-281.0,281.0,0.0,42.54828785,32804.60156,33865.94922,21.57229346,-78.42770654,302.7805645,355.7766867,-0.0054066059999999996,3779100,-1,-0.2732
BSESN,11/14/2017,32941.87109,33126.55078,32907.10938,32990.03125,12000,-91.6875,91.6875,0.0,38.91077182,32835.05859,33865.94922,10.36118647,-89.63881353,258.23186580000004,336.2677226,-0.019595034,3767100,-1,-0.5423
BSESN,11/15/2017,32760.43945,32944.94141,32683.589839999997,32944.94141,11300,-181.43164099999998,181.43164099999998,0.0,32.55594235,32683.589839999997,33865.94922,6.499682806,-93.50031719,205.9130466,310.1967874,-0.024209156000000003,3755800,-1,0.0
BSESN,11/16/2017,33106.82031,33165.14844,32829.82031,32829.82031,9600,346.38086,0.0,346.38086,50.40032873,32683.589839999997,33865.94922,35.79541702,-64.20458298,190.20745290000002,286.1989205,-0.017180605,3765400,1,0.0
BSESN,11/17/2017,33342.80078,33520.82031,33278.91016,33388.46875,11300,235.98046800000003,0.0,235.98046800000003,58.94009438,32683.589839999997,33865.94922,55.75385546,-44.24614454,194.559547,267.8710458,-0.011514287,3776700,1,-0.5106
BSESN,11/20/2017,33359.89844,33449.53125,33288.21094,33365.83984,7900,17.097657,0.0,17.097657,59.52271649,32683.589839999997,33865.94922,57.19991809,-42.80008191,197.1160201,253.7200406,-0.000325533,3784600,1,-0.802
BSESN,11/21/2017,33478.35156,33625.05078,33437.60938,33438.28125,14800,118.453125,0.0,118.453125,63.64630571,32683.589839999997,33865.94922,67.21828708,-32.78171292,206.3218707,244.2404066,0.007813133,3799400,1,0.0
BSESN,11/22/2017,33561.55078,33654.53125,33465.23047,33569.07031,13100,83.199218,0.0,83.199218,66.41886024,32683.589839999997,33865.94922,74.25499857,-25.74500143,217.8201599,238.95635730000004,0.009341727,3812500,1,-0.0516
BSESN,11/23/2017,33588.07813,33670.19141,33468.30078,33575.91016,7100,26.527344,0.0,26.527344,67.33535897,32683.589839999997,33865.94922,76.49859257,-23.50140743,226.4626514,236.4576161,0.00821021,3819600,1,0.0
BSESN,11/24/2017,33679.23828,33738.53125,33639.98047,33670.0,7800,91.160156,0.0,91.160156,70.52505062,32683.589839999997,33865.94922,84.20861356,-15.79138644,237.9250985,236.75111260000003,0.019546174,3827400,1,-0.6124
BSESN,11/27/2017,33724.44141,33745.17188,33540.46094,33640.51172,8900,45.203125,0.0,45.203125,72.08469129,32683.589839999997,33745.17188,98.04720988,-1.952790118,247.80019840000003,238.9609298,0.023756098,3836300,1,-0.5574
BSESN,11/28/2017,33618.58984,33770.14844,33576.64844,33726.64844,8100,-105.85156200000002,105.85156200000002,0.0,63.06781724,32683.589839999997,33770.14844,86.0515029,-13.948497099999999,244.26916690000002,240.0225772,0.026194715,3828200,-1,0.0
BSESN,11/29/2017,33602.76172,33728.80859,33553.12109,33664.26953,6600,-15.828125,15.828125,0.0,61.73543877,32683.589839999997,33770.14844,84.5947821,-15.4052179,237.4563526,239.50933230000004,0.014980037,3821600,-1,0.0
BSESN,11/30/2017,33149.35156,33576.19922,33108.71875,33542.5,7400,-453.410156,453.410156,0.0,36.35174745,32683.589839999997,33770.14844,42.86577103,-57.13422897,193.2431511,230.25609599999999,-0.0058018290000000005,3814200,-1,0.0
BSESN,12/1/2017,32832.94141,33300.80859,32797.78125,33247.66016,9200,-316.41015699999997,316.41015699999997,0.0,27.31005246,32683.589839999997,33770.14844,13.7453758,-86.25462420000001,131.160281,210.436933,-0.015796122,3805000,-1,0.4215
BSESN,12/4/2017,32869.71875,33008.46875,32785.76172,32968.01953,9600,36.777344,0.0,36.777344,29.65658124,32683.589839999997,33770.14844,17.13013058,-82.86986942,83.95895684,185.1413378,-0.018179892,3814600,1,0.5574
BSESN,12/5/2017,32802.44141,32893.05078,32682.51953,32814.03125,8600,-67.277344,67.277344,0.0,27.76475291,32682.51953,33770.14844,11.02599188,-88.97400812,40.65421155,156.2439125,-0.022618423999999998,3806000,-1,-0.4215
BSESN,12/6/2017,32597.179689999997,32804.75,32565.160160000003,32798.5,9600,-205.261718,205.261718,0.0,22.6731021,32565.160160000003,33770.14844,2.657248413,-97.34275159,-10.11145769,122.9728385,-0.029501492999999997,3796400,-1,-0.3182
BSESN,12/7/2017,32949.21094,32992.44922,32598.11914,32615.05078,9500,352.03125,0.0,352.03125,43.26293527,32565.160160000003,33770.14844,31.87174413,-68.12825587,-21.68763493,94.04074381,-0.021675886000000002,3805900,1,-0.6705
BSESN,12/8/2017,33250.30078,33285.67969,33034.19922,33034.19922,14200,301.08984300000003,0.0,301.08984300000003,55.06955883,32565.160160000003,33770.14844,56.85869607,-43.14130393,-6.49157396,73.93428026,-0.014059258,3820100,1,-0.4767
BSESN,12/11/2017,33455.78906,33535.96875,33313.17188,33317.71875,12000,205.488282,0.0,205.488282,61.39563139,32565.160160000003,33770.14844,73.91183137,-26.08816863,21.88037749,63.523499699999995,-0.004842582,3832100,1,0.0
BSESN,12/12/2017,33227.98828,33458.41016,33179.75,33426.58984,8200,-227.80078199999997,227.80078199999997,0.0,52.02586338,32565.160160000003,33770.14844,55.00701832,-44.99298168,25.687623199999997,55.95632439999999,-0.011153055,3823900,-1,0.3818
BSESN,12/13/2017,33053.03906,33404.26172,32988.82031,33229.73047,24500,-174.949218,174.949218,0.0,45.82818886,32565.160160000003,33770.14844,40.48826983,-59.51173017,14.42170859,47.64940124,-0.0029054109999999997,3799400,-1,0.0
BSESN,12/14/2017,33246.69922,33321.51953,32886.92969,33114.69141,11200,193.660156,0.0,193.660156,52.98217626,32565.160160000003,33770.14844,56.55980836,-43.44019164,20.87946078,42.29541315,0.012601911,3810600,1,0.0772
BSESN,12/15/2017,33462.96875,33621.96094,33405.82031,33456.01953,24200,216.269531,0.0,216.269531,59.81959385,32565.160160000003,33770.14844,74.50766181,-25.49233819,42.95328094,42.42698671,0.018048526999999998,3834800,1,0.0
BSESN,12/18/2017,33601.67969,33801.89844,32595.63086,33364.51953,21100,138.710938,0.0,138.710938,63.72365313,32565.160160000003,33801.89844,83.8107421,-16.1892579,70.82334841,48.10625905,0.024365207000000003,3855900,1,0.0
BSESN,12/19/2017,33836.73828,33862.07031,33666.62109,33732.07813,20600,235.05859300000003,0.0,235.05859300000003,69.51524692,32565.160160000003,33862.07031,98.04673964,-1.95326036,110.6028805,60.60558334,0.03802656,3876500,1,0.5574
BSESN,12/20/2017,33777.37891,33956.30859,33754.94141,33928.58984,7100,-59.359375,59.359375,0.0,66.42517662,32565.160160000003,33956.30859,87.13798736,-12.86201264,135.7735281,75.63917229,0.025134682999999998,3869400,-1,-0.128
BSESN,12/21/2017,33756.28125,33860.98828,33707.80078,33826.25,9900,-21.097656,21.097656,0.0,65.23594072,32565.160160000003,33956.30859,85.62142338,-14.37857662,152.26384040000002,90.96410591,0.01521732,3859500,-1,-0.25
BSESN,12/22/2017,33940.30078,33964.28125,33767.73047,33768.46875,7800,184.019531,0.0,184.019531,70.54349176,32565.160160000003,33964.28125,98.28603335,-1.713966654,178.1280209,108.3968889,0.014482149,3867300,1,-0.4019
BSESN,12/26/2017,34010.60938,34061.87891,33889.75,33980.76172,12900,70.308594,0.0,70.308594,72.40107492,32565.160160000003,34061.87891,96.57453807,-3.425461931,201.97069390000001,127.1116499,0.023553069,3880200,1,0.0
BSESN,12/27/2017,33911.80859,34137.96875,33839.51172,34087.32031,10900,-98.800781,98.800781,0.0,65.68475385,32595.63086,34137.96875,85.33653635,-14.66346365,210.46764669999996,143.7828493,0.02598156,3869300,-1,-0.2732
BSESN,12/28/2017,33848.03125,34023.64844,33752.03125,33928.85938,9500,-63.77734399999999,63.77734399999999,0.0,61.43964262,32595.63086,34137.96875,81.20142793,-18.79857207,209.6386603,156.9540115,0.018086968999999998,3859800,-1,0.0
BSESN,12/29/2017,34056.82813,34086.05078,33889.39063,33889.39063,12100,208.796875,0.0,208.796875,69.00629055,32595.63086,34137.96875,94.73911485,-5.260885145,223.256286,170.21446640000002,0.017746763,3871900,1,0.0772
BSESN,1/1/2018,33812.75,34101.12891,33766.14844,34059.98828,7500,-244.078125,244.078125,0.0,54.564384700000005,32595.63086,34137.96875,78.91391038,-21.08608962,211.9105151,178.5536761,0.006281541,3864400,-1,0.3818
BSESN,1/2/2018,33812.26172,33964.14063,33703.37109,33913.55078,10600,-0.488281,0.488281,0.0,54.53803812,32595.63086,34137.96875,78.88225188,-21.11774812,200.56749250000001,182.95643940000002,-0.000723372,3853800,-1,-0.1531
BSESN,1/3/2018,33793.37891,33998.37109,33765.42969,33929.60938,9000,-18.882813,18.882813,0.0,53.38776372,32595.63086,34137.96875,77.65795381,-22.34204619,187.88851830000002,183.9428552,0.00047369,3844800,-1,-0.5719
BSESN,1/4/2018,33969.64063,33995.39844,33802.12891,33912.48828,10500,176.261719,0.0,176.261719,62.01632097,32595.63086,34137.96875,89.08617068,-10.91382932,189.87443330000002,185.1291708,0.006320583,3855300,1,0.4215
BSESN,1/5/2018,34153.85156,34188.85156,34020.83984,34021.26953,14700,184.210938,0.0,184.210938,68.94793083,32595.63086,34188.85156,97.80319199,-2.196808007,203.961428,188.8956222,0.006291953,3870000,1,0.0
BSESN,1/8/2018,34352.78906,34385.67188,34216.32813,34216.32813,13500,198.9375,0.0,198.9375,74.70089197,33666.62109,34385.67188,95.42691381,-4.573086195,228.5435586,196.8252095,0.010060969,3883500,1,-0.34
BSESN,1/9/2018,34443.19141,34488.03125,34343.41016,34431.60938,11200,90.402343,0.0,90.402343,76.94092168,33703.37109,34488.03125,94.285444,-5.714555997000001,252.4101605,207.9421997,0.015669551,3894700,1,-0.1027
BSESN,1/10/2018,34433.07031,34565.62891,34311.62891,34538.78125,8500,-10.121093,10.121093,0.0,76.07083526,33703.37109,34565.62891,84.62657094,-15.37342906,267.4252155,219.83880290000002,0.017284286,3886200,-1,0.0
BSESN,1/11/2018,34503.48828,34558.87891,34400.60938,34471.48047,8100,70.417968,0.0,70.417968,78.06241543,33703.37109,34565.62891,92.79326622,-7.2067337789999995,281.7589544,232.2228332,0.013115143000000001,3894300,1,0.0258
BSESN,1/12/2018,34592.39063,34638.42188,34342.16016,34578.98828,7800,88.902344,0.0,88.902344,80.43454221,33703.37109,34638.42188,95.07713902,-4.922860976,296.87008829999996,245.15228419999997,0.023057592999999998,3902100,1,0.0
BSESN,1/15/2018,34843.51172,34963.69141,34687.21094,34687.21094,14600,251.121094,0.0,251.121094,85.53305757,33703.37109,34963.69141,90.46435372,-9.535646284,325.35861289999997,261.1935499,0.030499291,3916700,1,0.0
BSESN,1/16/2018,34771.05078,34936.03125,34735.55078,34877.71094,53600,-72.460938,72.460938,0.0,78.7046017,33703.37109,34963.69141,84.71494721,-15.28505279,338.1905318,276.5929463,0.028930871,3863100,-1,0.0
BSESN,1/17/2018,35081.82031,35118.60938,34700.82031,34753.80078,35000,310.76953199999997,0.0,310.76953199999997,84.73521609,33703.37109,35118.60938,97.40050404,-2.599495964,369.18073819999995,295.1105047,0.032740402,3898100,1,0.2263
BSESN,1/18/2018,35260.28906,35507.35938,35166.44141,35366.44922,15700,178.46875,0.0,178.46875,87.14706341,33703.37109,35507.35938,86.30421746,-13.69578254,403.4904499,316.7864937,0.032395687,3913800,1,-0.5574
BSESN,1/19/2018,35511.57813,35542.17188,35221.16016,35339.10938,35200,251.289062,0.0,251.289062,89.77243465,33703.37109,35542.17188,98.33621182,-1.6637881769999998,445.8189476,342.5929845,0.033732023,3949000,1,-0.5574
BSESN,1/22/2018,35798.01172,35827.69922,35544.67969,35613.96875,13700,286.43359399999997,0.0,286.43359399999997,91.93822851,33765.42969,35827.69922,98.5604452,-1.4395547990000002,496.7511461,373.4246168,0.039334924,3962700,1,-0.5994
BSESN,1/23/2018,36139.98047,36170.82813,35863.98047,35868.19141,27000,341.96875,0.0,341.96875,93.75885059999999,33802.12891,36170.82813,98.69769637,-1.302303634,558.2738669,410.39446680000003,0.049571826,3989700,1,-0.6369
BSESN,1/24/2018,36161.64063,36268.19141,36036.51172,36161.62109,25200,21.660156,0.0,21.660156,93.86018747,34020.83984,36268.19141,95.25882898,-4.741171021,601.8412092,448.6838153,0.048057527999999995,4014900,1,0.0
BSESN,1/25/2018,36050.44141,36247.01953,35823.35156,36208.39063,15100,-111.199219,111.199219,0.0,85.62468724,34216.32813,36268.19141,89.38769449,-10.61230551,620.2459846,482.99624919999997,0.042149466,3999800,-1,0.29600000000000004
BSESN,1/29/2018,36283.25,36443.98047,36093.35938,36106.35938,16900,232.808594,0.0,232.808594,88.13878864,34311.62891,36443.98047,92.46229038,-7.537709625,646.1689758,515.6307945,0.041320126,4016700,1,0.0
BSESN,1/30/2018,36033.73047,36291.82031,35993.41016,36277.12109,18100,-249.519531,249.519531,0.0,72.46579397,34311.62891,36443.98047,80.76067722,-19.23932278,639.2105707000001,540.3467497,0.036314108,3998600,-1,0.0
BSESN,1/31/2018,35965.01953,36050.69141,35818.41016,35951.64063,11000,-68.710938,68.710938,0.0,68.59038628,34342.16016,36443.98047,77.2120892,-22.787910800000002,620.9931634,556.4760325,0.02517541,3987600,-1,0.0
BSESN,2/1/2018,35906.66016,36256.82813,35501.73828,36048.98828,25200,-58.359375,58.359375,0.0,65.17456497,34342.16016,36443.98047,74.43547816,-25.56452184,594.9879721,564.1784203999999,0.018331418000000002,3962400,-1,-0.6908
BSESN,2/2/2018,35066.75,35738.12891,35006.41016,35707.60156,18000,-839.910156,839.910156,0.0,35.67312711,34687.21094,36443.98047,21.60437413,-78.39562587,500.8316648,551.5090693,-0.012526283999999999,3944400,-1,0.3818
BSESN,2/5/2018,34757.16016,34874.17188,34520.80078,34718.85156,23500,-309.58984399999997,309.58984399999997,0.0,29.91417072,34520.80078,36443.98047,12.29003075,-87.70996925,396.6583691,520.5389292,-0.029075681000000003,3920900,-1,-0.6705
BSESN,2/6/2018,34195.94141,34521.01172,33482.80859,33753.78125,22900,-561.21875,561.21875,0.0,22.36284718,33482.80859,36443.98047,24.08279026,-75.91720974,265.7512044,469.5813843,-0.053791923,3898000,-1,0.5574
BSESN,2/7/2018,34082.71094,34666.32813,34008.42188,34563.30078,13100,-113.23046799999999,113.23046799999999,0.0,21.12161705,33482.80859,36443.98047,20.25895049,-79.74104951,151.1274773,405.8906029,-0.057489915999999995,3884900,-1,0.0
BSESN,2/8/2018,34413.16016,34634.35156,34108.76172,34208.10938,35700,330.44921800000003,0.0,330.44921800000003,33.54264648,33482.80859,36443.98047,31.41835737,-68.58164263,85.96093385,341.90466910000004,-0.045416399999999996,3920600,1,-0.2263
BSESN,2/9/2018,34005.76172,34070.73047,33849.64844,34002.44922,15200,-407.398437,407.398437,0.0,27.40395999,33482.80859,36443.98047,17.66034351,-82.33965649,1.425892762,273.8089138,-0.062769688,3905400,-1,0.0
BSESN,2/12/2018,34300.46875,34351.33984,34115.12109,34203.33984,15500,294.70703100000003,0.0,294.70703100000003,37.023911,33482.80859,36443.98047,27.61272194,-72.38727806,-41.31212149,210.7847068,-0.04810109,3920900,1,0.0
BSESN,2/14/2018,34155.94922,34473.42969,34028.67969,34436.98047,21100,-144.519531,144.519531,0.0,34.44149681,33482.80859,36443.98047,22.73223755,-77.26776245,-85.85415084,151.4569352,-0.050300829000000005,3899800,-1,-0.5574
BSESN,2/15/2018,34297.46875,34535.07813,34186.01172,34207.57031,13000,141.519531,0.0,141.519531,39.23072372,33482.80859,36443.98047,27.511410700000003,-72.48858929999999,-108.48405,99.46873819,-0.044815959,3912800,1,-0.4588
BSESN,2/16/2018,34010.76172,34508.23828,33957.32813,34411.23828,18000,-286.70703100000003,286.70703100000003,0.0,33.50854042,33482.80859,36443.98047,17.82919558,-82.17080442,-147.8489586,50.00519883,-0.030113663,3894800,-1,-0.5719
BSESN,2/19/2018,33774.66016,34122.96094,33554.37109,34053.94922,18000,-236.101563,236.101563,0.0,29.42975781,33482.80859,36291.82031,10.3898307,-89.6101693,-195.8398356,0.836191947,-0.028267557000000002,3876800,-1,0.0
BSESN,2/20/2018,33703.58984,33960.94922,33657.89063,33913.94141,19200,-71.070312,71.070312,0.0,28.23600195,33482.80859,36256.82813,7.958893134,-92.04110687,-236.8771591,-46.70647826,-0.014397953,3857600,-1,0.0
BSESN,2/21/2018,33844.85938,33911.35938,33702.5,33813.82813,17700,141.269531,0.0,141.269531,34.34416146,33482.80859,36256.82813,13.05148637,-86.94851363,-255.0600892,-88.37720044,-0.006978656999999999,3875300,1,0.6486
BSESN,2/22/2018,33819.5,33868.73828,33691.42188,33817.08984,11800,-25.359375,25.359375,0.0,33.749178,33482.80859,35738.12891,14.92876219,-85.07123781,-268.422277,-124.38621570000001,-0.017250963,3863500,-1,0.0772
BSESN,2/23/2018,34142.14844,34167.60156,33832.0,33832.0,21600,322.648438,0.0,322.648438,47.182138,33482.80859,34874.17188,47.38804401,-52.61195599,-250.09394730000002,-149.52776200000002,0.004010694,3885100,1,-0.6908
BSESN,2/26/2018,34445.75,34483.39063,34225.71875,34225.71875,8400,303.601562,0.0,303.601562,56.71170688,33482.80859,34666.32813,81.36252768,-18.63747232,-208.6651433,-161.35523830000002,0.004235547,3893500,1,0.5719
BSESN,2/27/2018,34346.39063,34610.78906,34314.87109,34558.55859,12700,-99.359375,99.359375,0.0,53.09433329,33554.37109,34666.32813,71.22753028,-28.77246972,-181.7548323,-165.4351571,0.005575644,3880800,-1,-0.5267
BSESN,2/28/2018,34184.03906,34302.73828,34076.44922,34155.62891,12000,-162.351562,162.351562,0.0,47.39471129,33554.37109,34634.35156,58.3036441,-41.6963559,-171.5510969,-166.6583451,-0.0033072320000000002,3868800,-1,0.0
BSESN,3/1/2018,34046.94141,34278.62891,34015.78906,34141.21875,11300,-137.097657,137.097657,0.0,42.90678865,33554.37109,34610.78906,46.62646097,-53.37353903,-172.53828430000002,-167.83433290000002,0.001063772,3857500,-1,0.0
BSESN,3/5/2018,33746.78125,34034.28125,33653.41016,34034.28125,16900,-300.16015600000003,300.16015600000003,0.0,34.62419922,33554.37109,34610.78906,18.21344976,-81.78655024,-195.2898734,-173.32544099999998,-0.000825439,3840600,-1,-0.2023
BSESN,3/6/2018,33317.19922,34060.12891,33209.76172,34047.42969,11800,-429.582031,429.582031,0.0,26.254865399999996,33209.76172,34610.78906,7.6684798810000006,-92.33152012,-245.1583189,-187.6920166,-0.011464376,3828800,-1,-0.34
BSESN,3/7/2018,33033.08984,33331.21094,32991.14063,33279.39063,10700,-284.109375,284.109375,0.0,22.16613487,32991.14063,34610.78906,2.590020032,-97.40997997,-304.099207,-210.9734546,-0.023985017,3818100,-1,0.0
BSESN,3/8/2018,33351.57031,33439.96875,33037.48047,33244.51953,15500,318.48046899999997,0.0,318.48046899999997,35.21563922,32991.14063,34610.78906,22.2535755,-77.7464245,-321.4065981,-233.0600833,-0.013836091000000002,3833600,1,0.4019
BSESN,3/9/2018,33307.14063,33519.48828,33256.42188,33465.05078,8200,-44.429688,44.429688,0.0,34.29022925,32991.14063,34610.78906,19.51040686,-80.48959314,-334.8480153,-253.41766969999998,-0.024456803,3825400,-1,-0.128
BSESN,3/12/2018,33917.94141,33962.48047,33468.16016,33468.16016,12200,610.8007809999999,0.0,610.8007809999999,53.62241486,32991.14063,34610.78906,57.22234278,-42.77765722,-292.8382597,-261.3017877,-0.015322895,3837600,1,0.0
BSESN,3/13/2018,33856.78125,34077.32031,33722.96094,33818.21875,14300,-61.16015600000001,61.16015600000001,0.0,51.859637799999994,32991.14063,34610.78906,53.44620503,-46.55379497,-261.4663182,-261.3346938,-0.014255046,3823300,-1,0.0
BSESN,3/14/2018,33835.73828,33875.14844,33580.69141,33733.55078,9300,-21.042969,21.042969,0.0,51.19154681,32991.14063,34610.78906,52.14697438,-47.85302562,-235.5861301,-256.18498109999996,-0.010188989,3814000,-1,-0.8225
BSESN,3/15/2018,33685.53906,33866.28125,33637.28125,33843.46875,17300,-150.199218,150.199218,0.0,46.28112701,32991.14063,34610.78906,42.87340522,-57.12659478,-224.60659109999997,-249.8693031,-0.010614826,3796700,-1,0.4215
BSESN,3/16/2018,33176.0,33691.32031,33119.92188,33685.85938,12700,-509.539063,509.539063,0.0,33.64743993,32991.14063,34610.78906,11.41354943,-88.58645057,-254.09175980000003,-250.7137944,-0.01691365,3784000,-1,0.6597
BSESN,3/19/2018,32923.12109,33275.78906,32856.53906,33268.96875,9800,-252.878906,252.878906,0.0,29.09877521,32856.53906,34610.78906,3.795469916,-96.20453008,-294.4697191,-259.4649794,-0.011828068999999998,3774200,-1,0.0
BSESN,3/20/2018,32996.76172,33102.73828,32810.85938,32876.48047,14600,73.640625,0.0,73.640625,32.17945082,32810.85938,34302.73828,12.46095399,-87.53904601,-316.87462630000005,-270.9469087,-0.00109975,3788800,1,0.4215
BSESN,3/21/2018,33136.17969,33354.92969,33070.53125,33090.82031,10100,139.417969,0.0,139.417969,38.05869845,32810.85938,34278.62891,22.16426395,-77.83573605,-319.6955603,-280.6966391,-0.006458185,3798900,1,0.34
BSESN,3/22/2018,33006.26953,33281.76953,32963.30859,33206.98828,12900,-129.910157,129.910157,0.0,34.81391596,32810.85938,34077.32031,15.42962362,-84.57037638,-328.625643,-290.2824398,-0.009033231,3786000,-1,-0.2732
BSESN,3/23/2018,32596.539060000003,32720.0293,32483.839839999997,32650.89063,11400,-409.73046800000003,409.73046800000003,0.0,26.57010554,32483.839839999997,34077.32031,7.0725196320000006,-92.92748037,-364.5621765,-305.1383872,-0.038958801,3774600,-1,-0.5574
BSESN,3/26/2018,33066.41016,33115.41016,32515.16992,32536.43945,16400,469.871093,0.0,469.871093,44.08881748,32483.839839999997,34077.32031,36.55961421,-63.44038579,-351.08043119999996,-314.326796,-0.023344543,3791000,1,0.5267
BSESN,3/27/2018,33174.39063,33371.03906,33077.12891,33172.98047,15100,107.980469,0.0,107.980469,47.41542831,32483.839839999997,34077.32031,43.33600533,-56.66399467,-327.90306699999996,-317.0420502,-0.019545832,3806100,1,0.0
BSESN,3/28/2018,32968.67969,33104.10938,32917.66016,33098.08984,12300,-205.710937,205.710937,0.0,41.93136567,32483.839839999997,34077.32031,30.42646919,-69.57353081,-322.41736569999995,-318.11711329999997,-0.021280922999999997,3793800,-1,0.0
BSESN,4/2/2018,33255.35938,33289.33984,32997.87891,33030.87109,7600,286.679687,0.0,286.679687,51.03749481,32483.839839999997,34077.32031,48.41725682,-51.58274318,-291.5761447,-312.8089196,0.0023920720000000003,3801400,1,0.0
BSESN,4/3/2018,33370.62891,33402.94141,33153.82813,33197.42188,11100,115.269531,0.0,115.269531,54.35812977,32483.839839999997,34077.32031,55.65107821,-44.34892179,-254.8946997,-301.2260756,0.013592509,3812500,1,-0.7579
BSESN,4/4/2018,33019.07031,33505.53125,32972.55859,33437.51953,9700,-351.55859300000003,351.55859300000003,0.0,43.88445055,32483.839839999997,33875.14844,38.46957255,-61.53042745,-251.29545299999998,-291.23995110000004,0.000676084,3802800,-1,0.836
BSESN,4/5/2018,33596.80078,33637.46094,33267.85938,33289.96094,11000,577.730468,0.0,577.730468,58.90027391,32483.839839999997,33866.28125,80.50691568,-19.49308432,-199.5250035,-272.89696160000005,0.013900851,3813800,1,-0.3612
BSESN,4/6/2018,33626.96875,33697.51172,33501.37109,33608.58984,10800,30.167969,0.0,30.167969,59.55239382,32483.839839999997,33697.51172,94.18764079,-5.81235921,-154.2837592,-249.17432110000001,0.018805494,3824600,1,0.8014
BSESN,4/9/2018,33788.53906,33846.5,33578.91016,33653.60938,37400,161.570313,0.0,161.570313,63.16418186,32483.839839999997,33846.5,95.74648626,-4.253513743,-104.19132059999998,-220.177721,0.036568299,3862000,1,0.0
BSESN,4/10/2018,33880.25,33949.98047,33813.30078,33880.10938,13600,91.710937,0.0,91.710937,65.19945609999999,32483.839839999997,33949.98047,95.24394401,-4.756055989,-56.44177026,-187.4305308,0.024612283,3875600,1,0.0
BSESN,4/11/2018,33940.44141,33981.53906,33750.73828,33970.35156,9300,60.19140600000001,0.0,60.19140600000001,66.59710469,32483.839839999997,33981.53906,97.25594722,-2.744052776,-13.58634922,-152.6616945,0.023091631,3884900,1,0.0
BSESN,4/12/2018,34101.12891,34177.44141,33924.87891,33987.55078,6600,160.6875,0.0,160.6875,70.27447229,32483.839839999997,34177.44141,95.49407005,-4.5059299489999995,32.96304161,-115.5367473,0.034349244,3891500,1,0.4019
BSESN,4/13/2018,34192.64844,34313.14063,34103.53125,34167.53125,8300,91.519532,0.0,91.519532,72.27998749,32483.839839999997,34313.14063,93.41321076,-6.586789239,76.35841827,-77.15771418,0.028184602000000003,3899800,1,0.4588
BSESN,4/16/2018,34305.42969,34341.46094,33899.33984,33944.73047,7100,112.78125,0.0,112.78125,74.70646839,32515.16992,34341.46094,98.02708059,-1.972919413,118.4842585,-38.02931965,0.028012681,3906900,1,0.5423
BSESN,4/17/2018,34395.05859,34434.14063,34229.82813,34381.80078,10400,89.628906,0.0,89.628906,76.58587394,32917.66016,34434.14063,97.4228464,-2.5771536,157.28847040000002,1.034238355,0.041672533,3917300,1,0.2732
BSESN,4/18/2018,34331.67969,34591.80859,34270.03906,34443.42188,8200,-63.37890600000001,63.37890600000001,0.0,72.20821244,32917.66016,34591.80859,84.46201662,-15.53798338,180.8423024,36.99585116,0.021873478999999998,3909100,-1,-0.34
BSESN,4/19/2018,34427.28906,34478.82031,34358.91016,34403.67188,7600,95.609375,0.0,95.609375,74.72311258,32972.55859,34591.80859,89.83976958,-10.16023042,204.86223710000002,70.56912835,0.023799953999999998,3916700,1,-0.6908
BSESN,4/20/2018,34415.57813,34487.32813,34311.28906,34434.14063,10200,-11.710938,11.710938,0.0,73.77953141,32972.55859,34591.80859,89.11653735,-10.88346265,220.412456,100.5377939,0.018557743999999998,3906500,-1,0.0
BSESN,4/23/2018,34450.76953,34663.94922,34259.26953,34493.69141,9500,35.191406,0.0,35.191406,74.87941544,32972.55859,34663.94922,87.39618839,-12.60381161,232.89114480000003,127.00846409999998,0.016839295,3916000,1,0.0
BSESN,4/24/2018,34616.64063,34706.71094,34465.48828,34491.37891,8400,165.871094,0.0,165.871094,79.54571617,33267.85938,34706.71094,93.74012474,-6.259875259,253.2457472,152.2559207,0.019923112,3924400,1,0.1779
BSESN,4/25/2018,34501.26953,34631.26953,34400.55859,34593.17188,7800,-115.371094,115.371094,0.0,69.22561378,33501.37109,34706.71094,82.95572755,-17.04427245,257.1037018,173.22547690000002,0.011733941000000001,3916600,-1,0.4168
BSESN,4/26/2018,34713.60156,34747.96875,34505.62109,34532.94922,10000,212.33203199999997,0.0,212.33203199999997,75.87283240000001,33578.91016,34747.96875,97.06026822,-2.9397317789999997,274.1345268,193.4072869,0.015235823,3926600,1,-0.8658
BSESN,4/27/2018,34969.69922,35065.37109,34744.73047,34747.03906,16200,256.09765600000003,0.0,256.09765600000003,81.44919808,33750.73828,35065.37109,92.72254016,-7.277459839,304.7831682,215.68246319999997,0.019363393,3942800,1,-0.3182
BSESN,4/30/2018,35160.35938,35213.30078,35004.0,35021.19922,6900,190.660156,0.0,190.660156,84.52216192,33750.73828,35213.30078,96.38022949,-3.619770506,340.5316813,240.6523068,0.022250312,3949700,1,-0.25
BSESN,5/2/2018,35176.42188,35357.14844,35072.42188,35328.91016,8700,16.0625,0.0,16.0625,84.76744558,33899.33984,35357.14844,87.60286064,-12.39713936,365.9404117,265.7099278,0.024605326,3958400,1,0.3818
BSESN,5/3/2018,35103.14063,35257.30859,35020.07813,35257.30859,7700,-73.28125,73.28125,0.0,78.24039505,33899.33984,35357.14844,82.57605189,-17.42394811,375.8314779,287.7342378,0.019631275,3950700,-1,0.5267
BSESN,5/4/2018,34915.37891,35206.55078,34847.60938,35144.96094,7800,-187.761719,187.761719,0.0,63.73232261,33899.33984,35357.14844,69.69632819,-30.30367181,364.319766,303.0513434,0.014522516000000001,3942900,-1,0.128
BSESN,5/7/2018,35208.14063,35259.80859,34977.73828,34983.58984,12600,292.76171899999997,0.0,292.76171899999997,72.80480291,34229.82813,35357.14844,86.78212294,-13.21787706,374.5030376,317.34168230000006,0.021984156,3955500,1,0.5719
BSESN,5/8/2018,35216.32031,35388.87109,35136.01172,35349.85156,14200,8.179688,0.0,8.179688,73.02236366,34259.26953,35388.87109,84.7246333,-15.2753667,378.86605410000004,329.6465566,0.017323451,3969700,1,0.0
BSESN,5/9/2018,35319.35156,35404.82813,35134.19922,35198.07813,9400,103.03125,0.0,103.03125,75.83234237,34259.26953,35404.82813,92.53843824,-7.4615617610000005,386.18582710000004,340.9544107,0.02371165,3979100,1,0.2263
BSESN,5/10/2018,35246.26953,35500.76172,35203.85156,35353.96094,8400,-73.082032,73.082032,0.0,69.87553152,34259.26953,35500.76172,79.50110436,-20.49889564,381.6898082,349.1014902,0.015344647,3970700,-1,0.7906
BSESN,5/11/2018,35535.78906,35596.14844,35262.05859,35287.98828,8900,289.51953199999997,0.0,289.51953199999997,77.83443591,34259.26953,35596.14844,95.48505293,-4.514947067,396.91312,358.6638162,0.01618801,3979600,1,0.25
BSESN,5/14/2018,35556.71094,35642.71875,35456.55859,35555.82813,9000,20.921875,0.0,20.921875,78.31220703,34400.55859,35642.71875,93.07594825,-6.924051747999999,405.9859713,368.12824720000003,0.011272682,3988600,1,0.0
BSESN,5/15/2018,35543.94141,35993.53125,35497.92188,35537.85156,12000,-12.769532,12.769532,0.0,77.14122582,34400.55859,35993.53125,71.77667537,-28.22332463,407.44905760000006,375.9924093,0.010447894000000001,3976600,-1,0.0
BSESN,5/16/2018,35387.87891,35543.89063,35241.62891,35452.35156,10900,-156.0625,156.0625,0.0,63.70785682,34505.62109,35993.53125,59.2950998,-40.704900200000004,391.50262610000004,379.0944526,0.008111476,3965700,-1,0.0
BSESN,5/17/2018,35149.12109,35510.01172,35087.82031,35483.62109,11000,-238.757812,238.757812,0.0,48.72862603,34744.73047,35993.53125,32.38231679,-67.61768321,355.5012075,374.37580360000004,0.006694534,3954700,-1,0.0
BSESN,5/18/2018,34848.30078,35163.10938,34821.62109,35143.58984,9500,-300.820313,300.820313,0.0,36.31539657,34821.62109,35993.53125,2.276598327,-97.72340167,299.24661000000003,359.3499649,-0.010220359,3945200,-1,-0.2263
BSESN,5/21/2018,34616.12891,34973.94922,34593.82031,34873.16016,6500,-232.171875,232.171875,0.0,29.60036524,34593.82031,35993.53125,1.593800006,-98.40619999,233.24144410000002,334.1282607,-0.01704299,3938700,-1,0.0
BSESN,5/22/2018,34651.23828,34754.60156,34550.21875,34601.48828,12000,35.109375,0.0,35.109375,31.80074813,34550.21875,35993.53125,6.999144745,-93.00085525,181.6707207,303.6367527,-0.018916352,3950700,1,0.0
BSESN,5/23/2018,34344.91016,34668.46875,34302.89063,34656.62891,11300,-306.328125,306.328125,0.0,24.18935941,34302.89063,35993.53125,2.485420638,-97.51457936,114.75955459999999,265.8613131,-0.025573185,3939400,-1,0.0
BSESN,5/24/2018,34663.10938,34741.46094,34367.82813,34404.14063,15800,318.19921899999997,0.0,318.19921899999997,41.08917039,34302.89063,35993.53125,21.30664227,-78.69335773,86.41188857,229.97142819999996,-0.024557769,3955200,1,0.0
BSESN,5/25/2018,34924.87109,35017.92969,34700.51953,34753.46875,10300,261.76171899999997,0.0,261.76171899999997,51.37748099,34302.89063,35993.53125,36.78963227,-63.21036773,84.09870459,200.7968835,-0.017769918,3965500,1,0.4939
BSESN,5/28/2018,35165.48047,35240.96094,35006.5,35074.32031,11200,240.609375,0.0,240.609375,58.976181499999996,34302.89063,35993.53125,51.02147856,-48.97852144,100.5219014,180.7418871,-0.010647692,3976700,1,-0.0516
BSESN,5/29/2018,34949.23828,35234.14063,34922.17969,35213.14063,8400,-216.242188,216.242188,0.0,50.751378499999994,34302.89063,35993.53125,38.23093131,-61.76906869,94.99344062,163.5921978,-0.012395222,3968300,-1,-0.2263
BSESN,5/30/2018,34906.10938,35017.44922,34735.10938,34876.12891,10900,-43.128906,43.128906,0.0,49.17321012,34302.89063,35993.53125,35.67989205,-64.32010795,86.13899659999998,148.10155749999998,-0.006913735,3957400,-1,-0.3182
BSESN,5/31/2018,35322.37891,35416.03125,34926.07813,35083.80859,22900,416.26953100000003,0.0,416.26953100000003,62.24721354,34302.89063,35993.53125,60.30189183,-39.69810817,111.4267994,140.7666059,0.013604053,3980300,1,0.3182
BSESN,6/1/2018,35227.26172,35438.21875,35177.35156,35373.98047,11900,-95.117187,95.117187,0.0,58.29381436,34302.89063,35993.53125,54.67578859,-45.32421141,122.3816636,137.0896174,0.017654568,3968400,-1,-0.4019
BSESN,6/4/2018,35011.89063,35555.58984,34982.25,35503.23828,29400,-215.371094,215.371094,0.0,49.99766115,34302.89063,35555.58984,56.59778415,-43.40221585,112.3892715,132.1495482,0.010408065,3939000,-1,0.6249
BSESN,6/5/2018,34903.21094,35073.12109,34784.67969,35029.44922,8300,-108.67968700000002,108.67968700000002,0.0,46.17171243,34302.89063,35555.58984,47.92214315,-52.07785685,94.61008013,124.64165459999998,0.016255707,3930700,-1,0.4404
BSESN,6/6/2018,35178.87891,35230.53906,34896.37109,34932.48828,10100,275.66796800000003,0.0,275.66796800000003,56.02129315,34302.89063,35555.58984,69.92806156,-30.07193844,101.5929439,120.0319125,0.014879493999999998,3940800,1,0.0772
BSESN,6/7/2018,35463.07813,35628.48828,35278.37891,35278.37891,8800,284.19921899999997,0.0,284.19921899999997,63.88279908,34302.89063,35628.48828,87.52184305,-12.47815695,128.5772569,121.7409814,0.015410423000000001,3949600,1,0.0772
BSESN,6/8/2018,35443.67188,35484.94141,35260.0,35406.46875,9900,-19.40625,19.40625,0.0,62.99556157,34302.89063,35628.48828,86.05788075,-13.94211925,146.7054679,126.7338787,0.007910923,3939700,-1,0.4019
BSESN,6/11/2018,35483.46875,35704.83984,35444.48828,35472.58984,11100,39.796875,0.0,39.796875,64.17295656,34302.89063,35704.83984,84.20976373,-15.79023627,162.4113045,133.8693638,0.015285897,3950800,1,0.0
BSESN,6/12/2018,35692.51953,35743.07813,35479.07031,35525.30078,11100,209.050781,0.0,209.050781,69.96516681,34367.82813,35743.07813,96.32367977,-3.676320233,189.5420217,145.0038954,0.022529298,3961900,1,0.0
BSESN,6/13/2018,35739.16016,35877.41016,35715.96094,35835.44141,11900,46.640625,0.0,46.640625,71.16524644,34700.51953,35877.41016,88.25294407,-11.74705593,212.35887819999996,158.47489199999998,0.011799354,3973800,1,-0.3252
BSESN,6/14/2018,35599.82031,35749.87891,35488.55078,35743.10156,9800,-139.339843,139.339843,0.0,62.54994225,34735.10938,35877.41016,75.69905864,-24.30094136,216.6998594,170.1198855,0.01057586,3964000,-1,0.0
BSESN,6/15/2018,35622.14063,35675.19922,35419.67969,35656.26172,9000,22.320312,0.0,22.320312,63.36957161,34735.10938,35877.41016,77.65303716,-22.34696284,219.41193680000003,179.9782957,0.017429793,3973000,1,0.0
BSESN,6/18/2018,35548.26172,35721.55078,35518.73047,35698.42969,8100,-73.878906,73.878906,0.0,58.48135395,34735.10938,35877.41016,71.18548438,-28.81451562,213.14288880000004,186.61121430000003,0.01848113,3964900,-1,0.0
BSESN,6/19/2018,35286.73828,35552.46875,35249.05859,35552.46875,9000,-261.523438,261.523438,0.0,44.47012616,34784.67969,35877.41016,45.94532757,-54.05467243,184.93999409999998,186.27697030000002,0.0030660270000000002,3955900,-1,0.128
BSESN,6/20/2018,35547.32813,35571.37109,35329.51172,35329.60938,10200,260.58984399999997,0.0,260.58984399999997,56.462757200000006,34784.67969,35877.41016,69.79291411,-30.20708589,181.5239247,185.3263612,0.00237571,3966100,1,0.0
BSESN,6/21/2018,35432.39063,35678.69141,35396.96875,35644.05078,62300,-114.9375,114.9375,0.0,50.8714417,34784.67969,35877.41016,59.27453805,-40.72546195,167.6100649,181.78310190000002,-0.000318287,3903800,-1,0.0
BSESN,6/22/2018,35689.60156,35741.26172,35344.48828,35428.42188,14700,257.210938,0.0,257.210938,60.87550178,34784.67969,35877.41016,82.8129078,-17.1870922,175.3170579,180.4898931,0.005809263,3918500,1,0.0
BSESN,6/25/2018,35470.35156,35806.96875,35430.10938,35783.75,11800,-219.25,219.25,0.0,50.71769681,34896.37109,35877.41016,58.50740212,-41.49259788,161.8673567,176.7653858,-0.006224497,3906700,-1,0.0
BSESN,6/26/2018,35490.03906,35616.64063,35338.08984,35355.71875,11500,19.6875,0.0,19.6875,51.55523201,35249.05859,35877.41016,38.35121667,-61.64878333,151.055712,171.62345109999998,-0.006970535999999999,3918200,1,-0.0516
BSESN,6/27/2018,35217.10938,35618.85156,35154.21094,35543.89063,11300,-272.929688,272.929688,0.0,40.5358054,35154.21094,35877.41016,8.697249034,-91.30275097,119.0914488,161.1170506,-0.010750362,3906900,-1,0.0
BSESN,6/28/2018,35037.64063,35282.39844,34937.14844,35207.19141,13000,-179.46875,179.46875,0.0,34.87939222,34937.14844,35877.41016,10.68768249,-89.31231751,78.37445964,144.5685324,-0.016408335,3893900,-1,-0.4019
BSESN,6/29/2018,35423.48047,35459.05078,35099.64844,35128.16016,37800,385.83984399999997,0.0,385.83984399999997,51.62467132,34937.14844,35877.41016,51.723049200000005,-48.276950799999995,76.35977526,130.926781,-0.003510193,3931700,1,-0.4019
BSESN,7/2/2018,35264.41016,35578.23828,35106.57031,35545.21875,14800,-159.070313,159.070313,0.0,45.99810024,34937.14844,35877.41016,34.80538575,-65.19461425,61.22175227,116.9857752,-0.000632763,3916900,-1,0.0
BSESN,7/3/2018,35378.60156,35445.21094,35195.62891,35344.21094,7700,114.19140700000001,0.0,114.19140700000001,50.46957477,34937.14844,35806.96875,50.75222076,-49.24777924,57.77308009,105.14323619999999,-0.004746533,3924600,1,0.0
BSESN,7/4/2018,35645.39844,35667.30859,35309.67188,35385.51953,11900,266.796875,0.0,266.796875,59.50822804,34937.14844,35806.96875,81.4248633,-18.5751367,75.69568787,99.25372654,0.006011669,3936500,1,0.0
BSESN,7/5/2018,35574.55078,35748.26172,35517.78906,35703.17188,19300,-70.847657,70.847657,0.0,56.35705246,34937.14844,35806.96875,73.27977218,-26.72022782,83.22332318,96.04764587,-0.00322365,3917200,-1,0.0
BSESN,7/6/2018,35657.85938,35799.71094,35532.21094,35543.66016,14600,83.308594,0.0,83.308594,59.28247859,34937.14844,35806.96875,82.85745079,-17.14254921,94.81832901,95.8017825,0.005286325,3931800,1,0.1779
BSESN,7/9/2018,35934.71875,35977.37109,35779.71875,35835.10156,8400,276.859375,0.0,276.859375,67.60828549,34937.14844,35977.37109,95.89969092,-4.100309078,124.9078327,101.62299250000001,0.012529704,3940200,1,-0.6705
BSESN,7/10/2018,36239.62109,36274.32813,36019.62891,36068.26953,8800,304.90234399999997,0.0,304.90234399999997,74.28888389,34937.14844,36274.32813,97.4044602,-2.595539802,171.3814732,115.57468870000001,0.029034516,3949000,1,0.1779
BSESN,7/11/2018,36265.92969,36362.30078,36169.69922,36299.26172,9400,26.308594,0.0,26.308594,74.80620454,34937.14844,36362.30078,93.23783921,-6.762160794,207.9380711,134.04736509999998,0.035056272,3958400,1,0.0
BSESN,7/12/2018,36548.41016,36699.53125,36422.07813,36424.23047,12300,282.48046800000003,0.0,282.48046800000003,79.83325626,34937.14844,36699.53125,91.42518340000001,-8.574816605,256.7436701,158.5866261,0.031756611000000004,3970700,1,0.0
BSESN,7/13/2018,36541.62891,36740.07031,36501.60938,36635.14063,11900,-6.78125,6.78125,0.0,79.39444365,34937.14844,36740.07031,88.9933441,-11.0066559,291.5148668,185.1722743,0.03621835,3958800,-1,0.0
BSESN,7/16/2018,36323.76953,36658.71094,36298.94141,36658.71094,9600,-217.859375,217.859375,0.0,65.95561446,34937.14844,36740.07031,76.90966049,-23.09033951,298.05605519999995,207.7490305,0.026715809,3949200,-1,0.0
BSESN,7/17/2018,36519.96094,36549.55078,36261.78125,36390.98828,9200,196.191407,0.0,196.191407,71.04780309,34937.14844,36740.07031,87.79151898,-12.20848102,315.4348643,229.2861972,0.024535074,3958400,1,0.2023
BSESN,7/18/2018,36373.44141,36747.87109,36320.92188,36722.41016,18400,-146.519532,146.519532,0.0,62.93593104,35099.64844,36747.87109,77.28282119,-22.71717881,313.7678732,246.1825324,0.022456801000000002,3940000,-1,-0.5859
BSESN,7/19/2018,36351.23047,36515.57813,36279.32813,36509.07813,9400,-22.210937,22.210937,0.0,61.70367562,35106.57031,36747.87109,75.83376371,-24.16623629,307.1143112,258.36888819999996,0.019445113,3930600,-1,-0.0516
BSESN,7/20/2018,36496.37109,36567.33984,36335.60938,36377.03125,16300,145.140625,0.0,145.140625,66.63005232,35195.62891,36747.87109,83.79763146,-16.20236854,309.9796978,268.69105010000004,0.015629797,3946900,1,-0.5106
BSESN,7/23/2018,36718.60156,36749.69141,36491.82813,36501.05078,8100,222.230469,0.0,222.230469,72.80950672,35309.67188,36749.69141,97.84101241,-2.158987592,326.4199134,280.2368228,0.013217039,3955000,1,0.5106
BSESN,7/24/2018,36825.10156,36902.05859,36709.71875,36859.39063,11600,106.5,0.0,106.5,75.33512355,35517.78906,36902.05859,94.44060356,-5.559396437999999,344.07626560000006,293.0047113,0.015418655,3966600,1,0.0
BSESN,7/25/2018,36858.23047,36947.17969,36803.14844,36928.05859,11000,33.128906,0.0,33.128906,76.13090129,35532.21094,36947.17969,93.71369728,-6.286302719,356.6312547,305.73002,0.008476985,3977600,1,0.0
BSESN,7/26/2018,36984.64063,37061.62109,36852.53125,36928.37891,17800,126.410156,0.0,126.410156,79.09974425,35779.71875,37061.62109,93.99482579,-6.005174212999999,372.4876118,319.08153839999994,0.01212348,3995400,1,0.0
BSESN,7/27/2018,37336.85156,37368.62109,37134.87891,37253.85938,14700,352.210938,0.0,352.210938,85.06987092,36019.62891,37368.62109,97.64494329,-2.3550567069999997,408.76240950000005,337.01771260000004,0.027890333,4010100,1,0.0
BSESN,7/30/2018,37494.39844,37533.5,37292.44922,37491.39063,14100,157.546875,0.0,157.546875,86.98820414,36169.69922,37533.5,97.13289781,-2.8671021860000003,445.0924159,358.6326533,0.026682326,4024200,1,0.0
BSESN,7/31/2018,37606.57813,37644.58984,37298.75,37534.94922,14000,112.17968700000002,0.0,112.17968700000002,88.2306185,36261.78125,37644.58984,97.25112216,-2.748877839,477.4326249,382.39264760000003,0.033902117999999995,4038200,1,0.0
BSESN,8/1/2018,37521.62109,37711.87109,37432.91016,37643.87109,16100,-84.957031,84.957031,0.0,81.43580379,36261.78125,37711.87109,86.88012327,-13.11987673,490.5523687,404.0245918,0.032196726,4022100,-1,0.0
BSESN,8/2/2018,37165.16016,37529.69141,37128.98828,37529.69141,11700,-356.460938,356.460938,0.0,59.31936069,36261.78125,37711.87109,62.29813344,-37.70186656,466.8053995,416.5807534,0.01832481,4010400,-1,-0.5574
BSESN,8/3/2018,37556.16016,37582.26953,37319.60938,37327.16016,17800,391.0,0.0,391.0,69.72549924,36261.78125,37711.87109,89.26197996,-10.73802004,474.0713878,428.0788802,0.022810199,4028200,1,0.7269
BSESN,8/6/2018,37691.89063,37805.25,37643.28906,37714.69922,12400,135.730469,0.0,135.730469,72.53911544,36279.32813,37805.25,92.5710892,-7.428910802000001,485.18909249999996,439.5009227,0.023537995,4040600,1,0.0
BSESN,8/7/2018,37665.80078,37876.87109,37586.87891,37849.21094,15900,-26.089844,26.089844,0.0,71.07410306,36279.32813,37876.87109,86.78781622,-13.21218378,486.2890834,448.85855480000004,0.021910176,4024700,-1,0.0
BSESN,8/8/2018,37887.55859,37931.42188,37641.39844,37756.23828,9400,221.757813,0.0,221.757813,75.85630699,36335.60938,37931.42188,97.25135121,-2.748648792,499.2992256,458.946689,0.024413322999999997,4034100,1,0.0
BSESN,8/9/2018,38024.37109,38076.23047,37939.28125,37994.51172,15300,136.8125,0.0,136.8125,78.39855972,36491.82813,38076.23047,96.72688095,-3.2731190530000003,514.7161549,470.10058219999996,0.018413966,4049400,1,-0.29600000000000004
BSESN,8/10/2018,37869.23047,38051.44922,37815.75,38050.07031,15600,-155.140625,155.140625,0.0,68.90530093,36709.71875,38076.23047,84.85194111,-15.14805889,508.5533443,477.79113459999996,0.009997014,4033800,-1,-0.5859
BSESN,8/13/2018,37644.89844,37799.53906,37559.26172,37693.19141,11400,-224.332031,224.332031,0.0,57.32399922,36803.14844,38076.23047,66.11907006,-33.88092994,480.03401900000006,478.2397115,0.001018979,4022400,-1,-0.4019
BSESN,8/14/2018,37852.0,37932.39844,37689.71094,37749.58984,11300,207.101562,0.0,207.101562,63.80438291,36852.53125,38076.23047,81.67601437,-18.32398563,468.7402674,476.3398227,0.008805028000000001,4033700,1,-0.6369
BSESN,8/16/2018,37663.55859,37891.92188,37634.12891,37796.01172,13000,-188.441406,188.441406,0.0,55.03103146,37128.98828,38076.23047,56.43438603,-43.56561397,439.51775430000004,468.975409,0.013410367,4020700,-1,0.1027
BSESN,8/17/2018,37947.87891,38022.32031,37840.16016,37898.60156,10000,284.320312,0.0,284.320312,63.71666773,37128.98828,38076.23047,86.44997397,-13.55002603,434.2946961,462.0392664,0.010430213,4030700,1,0.0
BSESN,8/20/2018,38278.75,38340.69141,38050.69141,38075.07031,11800,330.87109399999997,0.0,330.87109399999997,71.18885949999999,37128.98828,38340.69141,94.88807079,-5.1119292110000005,451.6476046,459.960934,0.015569911,4042500,1,0.0
BSESN,8/21/2018,38285.75,38402.96094,38213.87109,38360.32031,8900,7.0,0.0,7.0,71.33297496,37128.98828,38402.96094,90.79957193,-9.200428075,460.65461150000004,460.0996695,0.016459207,4051400,1,-0.4215
BSESN,8/23/2018,38336.76172,38487.62891,38227.35938,38416.64844,11100,51.011719,0.0,51.011719,72.4900455,37128.98828,38487.62891,88.89572531,-11.10427469,466.5310688999999,461.3859494,0.011856216999999999,4062500,1,0.1779
BSESN,8/24/2018,38251.80078,38429.5,38172.76953,38366.78906,10700,-84.960938,84.960938,0.0,67.27198958,37319.60938,38487.62891,79.80957349,-20.19042651,459.04102689999996,460.91696490000004,0.005981156,4051800,-1,0.0
BSESN,8/27/2018,38694.10938,38736.87891,38416.73047,38472.03125,10800,442.308594,0.0,442.308594,77.15160502,37559.26172,38736.87891,96.36812952,-3.631870482,483.2254001,465.37865199999993,0.021782298999999998,4062600,1,0.0
BSESN,8/28/2018,38896.62891,38938.91016,38760.57813,38814.76172,9900,202.519531,0.0,202.519531,80.29429696,37559.26172,38938.91016,96.93536057,-3.06463943,512.8218327999999,474.8672881,0.033250998999999996,4072500,1,0.0
BSESN,8/29/2018,38722.92969,38989.64844,38679.57031,38989.64844,11400,-173.699218,173.699218,0.0,70.67407478,37559.26172,38989.64844,81.35338182,-18.64661818,516.3094497999999,483.15572050000003,0.023008816,4061100,-1,-0.5574
BSESN,8/30/2018,38690.10156,38819.05859,38581.82813,38796.98047,10800,-32.828125,32.828125,0.0,68.87456023,37559.26172,38989.64844,79.0583294,-20.941670600000002,510.53927710000005,488.6324318,0.027255602,4050300,-1,-0.2263
BSESN,8/31/2018,38645.07031,38838.44922,38562.21094,38704.83984,18000,-45.03125,45.03125,0.0,66.20640514,37559.26172,38989.64844,75.91014231,-24.08985769,496.6081386,490.2275732,0.018372342,4032300,-1,0.0
BSESN,9/3/2018,38312.51953,38934.35156,38270.01172,38915.91016,12300,-332.55078199999997,332.55078199999997,0.0,49.77554974,37559.26172,38989.64844,52.66113017,-47.33886983,453.5058094,482.88322039999997,0.0008822000000000001,4020000,-1,0.0
BSESN,9/4/2018,38157.92188,38518.55859,38098.60156,38460.96094,12500,-154.597656,154.597656,0.0,43.92775628,37634.12891,38989.64844,38.64149181,-61.35850819,402.23544439999995,466.7536652,-0.003338791,4007500,-1,0.29600000000000004
BSESN,9/5/2018,38018.30859,38250.60938,37774.42188,38192.94922,14800,-139.613281,139.613281,0.0,39.13669384,37634.12891,38989.64844,28.3418777,-71.6581223,346.3452335,442.6719789,-0.00830673,3992700,-1,-0.4019
BSESN,9/6/2018,38242.80859,38320.96094,37912.5,38161.85156,9300,224.5,0.0,224.5,49.38024159,37774.42188,38989.64844,38.54316004,-61.45683996,316.5184844,417.44128,-0.00023507900000000002,4002000,1,0.0772
BSESN,9/7/2018,38389.82031,38421.55859,38067.21875,38314.55078,18700,147.011719,0.0,147.011719,55.09120964,37774.42188,38989.64844,50.64063416,-49.35936584,301.2703311,394.2070902,-0.007863963,4020700,1,0.0
BSESN,9/10/2018,37922.17188,38354.51953,37882.82813,38348.39063,20500,-467.648438,467.648438,0.0,38.958499700000004,37774.42188,38989.64844,12.15822666,-87.84177334,248.58520359999997,365.0827129,-0.02505248,4000200,-1,0.0
BSESN,9/11/2018,37413.12891,38043.26953,37361.19922,38017.48828,11900,-509.042969,509.042969,0.0,28.4826674,37361.19922,38989.64844,3.18890429,-96.81109571,163.867386,324.8396475,-0.03382494,3988300,-1,0.5574
BSESN,9/12/2018,37717.96094,37752.57813,37342.0,37546.42188,13600,304.83203199999997,0.0,304.83203199999997,39.68842119,37342.0,38989.64844,22.8180314,-77.1819686,119.942678,283.8602536,-0.025126338999999998,4001900,1,-0.6908
BSESN,9/14/2018,38090.64063,38125.62109,37859.51953,37939.28906,12200,372.679687,0.0,372.679687,50.60601353,37342.0,38989.64844,45.43691529,-54.56308471,113.8912986,249.8664626,-0.014346712,4014100,1,-0.5423
BSESN,9/17/2018,37585.51172,38027.80859,37548.92969,38027.80859,8800,-505.128906,505.128906,0.0,39.44041398,37342.0,38989.64844,14.77934937,-85.22065063,67.55709941,213.40458999999998,-0.018975724,4005300,-1,0.0
BSESN,9/18/2018,37290.67188,37745.44141,37242.85156,37660.19141,10900,-294.83984399999997,294.83984399999997,0.0,34.33788664,37242.85156,38989.64844,2.737600043,-97.26239996,6.965507392999999,172.11677340000003,-0.022727915,3994400,-1,0.5719
BSESN,9/19/2018,37121.21875,37530.62891,37062.69141,37432.92969,13000,-169.453125,169.453125,0.0,31.62468886,37062.69141,38934.35156,3.127028365,-96.87297164,-54.10354484,126.8727098,-0.023596258999999998,3981400,-1,0.0
BSESN,9/21/2018,36841.60156,37489.23828,35993.64063,37278.89063,41100,-279.617187,279.617187,0.0,27.48915593,35993.64063,38934.35156,28.83523596,-71.16476404,-123.6387483,76.77041817,-0.036639752000000005,3940300,-1,-0.4404
BSESN,9/24/2018,36305.01953,36945.5,36216.94922,36924.71875,23300,-536.582032,536.582032,0.0,21.31683923,35993.64063,38934.35156,10.58855877,-89.41144123,-219.5131724,17.51370005,-0.054306083,3917000,-1,0.0
BSESN,9/25/2018,36652.05859,36705.78906,36064.10156,36350.25,20500,347.039063,0.0,347.039063,32.60903982,35993.64063,38518.55859,26.07680634,-73.92319366,-264.4428595,-38.87761186,-0.03349263,3937500,1,0.3818
BSESN,9/26/2018,36542.26953,36938.73828,36357.92969,36936.64063,21800,-109.78906299999998,109.78906299999998,0.0,30.98578069,35993.64063,38421.55859,22.59668214,-77.40331786,-305.3886894,-92.17982736,-0.023276839,3915700,-1,0.25
BSESN,9/27/2018,36324.17188,36711.62109,36238.23047,36691.92969,17800,-218.097656,218.097656,0.0,27.81236092,35993.64063,38421.55859,13.61377337,-86.38622663,-351.3866461,-144.02119109999998,-0.036952927,3897900,-1,0.0
BSESN,9/28/2018,36227.14063,36551.85938,35985.62891,36452.73828,22800,-97.03125,97.03125,0.0,26.42318033,35985.62891,38421.55859,9.91456035,-90.08543965,-391.1609097,-193.44913480000002,-0.048922779000000007,3875100,-1,-0.25
BSESN,10/1/2018,36526.14063,36616.64063,35960.64844,36274.25,21300,299.0,0.0,299.0,37.51936665,35960.64844,38354.51953,23.6224995,-76.3775005,-394.013556,-233.56201910000001,-0.028185624,3896400,1,-0.6486
BSESN,10/3/2018,35975.62891,36602.85156,35911.82031,36602.85156,25100,-550.5117190000001,550.5117190000001,0.0,28.41541379,35911.82031,38125.62109,2.882309625,-97.11769037,-435.6738171,-273.9843787,-0.035264662999999995,3871300,-1,-0.4767
BSESN,10/4/2018,35169.16016,35820.53125,35022.12109,35820.53125,21300,-806.46875,806.46875,0.0,20.15062304,35022.12109,38125.62109,4.7378463669999995,-95.26215363,-527.6823684999999,-324.7239766,-0.052586059000000004,3850000,-1,0.0
BSESN,10/5/2018,34376.98828,35118.53906,34202.21875,35097.98828,22100,-792.171875,792.171875,0.0,15.15479288,34202.21875,38125.62109,4.454540108,-95.54545989,-656.9485641,-391.1688941,-0.066897561,3827900,-1,0.0
BSESN,10/8/2018,34474.37891,34636.42969,33974.66016,34412.35938,20400,97.390625,0.0,97.390625,18.03736858,33974.66016,38027.80859,12.32914998,-87.67085002,-742.9698519,-461.5290857,-0.050423899,3848300,1,0.3182
BSESN,10/9/2018,34299.46875,34711.67969,34233.5,34651.82031,30300,-174.910156,174.910156,0.0,16.85098665,33974.66016,37745.44141,8.613827546,-91.38617245,-815.8515017999999,-532.3935688999999,-0.064187113,3818000,-1,-0.5574
BSESN,10/10/2018,34760.89063,34858.35156,34346.5,34493.21094,24400,461.421875,0.0,461.421875,30.72118979,33974.66016,37530.62891,22.1101625,-77.8898375,-826.8464739,-591.2841499,-0.048748447,3842400,1,0.0
BSESN,10/11/2018,34001.14844,34325.17969,33723.53125,34063.82031,30700,-759.7421870000001,759.7421870000001,0.0,23.32816361,33723.53125,37489.23828,7.372246054,-92.62775395,-886.6442308000001,-650.3561661,-0.063952551,3811700,-1,-0.4391
BSESN,10/12/2018,34733.57813,34808.42188,34279.78125,34291.92188,31300,732.4296870000001,0.0,732.4296870000001,39.5184558,33723.53125,36945.5,31.34874834,-68.65125166,-864.9626781,-693.2774684999999,-0.041227722,3843000,1,0.1027
BSESN,10/15/2018,34865.10156,35008.64844,34559.98047,34971.82813,10600,131.523438,0.0,131.523438,42.05375511,33723.53125,36938.73828,35.50534389,-64.49465611,-827.6266839,-720.1473116000001,-0.045475351,3853600,1,-0.4939
BSESN,10/16/2018,35162.48047,35215.78906,34913.05859,35004.32813,12900,297.37890600000003,0.0,297.37890600000003,47.76609187,33723.53125,36938.73828,44.75448098,-55.24551902,-765.2206596,-729.1619812000001,-0.022602757999999997,3866500,1,0.0
BSESN,10/17/2018,34779.57813,35605.42969,34727.16016,35543.37891,17700,-382.90234399999997,382.90234399999997,0.0,41.66404292,33723.53125,36711.62109,35.34187157,-64.65812843,-738.1515038,-730.9598857000001,-0.011077377,3848800,-1,0.3818
BSESN,10/19/2018,34315.62891,34563.28906,34140.32031,34563.28906,16000,-463.949219,463.949219,0.0,35.350392299999996,33723.53125,36616.64063,20.46578885,-79.53421115,-745.5416869,-733.8762459,-0.0017848970000000001,3832800,-1,0.1027
BSESN,10/22/2018,34134.37891,34748.69141,34082.76172,34689.39063,17100,-181.25,181.25,0.0,33.09006062,33723.53125,36616.64063,14.200903,-85.799097,-757.2942042999999,-738.5598376,-0.009862397,3815700,-1,-0.5994
BSESN,10/23/2018,33847.23047,34073.92188,33742.75,33935.87891,12700,-287.148437,287.148437,0.0,29.62712947,33723.53125,36602.85156,4.296125667,-95.70387433,-780.7783118,-747.0035324,-0.013184993999999998,3803000,-1,-0.7814
BSESN,10/24/2018,34033.96094,34300.96875,33726.07031,34203.69922,18900,186.730469,0.0,186.730469,34.75076641,33723.53125,35820.53125,14.80351397,-85.19648603,-775.3839048,-752.6796069000001,-0.020912286000000002,3821900,1,-0.6124
BSESN,10/25/2018,33690.08984,33838.76172,33553.17969,33778.60156,17400,-343.87109399999997,343.87109399999997,0.0,30.09495696,33553.17969,35605.42969,6.6712221220000005,-93.32877788,-789.7525461,-760.0941948,-0.009148473,3804500,-1,0.0
BSESN,10/26/2018,33349.30859,33776.80078,33291.57813,33776.80078,21300,-340.78125,340.78125,0.0,26.09691052,33291.57813,35605.42969,2.49499449,-97.50500551,-819.1948287,-771.9143215,-0.039853928,3783200,-1,0.25
BSESN,10/29/2018,34067.39844,34154.60156,33341.80078,33549.87891,28000,718.0898440000001,0.0,718.0898440000001,44.13984726,33291.57813,35605.42969,33.52938993,-66.47061007,-775.6430702,-772.6600712999999,-0.022879702000000002,3811200,1,-0.5859
BSESN,10/30/2018,33891.12891,34176.35938,33799.78906,34068.92188,15800,-176.269532,176.269532,0.0,41.28499743,33291.57813,35605.42969,25.911376100000002,-74.0886239,-746.7434718999999,-767.4767513999999,-0.036156481000000004,3795400,-1,0.0772
BSESN,10/31/2018,34442.05078,34463.37891,33587.23828,33963.08984,25900,550.921875,0.0,550.921875,52.38984724,33291.57813,35605.42969,49.72110892,-50.27889108,-671.6432557,-748.3100522999999,-0.009704757,3821300,1,0.0
BSESN,11/1/2018,34431.96875,34679.92969,34303.37891,34650.62891,22400,-10.082031,10.082031,0.0,52.18145301,33291.57813,35605.42969,49.28538387,-50.71461613,-605.9542653,-719.8388949,0.003390287,3798900,-1,0.0
BSESN,11/2/2018,35011.64844,35190.19922,34649.80078,34743.94922,38700,579.6796879999999,0.0,579.6796879999999,62.16564375,33291.57813,35605.42969,74.33797139,-25.66202861,-501.34081610000004,-676.1392791000001,0.025700469,3837600,1,-0.7906
BSESN,11/5/2018,34950.92188,35123.41016,34811.60156,35118.62109,22200,-60.726563,60.726563,0.0,60.63532902,33291.57813,35605.42969,71.71349176,-28.28650824,-418.5097106,-624.6133654,0.032608027000000005,3815400,-1,0.0
BSESN,11/6/2018,34991.91016,35196.03125,34889.71875,35076.23828,16200,40.988281,0.0,40.988281,61.37581788,33291.57813,35605.42969,73.48492264,-26.51507736,-345.57448339999996,-568.8055889999999,0.028146862,3831600,1,-0.29600000000000004
BSESN,11/7/2018,35237.67969,35302.25,35183.17188,35301.87891,2500,245.76953199999997,0.0,245.76953199999997,65.82369929,33291.57813,35302.25,96.78862012,-3.2113798780000002,-264.8877817,-508.02202750000004,0.045936055999999996,3834100,1,0.34
BSESN,11/9/2018,35158.55078,35287.28906,35011.23047,35258.12891,17100,-79.128907,79.128907,0.0,63.12323653,33291.57813,35302.25,92.85317407,-7.146825933,-204.96531819999998,-447.4106857,0.054251265,3817000,-1,0.0772
BSESN,11/12/2018,34812.98828,35333.21875,34756.80078,35287.48828,15700,-345.5625,345.5625,0.0,52.309499200000005,33291.57813,35333.21875,74.51899895,-25.48100105,-183.2479714,-394.5781428,0.021885729,3801300,-1,-0.8126
BSESN,11/13/2018,35144.48828,35187.75,34672.19922,34846.19141,12000,331.5,0.0,331.5,59.91125406,33291.57813,35333.21875,90.75594075,-9.244059248,-137.7002156,-343.20255739999993,0.036981931,3813300,1,0.0
BSESN,11/14/2018,35141.98828,35351.87891,34986.85938,35330.14063,23300,-2.5,2.5,0.0,59.82827036,33291.57813,35351.87891,89.81262217,-10.18737783,-100.644849,-294.6910157,0.020322178,3790000,-1,0.0
BSESN,11/15/2018,35260.53906,35402.0,35118.42188,35145.75,20000,118.55078200000001,0.0,118.55078200000001,62.65829891,33291.57813,35402.0,93.29703039,-6.702969614,-61.00887426,-247.95458739999998,0.024063982999999997,3810000,1,-0.8176
BSESN,11/16/2018,35457.16016,35545.85156,35324.37109,35398.69922,21100,196.621093,0.0,196.621093,67.09451031,33341.80078,35545.85156,95.97598169,-4.024018309,-13.57491659,-201.0786532,0.012724671000000002,3831100,1,-0.2023
BSESN,11/19/2018,35774.87891,35818.82813,35511.10156,35647.62109,15600,317.71875,0.0,317.71875,73.06146517,33587.23828,35818.82813,98.03058707,-1.969412933,49.08822594,-151.0452774,0.023574687,3846700,1,-0.8225
BSESN,11/20/2018,35474.51172,35731.67188,35416.17969,35730.76953,15700,-300.367187,300.367187,0.0,60.9960179,33587.23828,35818.82813,84.57080243,-15.42919757,73.66295544,-106.10363079999999,0.013791804,3831000,-1,0.3612
BSESN,11/21/2018,35199.80078,35494.25,35112.48828,35492.62109,13900,-274.710938,274.710938,0.0,51.94370879,34303.37891,35818.82813,59.15222125,-40.84777875,70.16293415,-70.85031784,-0.001074955,3817100,-1,0.0
BSESN,11/22/2018,34981.01953,35364.5,34937.98047,35282.32813,13800,-218.78125,218.78125,0.0,45.70994117,34649.80078,35818.82813,28.33284882,-71.66715118,49.1685393,-46.84654641,-0.005049447,3803300,-1,0.29600000000000004
BSESN,11/26/2018,35354.07813,35397.23828,34896.07031,35118.08984,19200,373.05859399999997,0.0,373.05859399999997,56.08026313,34672.19922,35818.82813,59.46814200000001,-40.531858,61.91927403,-25.09338232,0.015542758,3822500,1,0.0
BSESN,11/27/2018,35513.14063,35555.16016,35262.96875,35394.76953,19100,159.0625,0.0,159.0625,59.85305694,34672.19922,35818.82813,73.34032847,-26.65967153,83.89227961,-3.296249937,0.01048962,3841600,1,0.0
BSESN,11/28/2018,35716.94922,35822.16016,35605.33984,35635.51953,27500,203.808594,0.0,203.808594,64.37717837,34672.19922,35822.16016,90.85091209,-9.149087905,116.40979540000001,20.64495913,0.016361082,3869100,1,0.0
BSESN,11/29/2018,36170.41016,36253.85156,35946.23828,35997.28906,40500,453.460937,0.0,453.460937,72.37039728,34672.19922,36253.85156,94.72441543,-5.275584568999999,176.7333963,51.86264656,0.025804231,3909600,1,0.0
BSESN,11/30/2018,36194.30078,36389.21875,36082.96875,36304.42969,23300,23.890625,0.0,23.890625,72.74220605,34672.19922,36389.21875,88.64788865,-11.35211135,223.8872257,86.2675624,0.020789613000000002,3932900,1,0.1376
BSESN,12/3/2018,36241.0,36446.16016,36099.67969,36396.69141,30100,46.699219,0.0,46.699219,73.54514117,34672.19922,36446.16016,88.43491129,-11.56508871,262.0049817,121.4150463,0.013029285,3963000,1,0.5267
BSESN,12/4/2018,36134.30859,36295.83984,36036.39063,36290.48047,18500,-106.691406,106.691406,0.0,68.24566949999999,34896.07031,36446.16016,79.88171051,-20.11828949,280.3725133,153.20653969999998,0.018599181,3944500,-1,-0.4767
BSESN,12/5/2018,35884.41016,36048.64844,35777.80859,36035.64844,20800,-249.898438,249.898438,0.0,57.12165855,34896.07031,36446.16016,63.76016509,-36.23983491,271.632983,176.89182830000001,0.01944924,3923700,-1,-0.7096
BSESN,12/6/2018,35312.12891,35707.23047,35266.76172,35694.25,22600,-572.28125,572.28125,0.0,39.92552452,34896.07031,36446.16016,26.84093408,-73.15906592,216.0381746,184.7210976,0.009465401,3901100,-1,0.5106
BSESN,12/7/2018,35673.25,35730.05078,35378.26953,35494.85938,19000,361.12109399999997,0.0,361.12109399999997,50.72592256,34896.07031,36446.16016,50.13771882,-49.86228118,198.8263957,187.5421572,0.009027865999999999,3920100,1,0.0
BSESN,12/10/2018,34959.71875,35246.96875,34915.76953,35204.66016,18500,-713.53125,713.53125,0.0,35.97886729,34896.07031,36446.16016,4.106112771,-95.89388723,126.1556841,175.2648626,-0.01558358,3901600,-1,0.0
BSESN,12/11/2018,35150.01172,35207.32813,34426.28906,34584.12891,22300,190.292969,0.0,190.292969,41.23594904,34426.28906,36446.16016,35.83014077,-64.16985923,82.96233569,156.8043572,-0.015873066,3923900,1,0.0
BSESN,12/12/2018,35779.07031,35826.57813,35167.46875,35277.83984,21600,629.0585940000001,0.0,629.0585940000001,55.25164619,34426.28906,36446.16016,66.97364276,-33.02635724,98.35726581,145.1149389,-0.010819337,3945500,1,0.5719
BSESN,12/13/2018,35929.64063,36095.55859,35794.51172,36024.87891,22600,150.570312,0.0,150.570312,58.01713084,34426.28906,36446.16016,74.42809431,-25.57190569,121.3092472,140.3538006,-0.007312205,3968100,1,-0.6486
BSESN,12/14/2018,35962.92969,36019.01953,35813.85156,35960.19141,19000,33.289063,0.0,33.289063,58.66873376,34426.28906,36446.16016,76.0761729,-23.9238271,140.564665,140.3959735,-0.00767281,3987100,1,0.0
BSESN,12/17/2018,36270.07031,36312.30859,36123.62109,36129.12891,17130800,307.140625,0.0,307.140625,64.52958594,34426.28906,36446.16016,91.28212471,-8.717875295,178.5501884,148.0268165,0.003757142,21117900,1,0.0
BSESN,12/18/2018,36347.07813,36375.37891,36046.51953,36226.37891,20793100,77.007812,0.0,77.007812,65.92734854,34426.28906,36446.16016,95.09463592,-4.905364077,212.4192395,160.9053011,0.012893286,41911000,1,0.0
BSESN,12/19/2018,36484.32813,36554.98828,36381.87109,36441.46094,16700,137.25,0.0,137.25,68.4815627,34426.28906,36554.98828,96.68059464,-3.319405363,247.4828068,178.22080219999998,0.033195371,41927700,1,0.0
BSESN,12/20/2018,36431.67188,36475.51953,36202.89844,36321.17969,19766300,-52.65625,52.65625,0.0,66.28201904,34426.28906,36554.98828,94.20695959,-5.793040414,267.93344709999997,196.1633312,0.021260241000000003,22161400,-1,0.0
BSESN,12/21/2018,35742.07031,36483.48828,35694.73828,36449.26953,18528300,-689.6015620000001,689.6015620000001,0.0,44.6238352,34426.28906,36554.98828,61.81151564,-38.18848436,225.8917051,202.109006,0.022378657000000003,3633100,-1,0.0
BSESN,12/24/2018,35470.14844,35910.67188,35423.23828,35859.66016,13245200,-271.921875,271.921875,0.0,38.84830108,34426.28906,36554.98828,49.03742935,-50.96257065,168.6869804,195.4246009,0.009107727,-9612100,-1,0.0
BSESN,12/26/2018,35649.94141,35711.26172,35010.82031,35443.16016,16200,179.792968,0.0,179.792968,44.34389383,34426.28906,36554.98828,57.48357178,-42.51642822,136.2885642,183.5973935,-0.003609063,-9595900,1,0.0
BSESN,12/27/2018,35807.28125,36041.23828,35781.94922,36002.10938,13054200,157.339844,0.0,157.339844,48.97420048,34426.28906,36554.98828,64.87493279,-35.12506721,121.90337020000001,171.2585889,-0.003405527,3458300,1,0.2732
BSESN,12/28/2018,36076.71875,36194.78125,35911.98828,35911.98828,10426300,269.4375,0.0,269.4375,56.17792511,34426.28906,36554.98828,77.53231049,-22.46768951,130.7372966,163.1543304,0.003164065,13884600,1,0.4767
BSESN,12/31/2018,36068.32813,36285.46094,36033.94922,36239.19141,8645400,-8.390625,8.390625,0.0,55.89438166,34426.28906,36554.98828,77.13814371,-22.86185629,135.4992427,157.6233129,-0.0055622219999999995,5239200,-1,0.0
BSESN,1/2/2019,35891.51953,36236.69922,35734.01172,36198.12891,14705400,-176.808594,176.808594,0.0,49.78484783,35010.82031,36554.98828,57.03390021,-42.96609979,123.5815719,150.8149647,-0.012533569,-9466200,-1,-0.0516
BSESN,1/3/2019,35513.71094,35999.66016,35475.57031,35934.5,17400,-377.80859300000003,377.80859300000003,0.0,39.21615461,35010.82031,36554.98828,32.56709344,-67.43290656,82.6974513,137.191462,-0.026603674,-9483600,-1,-0.25
BSESN,1/4/2019,35695.10156,35744.19922,35382.07813,35590.78906,15855600,181.390625,0.0,181.390625,45.61226556,35010.82031,36554.98828,44.31391301,-55.68608699,64.19321916,122.5918134,-0.020217856,6372000,1,0.2263
BSESN,1/7/2019,35850.16016,36076.94922,35809.23047,35971.17969,14831200,155.058593,0.0,155.058593,50.72638803,35010.82031,36554.98828,54.355475600000005,-45.6445244,61.33340118,110.340131,0.003024163,21203200,1,0.0
BSESN,1/8/2019,35980.92969,36037.35156,35753.94922,35964.62109,16218000,130.769532,0.0,130.769532,54.85704193,35010.82031,36554.98828,62.82408359,-37.17591641,68.82560444,102.0372257,0.014400313,37421200,1,0.4019
BSESN,1/9/2019,36212.91016,36250.53906,35863.28906,36181.37109,20300,231.98046800000003,0.0,231.98046800000003,61.46870574,35010.82031,36554.98828,77.84709098,-22.15290902,92.41679129,100.11313879999999,0.015791576,37441500,1,0.0
BSESN,1/10/2019,36106.5,36269.30859,36070.76172,36258.0,17331500,-106.410156,106.410156,0.0,57.04659095,35010.82031,36483.48828,74.40099947,-25.59900053,101.35817259999999,100.36214559999999,0.008356366,20110000,-1,0.0
BSESN,1/11/2019,36009.83984,36214.26172,35840.60156,36191.87109,18100,-96.660156,96.660156,0.0,53.046713000000004,35010.82031,36483.48828,67.83739123,-32.16260877,99.49766782,100.18925,-0.0018537970000000001,20091900,-1,0.0
BSESN,1/14/2019,35853.55859,36124.94141,35691.75,36113.26953,24100,-156.28125,156.28125,0.0,46.91057534,35010.82031,36285.46094,66.11575565,-33.88424435,84.43925045,97.03925009999999,-0.005954519,20067800,-1,-0.5574
BSESN,1/15/2019,36318.32813,36349.30859,35950.07813,35950.07813,24000,464.769531,0.0,464.769531,61.99567836,35010.82031,36349.30859,97.6854135,-2.314586496,108.75470659999999,99.38234139,0.011891628000000001,20091800,1,0.0
BSESN,1/16/2019,36321.28906,36462.03125,36278.60938,36370.73828,16400,2.960938,0.0,2.960938,62.07489322,35382.07813,36462.03125,86.96775038,-13.03224962,126.80210790000001,104.8662947,0.022739897000000002,20108200,1,0.1531
BSESN,1/17/2019,36374.07813,36468.42188,36170.80078,36413.60156,20500,52.789062,0.0,52.789062,63.63419234,35382.07813,36468.42188,91.31547909999999,-8.684520898999999,143.7078648,112.6346087,0.019021561,20128700,1,-0.1531
BSESN,1/18/2019,36386.60938,36469.98047,36218.32813,36417.57813,20800,12.53125,0.0,12.53125,64.03916965,35382.07813,36469.98047,92.33652777,-7.663472228,156.31506330000002,121.37069960000001,0.014963648999999999,20149500,1,-0.3612
BSESN,1/21/2019,36578.96094,36701.03125,36351.76953,36467.12109,18700,192.351563,0.0,192.351563,69.96346289,35382.07813,36701.03125,90.74490899999999,-9.255091002999999,179.755414,133.0476425,0.016620784,20168200,1,0.0
BSESN,1/22/2019,36444.64063,36650.46875,36282.92969,36649.92188,17300,-134.320313,134.320313,0.0,61.76482120000001,35382.07813,36701.03125,80.56105102,-19.43894898,185.35685569999998,143.5094852,0.006399111999999999,20150900,-1,0.0
BSESN,1/23/2019,36108.46875,36521.46875,36037.89844,36494.12109,14300,-336.171875,336.171875,0.0,46.14804182,35382.07813,36701.03125,55.0732707,-44.9267293,160.81599119999998,146.9707864,5.45e-05,20136600,-1,0.5106
BSESN,1/24/2019,36195.10156,36258.28125,35996.67969,36146.55078,23100,86.632813,0.0,86.632813,49.91367813,35691.75,36701.03125,49.87227921,-50.12772079,146.6670369,146.9100365,0.005144753,20159700,1,0.6124
BSESN,1/25/2019,36025.53906,36474.48047,35953.14844,36245.76953,23000,-169.5625,169.5625,0.0,43.10639412,35691.75,36701.03125,33.0719572,-66.9280428,120.3839013,141.6048094,0.004796748,20136700,-1,0.4939
BSESN,1/28/2019,35656.69922,36124.26172,35565.14844,36099.62109,15000,-368.83984399999997,368.83984399999997,0.0,32.11376744,35565.14844,36701.03125,8.059879067999999,-91.94012093,68.99668336,127.08318419999999,-0.018217493,20121700,-1,-0.5423
BSESN,1/29/2019,35592.5,35734.14063,35375.51172,35716.71875,16670300,-64.199219,64.199219,0.0,30.54918232,35375.51172,36701.03125,16.37005536,-83.62994464,22.82845028,106.2322374,-0.020065066,3451400,-1,-0.25
BSESN,1/30/2019,35591.25,35850.41016,35490.96875,35819.67188,18974200,-1.25,1.25,0.0,30.51578123,35375.51172,36701.03125,16.27575271,-83.72424729,-13.70311068,82.24516781,-0.021521593999999998,-15522800,-1,0.0
BSESN,1/31/2019,36256.69141,36278.12891,35740.07031,35805.51172,18611400,665.4414059999999,0.0,665.4414059999999,58.43243324,35375.51172,36701.03125,66.47806135,-33.52193865,10.9151017,67.97915459,-0.0035704879999999997,3088600,1,0.0
BSESN,2/1/2019,36469.42969,36778.14063,36221.32031,36311.73828,31815100,212.73828199999997,0.0,212.73828199999997,63.79776166,35375.51172,36778.14063,77.99054791,-22.00945209,47.04906152,63.79313598,-0.002994378,34903700,1,0.2732
BSESN,2/4/2019,36582.73828,36622.76953,36225.48047,36456.21875,15600,113.30859299999999,0.0,113.30859299999999,66.45842693,35375.51172,36778.14063,86.06884949,-13.93115051,83.86183447,67.80687568,0.003789245,34919300,1,0.0
BSESN,2/5/2019,36616.80859,36727.82813,36495.82813,36573.03906,14104800,34.070313,0.0,34.070313,67.29242369,35375.51172,36778.14063,88.49788206,-11.50211794,114.4659199,77.13868452,0.014078133999999999,49024100,1,-0.3612
BSESN,2/6/2019,36975.23047,37005.25,36680.87891,36714.53906,13931600,358.421875,0.0,358.421875,74.87548966,35375.51172,37005.25,98.15801523,-1.8419847740000002,165.7310832,94.85716426,0.021553439,62955700,1,0.8463
BSESN,2/7/2019,36971.08984,37172.17969,36898.80078,37026.55859,14600,-4.140625,4.140625,0.0,74.64480678,35375.51172,37172.17969,88.80762347,-11.19237653,203.6771176,116.62115490000001,0.02624668,62941100,-1,-0.34
BSESN,2/8/2019,36546.48047,36885.57813,36480.62109,36873.58984,21600,-424.609375,424.609375,0.0,54.70320463,35375.51172,37172.17969,65.17446574,-34.82553426,197.2138369,132.7396913,0.024954112,62919500,-1,0.4939
BSESN,2/11/2019,36395.03125,36588.41016,36300.48047,36585.5,19200,-151.449219,151.449219,0.0,49.28449222,35375.51172,37172.17969,56.74501625,-43.25498375,177.8211427,141.75598159999998,0.022547763,62900300,-1,0.0
BSESN,2/12/2019,36153.62109,36465.39844,36113.91016,36405.71875,12200,-241.410156,241.410156,0.0,41.68921758,35375.51172,37172.17969,43.30846814,-56.69153186,141.3431945,141.6734242,0.015800823999999998,62888100,-1,0.0
BSESN,2/14/2019,35876.21875,36109.10156,35799.42188,36065.07813,32500,-277.40234399999997,277.40234399999997,0.0,34.61606008,35375.51172,37172.17969,27.86864572,-72.13135428,89.0238948,131.14351829999998,-0.01049386,62855600,-1,0.4019
BSESN,2/15/2019,35808.94922,36022.57031,35510.96875,35985.67969,23000,-67.269531,67.269531,0.0,33.04721303,35375.51172,37172.17969,24.12451869,-75.87548131,41.65224279,113.2452632,-0.018110524,62832600,-1,-0.8689
BSESN,2/18/2019,35498.44141,35912.44141,35470.76172,35831.17969,15900,-310.507813,310.507813,0.0,26.62130687,35375.51172,37172.17969,6.842092647,-93.15790735,-20.70682284,86.45484599,-0.029639577,62816700,-1,-0.5719
BSESN,2/19/2019,35352.60938,35776.03906,35287.16016,35543.23828,10100,-145.832031,145.832031,0.0,24.08355883,35287.16016,37172.17969,3.472071132,-96.52792887,-80.96098987,52.97167882,-0.034525107,62806600,-1,0.0
BSESN,2/20/2019,35756.26172,35797.10938,35469.48828,35564.92969,12500,403.65234399999997,0.0,403.65234399999997,41.80212948,35287.16016,37172.17969,24.885766699999998,-75.1142333,-95.04585124,23.36817281,-0.032967171,62819100,1,-0.0516
BSESN,2/21/2019,35898.35156,35983.07031,35707.28906,35837.0,11400,142.089844,0.0,142.089844,46.84142301,35287.16016,37172.17969,32.42361135,-67.57638865,-93.66305306,-0.038072365,-0.029015597999999997,62830500,1,0.2732
BSESN,2/22/2019,35871.48047,35941.69141,35795.78906,35906.01172,18400,-26.871094,26.871094,0.0,45.97279528,35287.16016,37172.17969,30.9981039,-69.0018961,-93.65584201,-18.76162629,-0.018469631,62812100,-1,0.0
BSESN,2/25/2019,36213.37891,36242.17969,35901.05859,35983.80078,11800,341.898437,0.0,341.898437,57.53403239,35287.16016,37172.17969,49.13576407,-50.86423593,-65.30893989,-28.07108901,-0.00499113,62823900,1,0.0
BSESN,2/26/2019,35973.71094,36172.51953,35714.16016,35975.75,17900,-239.66796800000003,239.66796800000003,0.0,49.0451809,35287.16016,37172.17969,36.42141476,-63.57858524,-61.47437939,-34.75174709,-0.004976269,62806000,-1,-0.7579
BSESN,2/27/2019,35905.42969,36371.10938,35735.32813,36138.82813,19300,-68.28125,68.28125,0.0,46.77641128,35287.16016,37172.17969,32.79910481,-67.20089519,-63.21646868,-40.44469141,0.000814215,62786700,-1,-0.5574
BSESN,2/28/2019,35867.44141,36085.85156,35829.14844,36025.71875,11900,-37.988282,37.988282,0.0,45.42742277,35287.16016,36885.57813,36.30347389,-63.69652611,-66.89134213,-45.73402155,0.001633452,62774800,-1,0.0
BSESN,3/1/2019,36063.80859,36140.67188,35952.41016,36018.48828,16700,196.367188,0.0,196.367188,53.43668352,35287.16016,36588.41016,59.68479831,-40.31520169,-53.34360299,-47.25593784,0.015926536,62791500,1,0.25
BSESN,3/5/2019,36442.53906,36457.44141,35926.94141,36141.07031,21200,378.73046899999997,0.0,378.73046899999997,64.90047822,35287.16016,36465.39844,98.05986825,-1.94013175,-11.90925597,-40.18660146,0.030830247,62812700,1,0.0
BSESN,3/6/2019,36636.10156,36666.46875,36456.82031,36544.85938,15900,193.5625,0.0,193.5625,69.35036253,35287.16016,36666.46875,97.79837615,-2.201623852,36.13015274,-24.92325062,0.024606595,62828600,1,0.0
BSESN,3/7/2019,36725.42188,36830.25,36590.87891,36744.01953,16800,89.320312,0.0,89.320312,71.28848219,35287.16016,36830.25,93.2066091,-6.793390897,80.48139354,-3.842321792,0.023039228,62845400,1,0.0
BSESN,3/8/2019,36671.42969,36753.58984,36592.92969,36753.58984,14600,-53.992187,53.992187,0.0,68.27714629,35287.16016,36830.25,89.70764323,-10.29235677,110.0052807,18.92719871,0.022300424,62830800,-1,-0.5187
BSESN,3/11/2019,37054.10156,37106.19141,36726.39063,36741.57031,14400,382.671875,0.0,382.671875,76.42209813,35287.16016,37106.19141,97.13639647,-2.863603525,162.40944130000003,47.62364723,0.023215802999999997,62845200,1,0.0
BSESN,3/12/2019,37535.66016,37586.62891,37230.85156,37249.64844,19500,481.558593,0.0,481.558593,82.82507165,35469.48828,37586.62891,97.59256663,-2.407433375,240.03094269999997,86.10510633,0.043419185,62864700,1,0.0
BSESN,3/13/2019,37752.17188,37797.28906,37478.87109,37608.28906,21000,216.511719,0.0,216.511719,84.9459257,35707.28906,37797.28906,97.84128287,-2.1587171290000002,315.38170410000004,131.96042590000002,0.051433507,62885700,1,0.6124
BSESN,3/14/2019,37754.89063,37907.78125,37693.69141,37840.64063,15600,2.71875,0.0,2.71875,84.97281190000001,35714.16016,37907.78125,93.03021723,-6.969782768,371.0399878,179.77633830000002,0.052622912,62901300,1,-0.8934
BSESN,3/15/2019,38024.32031,38254.76953,37760.23047,37760.23047,16300,269.429688,0.0,269.429688,87.52123229,35714.16016,38254.76953,90.92937229,-9.070627711,431.91149580000007,230.20336980000002,0.05436230400000001,62917600,1,0.5423
BSESN,3/18/2019,38095.07031,38369.58984,37952.10156,38132.96094,15900,70.75,0.0,70.75,88.1310961,35714.16016,38369.58984,89.66195444,-10.33804556,480.32465460000003,280.2276267,0.045346215999999995,62933500,1,-0.29600000000000004
BSESN,3/19/2019,38363.46875,38396.05859,38078.23047,38218.58984,15100,268.398437,0.0,268.398437,90.22270836,35735.32813,38396.05859,98.77515425,-1.224845747,534.1921083999999,331.0205231,0.047149317999999996,62948600,1,0.4939
BSESN,3/20/2019,38386.75,38489.80859,38316.21094,38433.85938,15600,23.28125,0.0,23.28125,90.39216949,35829.14844,38489.80859,96.12657807,-3.873421931,572.1654883,379.24951610000005,0.045236461,62964200,1,0.0
BSESN,3/22/2019,38164.60938,38564.71094,38089.35938,38452.46875,18200,-222.140625,222.140625,0.0,75.90757711,35926.94141,38564.71094,84.83182256,-15.16817744,577.6756878,418.9347504,0.040717792999999995,62946000,-1,0.0
BSESN,3/25/2019,37808.91016,38016.76172,37667.39844,38016.76172,17000,-355.69921899999997,355.69921899999997,0.0,58.56799416,35926.94141,38564.71094,71.3469743,-28.653025699999997,547.0347305,444.55474639999994,0.020370446,62929000,-1,-0.4588
BSESN,3/26/2019,38233.41016,38297.69922,37800.07813,37886.28906,14600,424.5,0.0,424.5,68.48209879,36456.82031,38564.71094,84.28282862,-15.71717138,550.6575163,465.7753004,0.01858899,62943600,1,-0.5423
BSESN,3/27/2019,38132.87891,38475.92969,38001.33984,38372.03125,18800,-100.53125,100.53125,0.0,64.27910585,36590.87891,38564.71094,78.12214895,-21.87785105,539.200995,480.4604393,0.010084374,62924800,-1,-0.2195
BSESN,3/28/2019,38545.71875,38593.64844,38148.44141,38208.30078,16000,412.83984399999997,0.0,412.83984399999997,72.32677053,36592.92969,38593.64844,97.60437653,-2.395623473,557.0134403,495.7710395,0.020946376000000003,62940800,1,0.0
BSESN,4/1/2019,38871.87109,39115.57031,38808.73828,38858.87891,19800,326.15234399999997,0.0,326.15234399999997,77.04168993,36726.39063,39115.57031,89.799879,-10.200121000000001,590.6391791,514.7446675,0.022289702,62960600,1,0.5106
BSESN,4/2/2019,39056.64844,39121.69141,38846.96094,38988.57031,19700,184.777344,0.0,184.777344,79.34244063,37230.85156,39121.69141,96.56010168,-3.43989832,624.9932734,536.7943886,0.025241537,62980300,1,0.0
BSESN,4/3/2019,38877.12109,39270.14063,38826.55859,39167.05078,17000,-179.527344,179.527344,0.0,71.32889136,37478.87109,39270.14063,78.05916283,-21.94083717,630.4651743,555.5285458,0.013389101,62963300,-1,-0.4767
BSESN,4/4/2019,38684.71875,38939.35156,38581.03906,38935.75,13000,-192.402344,192.402344,0.0,63.40934538,37667.39844,39270.14063,63.47373397,-36.52626603,612.2191526,566.8666671,0.007762280999999999,62950300,-1,0.0
BSESN,4/5/2019,38862.23047,38958.60156,38701.03906,38839.51953,15900,177.511719,0.0,177.511719,67.27703836,37667.39844,39270.14063,74.54923447,-25.45076553,605.1074591,574.5148255,0.018279267,62966200,1,0.0
BSESN,4/8/2019,38700.53125,39041.25,38520.96094,38993.60156,10500,-161.699219,161.699219,0.0,60.54998808,37667.39844,39270.14063,64.46032434,-35.53967566,579.740725,575.5600053999999,0.023582301,62955700,-1,0.1531
BSESN,4/9/2019,38939.21875,38978.98828,38598.71875,38730.92969,15100,238.6875,0.0,238.6875,66.29082932,37667.39844,39270.14063,79.35276942,-20.64723058,572.3003694,574.9080782000001,0.018460518999999998,62970800,1,0.0
BSESN,4/10/2019,38585.35156,38950.44922,38542.28125,38898.60156,16200,-353.867187,353.867187,0.0,53.07786241,37667.39844,39270.14063,57.27391045,-42.72608955,531.720368,566.2705362,0.011865683,62954600,-1,0.0
BSESN,4/11/2019,38607.01172,38649.98047,38460.25,38621.57813,14500,21.660156,0.0,21.660156,53.72922507,37667.39844,39270.14063,58.62535401,-41.37464599,495.595304,552.1354897000001,0.0015901370000000001,62969100,1,-0.5719
BSESN,4/12/2019,38767.10938,38818.87109,38554.78906,38692.05859,17000,160.097656,0.0,160.097656,58.62734853,37667.39844,39270.14063,68.61433772,-31.38566228,474.4157044,536.5915326999999,-0.0026950520000000003,62986100,1,0.0
BSESN,4/15/2019,38905.83984,38976.57813,38780.07813,38805.53906,20900,138.730469,0.0,138.730469,62.58719223,37800.07813,39270.14063,75.21868757,-24.78131243,463.4823722,521.9697006,-0.0038612779999999997,63007000,1,0.4019
BSESN,4/16/2019,39275.64063,39364.33984,39038.80859,39040.30078,14400,369.80078100000003,0.0,369.80078100000003,71.09596674,38001.33984,39364.33984,93.49235371,-6.507646295,479.1342983,513.4026201,0.010250747,63021400,1,-0.2732
BSESN,4/18/2019,39140.28125,39487.44922,39083.16016,39420.03906,14600,-135.359375,135.359375,0.0,64.86539106,38148.44141,39487.44922,74.07274509,-25.92725491,475.13908449999997,505.749913,0.011776291000000001,63006800,-1,0.0
BSESN,4/22/2019,38645.17969,39158.21875,38585.64844,39158.21875,14900,-495.101562,495.101562,0.0,47.3518482,38460.25,39487.44922,18.00329328,-81.99670672,427.0989596,490.0197223,-0.005585134,62991900,-1,-0.6124
BSESN,4/23/2019,38564.87891,38832.60938,38518.26172,38771.26953,11600,-80.300782,80.300782,0.0,45.07432113,38460.25,39487.44922,10.18584361,-89.81415639,378.1877,467.65331789999993,-0.00350518,62980300,-1,0.0
BSESN,4/24/2019,39054.67969,39095.35156,38571.0,38672.62891,15200,489.800782,0.0,489.800782,58.96512393,38460.25,39487.44922,57.868977799999996,-42.131022200000004,374.62950839999996,449.04855599999996,0.002965158,62995500,1,0.0
BSESN,4/25/2019,38730.85938,39262.21875,38663.98047,39101.78125,14400,-323.820313,323.820313,0.0,49.42910361,38460.25,39487.44922,26.34439065,-73.65560935,341.7406494,427.5869746,0.003771064,62981100,-1,0.4019
BSESN,4/26/2019,39067.32813,39103.16016,38765.32813,38865.82813,17300,336.46875,0.0,336.46875,57.64199378,38460.25,39487.44922,59.10032969,-40.89967031,338.91935639999997,409.85345099999995,0.01192313,62998400,1,0.0
BSESN,4/30/2019,39031.55078,39105.87891,38753.46094,39056.92188,30900,-35.777344,35.777344,0.0,56.51589308,38460.25,39487.44922,55.61733016,-44.38266984,329.9925798,393.8812768,0.006821283,62967500,-1,0.0
BSESN,5/2/2019,38981.42969,39189.94922,38882.98828,39036.51172,26200,-50.121093,50.121093,0.0,54.78581114,38460.25,39487.44922,50.73793655,-49.26206345,315.23980339999997,378.15298210000003,0.001942892,62941300,-1,-0.5423
BSESN,5/3/2019,38963.26172,39172.76172,38920.17188,39009.55078,14800,-18.167969,18.167969,0.0,54.09322672,38460.25,39487.44922,48.96924664,-51.03075336,298.6395873,362.25030310000005,-0.007953503,62926500,-1,0.0
BSESN,5/6/2019,38600.33984,38719.32813,38509.78906,38719.32813,13400,-362.921875,362.921875,0.0,41.887933200000006,38460.25,39487.44922,13.63804035,-86.36195965,253.27938709999998,340.4561199,-0.013795031000000001,62913100,-1,0.5574
BSESN,5/7/2019,38276.62891,38835.53906,38236.17969,38815.46094,15600,-323.710938,323.710938,0.0,33.9939071,38236.17969,39487.44922,3.2326542760000003,-96.76734572,189.03129909999998,310.1711557,-0.009536785,62897500,-1,0.5574
BSESN,5/8/2019,37789.12891,38248.57031,37743.07031,38244.17969,13100,-487.5,487.5,0.0,25.60799429,37743.07031,39487.44922,2.640400709,-97.35959929,97.65138633,267.6672019,-0.020115453000000002,62884400,-1,0.0258
BSESN,5/9/2019,37558.91016,37780.46094,37405.39844,37747.91016,15300,-230.21875,230.21875,0.0,22.57364896,37405.39844,39487.44922,7.3731015310000005,-92.62689847,6.579572773,215.44967599999998,-0.038299368,62869100,-1,0.6597
BSESN,5/10/2019,37462.98828,37721.98047,37370.39063,37632.35938,19700,-95.921875,95.921875,0.0,21.35702843,37370.39063,39487.44922,4.37388253,-95.62611747,-72.49985606,157.8597696,-0.032735424,62849400,-1,0.5574
BSESN,5/13/2019,37090.82031,37583.57031,36999.83984,37491.30078,17800,-372.16796800000003,372.16796800000003,0.0,17.20563944,36999.83984,39262.21875,4.021451436,-95.97854856,-163.31907719999998,93.62400027,-0.050592347,62831600,-1,0.0
BSESN,5/14/2019,37318.53125,37572.69922,36956.10156,37146.57813,17700,227.710937,0.0,227.710937,27.19639421,36956.10156,39262.21875,15.71601344,-84.28398656,-214.44757650000003,32.00968492,-0.043888073,62849300,1,0.5106
BSESN,5/15/2019,37114.87891,37559.67188,37047.87109,37539.05078,19400,-203.652344,203.652344,0.0,24.18481838,36956.10156,39262.21875,6.885050937000001,-93.11494906,-268.3074415,-28.05374037,-0.047883077,62829900,-1,0.0
BSESN,5/16/2019,37393.48047,37518.94141,37052.30078,37179.12891,15700,278.601563,0.0,278.601563,35.46508268,36956.10156,39262.21875,18.96603123,-81.03396877,-285.2230807,-79.48760845,-0.040288753999999996,62845600,1,0.0869
BSESN,5/17/2019,37930.76953,38001.12891,37415.35938,37494.42188,18800,537.2890620000001,0.0,537.2890620000001,51.51694514,36956.10156,39189.94922,43.63180118,-56.36819882,-252.36500299999997,-114.0630874,-0.017346228,62864400,1,0.0
BSESN,5/20/2019,39352.67188,39412.55859,38570.03906,38701.17969,26400,1421.9023439999999,0.0,1421.9023439999999,72.44532590000001,36956.10156,39412.55859,97.56206934,-2.437930656,-110.3174332,-113.31395649999999,0.028112271,62890800,1,0.5859
BSESN,5/21/2019,38969.80078,39571.73047,38884.85156,39449.44922,22700,-382.87109399999997,382.87109399999997,0.0,63.87830631,36956.10156,39571.73047,76.98719086,-23.01280914,-28.31184685,-96.3135346,0.031243691,62868100,-1,0.0
BSESN,5/22/2019,39110.21094,39249.07813,38903.87109,39086.21094,15600,140.410157,0.0,140.410157,65.59968213,36956.10156,39571.73047,82.35531309999999,-17.644686899999996,47.46099654,-67.55862837,0.041303136000000004,62883700,1,0.0
BSESN,5/23/2019,38811.39063,40124.96094,38651.60938,39591.76953,28100,-298.820313,298.820313,0.0,58.72730248,36956.10156,40124.96094,58.54753533,-41.45246467,82.44880047,-37.557142600000006,0.03599292,62855600,-1,0.0
BSESN,5/24/2019,39434.71875,39476.96875,38824.26172,39076.28125,17100,623.328125,0.0,623.328125,67.03855021,36956.10156,40124.96094,78.21796090000001,-21.7820391,158.645491,1.683384121,0.06319349099999999,62872700,1,0.0
BSESN,5/27/2019,39683.28906,39821.94141,39353.16016,39536.23047,16000,248.570313,0.0,248.570313,69.83370456,36956.10156,40124.96094,86.06211817,-13.93788183,236.36479780000002,48.61966687,0.063366851,62888700,1,0.8402
BSESN,5/28/2019,39749.73047,39828.64844,39498.64844,39765.64063,15300,66.441406,0.0,66.441406,70.60256306,36956.10156,40124.96094,88.15881601,-11.84118399,299.8625459,98.86824267,0.070991787,62904000,1,0.0
BSESN,5/29/2019,39502.05078,39767.92969,39420.5,39714.26953,12800,-247.679688,247.679688,0.0,63.62720118,36956.10156,40124.96094,80.34276428,-19.65723572,326.43633289999997,144.38186069999998,0.056388715,62891200,-1,0.0
BSESN,5/30/2019,39831.96875,39911.92188,39500.55859,39580.28125,17500,329.91796899999997,0.0,329.91796899999997,68.42222997,36956.10156,40124.96094,90.75401735,-9.24598265,369.8544219,189.476373,0.050122875,62908700,1,0.4939
BSESN,5/31/2019,39714.19922,40122.33984,39374.23828,39998.91016,17100,-117.769531,117.769531,0.0,64.89833515,36956.10156,40124.96094,87.03755294,-12.96244706,390.26185760000004,229.6334699,0.009186856,62891600,-1,0.6369
BSESN,6/3/2019,40267.62109,40308.89844,39711.01953,39806.85938,34600,553.421875,0.0,553.421875,72.56079924,37047.87109,40308.89844,98.7342227,-1.265777304,445.95077469999995,272.8969308,0.033303232,62926200,1,-0.6486
BSESN,6/4/2019,40083.53906,40312.07031,40031.05078,40196.0,11900,-184.082031,184.082031,0.0,66.95155456,37052.30078,40312.07031,92.98934333,-7.010656666,469.815026,312.2805499,0.024886803,62914300,-1,0.0772
BSESN,6/6/2019,39529.71875,40159.26172,39481.14844,40136.42969,18700,-553.8203129999999,553.8203129999999,0.0,52.78618285,37415.35938,40312.07031,72.99172821,-27.00827179,438.9786734,337.62017460000004,0.018508178,62895600,-1,0.7579
BSESN,6/7/2019,39615.89844,39703.10156,39279.46875,39581.76953,14800,86.179688,0.0,86.179688,54.51411967,38570.03906,40312.07031,60.0367746,-39.9632254,416.69126489999996,353.4343927,0.004594421,62910400,1,0.4019
BSESN,6/10/2019,39784.51953,39979.48047,39619.96875,39787.32813,16200,168.621093,0.0,168.621093,57.98557851,38651.60938,40312.07031,68.22865447,-31.77134553,407.932257,364.3339655,0.00255096,62926600,1,-0.34
BSESN,6/11/2019,39950.46094,40066.30859,39760.01953,39900.44922,14200,165.941407,0.0,165.941407,61.33623804,38651.60938,40312.07031,78.22234979,-21.77765021,409.6584768,373.3988678,0.0050498570000000005,62940800,1,0.0
BSESN,6/12/2019,39756.80859,39982.10156,39623.53125,39974.17969,11700,-193.652344,193.652344,0.0,55.38830731,38651.60938,40312.07031,66.55978432,-33.44021568,390.8944053999999,376.8979753,0.00644923,62929100,-1,0.0
BSESN,6/13/2019,39741.35938,39800.80859,39461.26953,39679.35156,21800,-15.449219,15.449219,0.0,54.89825887,38824.26172,40312.07031,61.64083604,-38.35916396,370.50615639999995,375.6196115,-0.00227479,62907300,-1,-0.2732
BSESN,6/14/2019,39452.07031,39799.89844,39363.44922,39797.0,20600,-289.289062,289.289062,0.0,46.08811061,39279.46875,40312.07031,16.71521419,-83.28478581,327.2329745,365.9422841,-0.0066003830000000005,62886700,-1,0.0
BSESN,6/17/2019,38960.78906,39540.42188,38911.48828,39514.35938,12700,-491.28125,491.28125,0.0,35.06228837,38911.48828,40312.07031,3.520021025,-96.47997897,250.4098067,342.83578860000006,-0.032453669,62874000,-1,-0.2263
BSESN,6/18/2019,39046.33984,39167.82813,38870.96094,39056.98047,17800,85.550781,0.0,85.550781,38.04060553,38870.96094,40312.07031,12.16971515,-87.83028485,194.19160580000002,313.1069521,-0.025875939,62891800,1,-0.6486
BSESN,6/19/2019,39112.73828,39435.80078,38881.05078,39176.55859,18500,66.398437,0.0,66.398437,40.48505888,38870.96094,40312.07031,16.77716815,-83.22283185,153.2297385,281.13150939999997,-0.010548531000000002,62910300,1,0.3182
BSESN,6/20/2019,39601.62891,39638.64063,38933.78125,39042.96094,20100,488.890625,0.0,488.890625,55.4254848,38870.96094,40312.07031,50.7017705,-49.2982295,158.3907215,256.5833518,-0.000360197,62930400,1,0.1779
BSESN,6/21/2019,39194.48828,39617.94922,39121.30078,39608.25,15600,-407.140625,407.140625,0.0,44.65395201,38870.96094,40312.07031,22.44988122,-77.55011878,128.1507498,230.89683140000002,-0.014830673999999999,62914800,-1,0.5106
BSESN,6/24/2019,39122.96094,39300.01953,39021.69922,39160.23047,11600,-71.527343,71.527343,0.0,42.9614751,38870.96094,40312.07031,17.48652839,-82.51347161,97.29217195,204.1758995,-0.020713153,62903200,-1,0.2732
BSESN,6/25/2019,39434.94141,39490.64063,38946.03906,39131.94141,11300,311.98046800000003,0.0,311.98046800000003,52.09868332,38870.96094,40159.26172,43.77708035,-56.22291965,96.89381159,182.7194819,-0.008095900999999999,62914500,1,0.3182
BSESN,6/26/2019,39592.07813,39674.21875,39319.64063,39379.12891,15000,157.136719,0.0,157.136719,56.17841413,38870.96094,40066.30859,60.32698382,-39.67301618,108.0126258,167.77811069999998,-0.00375632,62929500,1,-0.4767
BSESN,6/27/2019,39586.41016,39817.21875,39510.44141,39633.96875,13200,-5.667969,5.667969,0.0,55.97998086,38870.96094,40066.30859,59.85281474,-40.14718526,115.04088870000001,157.23066630000002,0.003405141,62916300,-1,0.0
BSESN,6/28/2019,39394.64063,39675.25,39361.92188,39630.51953,11200,-191.769531,191.769531,0.0,49.1961339,38870.96094,40066.30859,43.80982255,-56.19017745,103.93850079999999,146.5722332,0.011135595,62905100,-1,0.4939
BSESN,7/1/2019,39686.5,39764.82031,39541.08984,39543.73047,10800,291.859375,0.0,291.859375,58.11049925,38870.96094,39982.10156,73.39656598,-26.60343402,117.33779380000001,140.72534530000001,0.016394883,62915900,1,0.0
BSESN,7/2/2019,39816.48047,39838.48828,39499.19141,39811.67969,14800,129.980469,0.0,129.980469,61.57514079999999,38870.96094,39838.48828,97.72535503,-2.274644966,136.8674449,139.95376519999996,0.01799266,62930700,1,0.0
BSESN,7/3/2019,39839.25,39934.98828,39732.37891,39907.57031,13800,22.769531,0.0,22.769531,62.20695431,38870.96094,39934.98828,91.00227249,-8.997727514,152.4250835,142.4480289,0.006000286,62944500,1,-0.5994
BSESN,7/4/2019,39908.05859,39979.10156,39858.32813,39917.64844,14500,68.808594,0.0,68.808594,64.25628846,38870.96094,39979.10156,93.58899336,-6.411006636000001,168.3660832,147.63163980000002,0.018205884,62959000,1,0.0
BSESN,7/5/2019,39513.39063,40032.41016,39441.37891,39990.39844,26000,-394.66796899999997,394.66796899999997,0.0,47.28653653,38870.96094,40032.41016,55.312765899999995,-44.687234100000005,147.453284,147.5959686,0.009979554,62933000,-1,0.0
BSESN,7/8/2019,38720.57031,39476.37891,38605.48047,39476.37891,22000,-792.8203120000001,792.8203120000001,0.0,29.33153509,38605.48047,40032.41016,8.065558174,-91.93444183,66.14330769,131.30543640000002,-0.018115181,62911000,-1,-0.0516
BSESN,7/9/2019,38730.82031,38814.23047,38435.87109,38754.46875,18800,10.25,0.0,10.25,29.72956671,38435.87109,40032.41016,18.47428767,-81.52571233,2.502804264,105.54491000000002,-0.021753286,62929800,1,0.3612
BSESN,7/10/2019,38557.03906,38854.85156,38474.66016,38701.98828,14900,-173.78125,173.78125,0.0,26.77895231,38435.87109,40032.41016,7.589414621,-92.41058538,-61.24940274,72.18604744,-0.026003143,62914900,-1,0.0
BSESN,7/11/2019,38823.10938,38892.5,38631.30859,38751.62109,14600,266.070312,0.0,266.070312,37.701905,38435.87109,40032.41016,24.25485791,-75.74514209,-89.27473203,39.89389155,-0.014507843000000001,62929500,1,0.0
BSESN,7/12/2019,38736.23047,39021.83984,38684.85156,38941.10156,12900,-86.878906,86.878906,0.0,35.695653899999996,38435.87109,40032.41016,18.81315542,-81.18684458,-117.14503400000001,8.486106435,-0.023944403,62916600,-1,-0.4767
BSESN,7/15/2019,38896.71094,39023.96875,38696.60156,39009.94922,18000,160.480469,0.0,160.480469,42.24593988,38435.87109,40032.41016,28.86492758,-71.13507242,-124.8438938,-18.17989361,-0.023100222000000004,62934600,1,-0.8519
BSESN,7/16/2019,39131.03906,39173.89063,38845.26953,38961.85938,25100,234.328125,0.0,234.328125,50.70584514,38435.87109,40032.41016,43.54218356,-56.45781644,-110.7601996,-36.69595481,-0.017776714,62959700,1,0.0
BSESN,7/17/2019,39215.64063,39284.73047,39081.14063,39171.10156,23400,84.601562,0.0,84.601562,53.54086416,38435.87109,40032.41016,48.84124351,-51.15875649,-91.71489929,-47.69974371,-0.01735033,62983100,1,0.0
BSESN,7/18/2019,38897.46094,39204.46875,38861.25,39204.46875,24100,-318.179687,318.179687,0.0,42.84723087,38435.87109,40032.41016,28.91190419,-71.08809581,-101.130039,-58.38580277,-0.015587872,62959000,-1,0.6249
BSESN,7/19/2019,38337.01172,39058.73047,38271.35156,39058.73047,19200,-560.4492190000001,560.4492190000001,0.0,30.47606709,38271.35156,40032.41016,3.72844812,-96.27155188,-152.0622937,-77.12110096,-0.00990581,62939800,-1,0.0
BSESN,7/22/2019,38031.12891,38333.51953,37890.32031,38333.51953,23000,-305.882813,305.882813,0.0,25.78728426,37890.32031,40032.41016,6.57342144,-93.42657856,-214.63448640000001,-104.623778,-0.018065493999999998,62916800,-1,0.0
BSESN,7/23/2019,37982.73828,38217.80859,37898.89844,38138.55859,19300,-48.390625,48.390625,0.0,25.08286314,37890.32031,40032.41016,4.314383372,-95.68561663,-265.0725278,-136.713528,-0.014894836000000002,62897500,-1,0.0
BSESN,7/24/2019,37847.64844,38102.83984,37708.41016,37990.23047,16600,-135.089843,135.089843,0.0,23.05430196,37708.41016,40032.41016,5.991320224,-94.00867978,-312.34514,-171.8398504,-0.025125781,62880900,-1,0.4588
BSESN,7/25/2019,37830.98047,38169.87109,37775.51172,37935.01953,18000,-16.667969,16.667969,0.0,22.79188068,37708.41016,39476.37891,6.932832551000001,-93.06716745,-347.1522367,-206.90232769999997,-0.023369595,62862900,-1,-0.875
BSESN,7/26/2019,37882.78906,37978.07031,37690.46875,37831.17969,24100,51.808594,0.0,51.808594,25.82018727,37690.46875,39284.73047,12.06328363,-87.93671637,-366.33372389999994,-238.78860690000002,-0.026067034,62887000,1,0.5574
BSESN,7/29/2019,37686.37109,38043.21875,37519.16016,38043.21875,21100,-196.417969,196.417969,0.0,22.03879279,37519.16016,39284.73047,9.470647347,-90.52935265,-392.8558812,-269.6020618,-0.036918722,62865900,-1,0.3612
BSESN,7/30/2019,37397.23828,37950.21094,37359.03125,37735.53906,22800,-289.132813,289.132813,0.0,17.64873487,37359.03125,39284.73047,1.98406016,-98.01593984,-432.22308489999995,-302.12626639999996,-0.046369314,62843100,-1,0.7906
BSESN,7/31/2019,37481.12109,37576.37109,37128.26172,37257.55078,27200,83.882813,0.0,83.882813,22.796769199999996,37128.26172,39284.73047,16.36283276,-83.63716724,-451.44920999999994,-331.99085510000003,-0.036412141,62870300,1,0.7506
BSESN,8/1/2019,37018.32031,37387.17969,36694.17969,37387.17969,21000,-462.800781,462.800781,0.0,16.30716053,36694.17969,39284.73047,12.5124212,-87.4875788,-498.2862739,-365.2499389,-0.034397345,62849300,-1,0.6808
BSESN,8/2/2019,37118.21875,37375.16016,36607.41016,36920.10938,28100,99.898437,0.0,99.898437,21.84826511,36607.41016,39284.73047,19.07909903,-80.92090097,-521.3343971,-396.4668305,-0.024004288,62877400,1,-0.2023
BSESN,8/5/2019,36699.83984,36844.05078,36416.78906,36842.17188,25900,-418.37890600000003,418.37890600000003,0.0,16.55248226,36416.78906,39284.73047,9.869475729,-90.13052427,-566.8258662999999,-430.53863770000004,-0.033775828,62851500,-1,-0.3612
BSESN,8/6/2019,36976.85156,37241.76953,36536.58984,36568.03125,25400,277.01171899999997,0.0,277.01171899999997,29.59073238,36416.78906,39204.46875,20.09063317,-79.90936683,-573.9099757,-459.21290530000005,-0.023007952,62876900,1,0.0
BSESN,8/7/2019,36690.5,37104.78906,36610.57031,37025.26953,25300,-286.351563,286.351563,0.0,24.94243363,36416.78906,39058.73047,10.36021981,-89.63978019,-595.762779,-486.52288,-0.030146733,62851600,-1,0.0
BSESN,8/8/2019,37327.35938,37405.48047,36655.41016,36808.01172,24100,636.859375,0.0,636.859375,46.50652011,36416.78906,38333.51953,47.5064349,-52.493565100000005,-555.2910049,-500.276505,-0.014661795,62875700,1,0.5994
BSESN,8/9/2019,37581.91016,37807.55078,37406.26172,37521.30078,27400,254.550781,0.0,254.550781,52.76513283,36416.78906,38217.80859,64.69230749,-35.30769251,-496.94820210000006,-499.6108444,-0.0027718490000000003,62903100,1,-0.8991
BSESN,8/13/2019,36958.16016,37755.16016,36888.48828,37755.16016,28600,-623.75,623.75,0.0,39.64927933,36416.78906,38169.87109,30.88110445,-69.11889555,-495.3326364,-498.7552028,-0.011740924,62874500,-1,0.3818
BSESN,8/14/2019,37311.53125,37473.60938,37000.76953,37233.5,22500,353.37109399999997,0.0,353.37109399999997,48.08480882,36416.78906,38169.87109,51.03823844,-48.96176156,-460.23291629999994,-491.0507455,-0.004524674,62897000,1,0.29600000000000004
BSESN,8/16/2019,37350.32813,37444.44922,36974.41016,37383.0,26100,38.796875,0.0,38.796875,48.98807394,36416.78906,38043.21875,57.39805843,-42.60194157,-424.3934087,-477.71927810000005,0.008968743000000001,62923100,1,0.0
BSESN,8/19/2019,37402.48828,37718.87891,37358.48828,37485.92188,17700,52.160156,0.0,52.160156,50.32872614,36416.78906,38043.21875,60.60509261,-39.39490739,-387.31670610000003,-459.6387637,0.007658491,62940800,1,-0.0516
BSESN,8/20/2019,37328.01172,37511.55078,37219.89844,37441.75,20900,-74.476562,74.476562,0.0,48.24000532,36416.78906,37950.21094,59.4241331,-40.5758669,-359.7952921,-439.6700694,0.017116475,62919900,-1,-0.6486
BSESN,8/21/2019,37060.37109,37406.55078,37022.51953,37298.73047,28500,-267.640625,267.640625,0.0,41.15740461,36416.78906,37807.55078,46.27550663,-53.72449337,-355.4829488,-422.83264529999997,0.002258698,62891400,-1,0.0
BSESN,8/22/2019,36472.92969,37087.57813,36391.35156,37087.57813,33100,-587.4414059999999,587.4414059999999,0.0,30.00179933,36391.35156,37807.55078,5.760356591,-94.23964341,-394.9146672,-417.2490497,-0.005929881,62858300,-1,0.3182
BSESN,8/23/2019,36701.16016,36807.33984,36102.35156,36387.67969,38400,228.23046800000003,0.0,228.23046800000003,37.58560034,36102.35156,37807.55078,35.11663545,-64.88336455,-403.1015925,-414.4195582,-0.016775878,62896700,1,0.0
BSESN,8/26/2019,37494.12109,37544.48047,36492.64844,37363.94922,35600,792.9609379999999,0.0,792.9609379999999,56.48551919,36102.35156,37807.55078,81.61917483,-18.38082517,-341.6659567,-399.86883789999996,-0.002335939,62932300,1,-0.4654
BSESN,8/27/2019,37641.26953,37731.51172,37449.69141,37658.48047,36500,147.148437,0.0,147.148437,59.13510102,36102.35156,37807.55078,90.24857341,-9.751426593,-277.90065780000003,-375.4752019,0.018483317,62968800,1,0.29600000000000004
BSESN,8/28/2019,37451.83984,37687.82031,37249.19141,37655.76953,28600,-189.429687,189.429687,0.0,54.23025402,36102.35156,37807.55078,79.13962584,-20.86037416,-239.8863313,-348.3574278,0.003760462,62940200,-1,0.0
BSESN,8/29/2019,37068.92969,37381.80078,36987.35156,37381.80078,31700,-382.91015600000003,382.91015600000003,0.0,45.43976647,36102.35156,37807.55078,56.68417595,-43.31582405,-237.91481919999998,-326.26890610000004,-0.007534029,62908500,-1,0.4019
BSESN,8/30/2019,37332.78906,37397.96875,36829.80859,37222.26172,33400,263.859375,0.0,263.859375,51.66882267,36102.35156,37807.55078,72.15799109999999,-27.842008899999996,-212.6102962,-303.5371841,-0.001863491,62941900,1,0.6369
BSESN,9/3/2019,36562.91016,37188.37891,36466.01172,37181.76172,23600,-769.878907,769.878907,0.0,37.32312136,36102.35156,37755.16016,27.86521046,-72.13478954,-251.7767474,-293.18509680000005,-0.020496714,62918300,-1,0.0
BSESN,9/4/2019,36724.73828,36776.30859,36409.53906,36575.23828,25600,161.828125,0.0,161.828125,41.27749139,36102.35156,37731.51172,38.20291797,-61.79708203,-266.6840966,-287.88489669999996,-0.00905638,62943900,1,0.0
BSESN,9/5/2019,36644.42188,36898.98828,36541.87891,36821.71094,27400,-80.316406,80.316406,0.0,39.83813892,36102.35156,37731.51172,33.27299099,-66.72700901,-281.7315155,-286.6542205,0.0047019029999999995,62916500,-1,0.0
BSESN,9/6/2019,36981.76953,37012.98047,36727.66016,36785.58984,23000,337.34765600000003,0.0,337.34765600000003,48.53542219,36102.35156,37731.51172,53.97983524,-46.02016476,-263.3992641,-282.00322919999996,0.00764579,62939500,1,-0.5423
BSESN,9/9/2019,37145.44922,37244.07813,36784.46875,36969.48047,25300,163.679688,0.0,163.679688,52.38875803,36102.35156,37731.51172,64.02671046,-35.97328954,-232.97761890000004,-272.1981072,-0.009299375,62964800,1,0.0
BSESN,9/11/2019,37270.82031,37343.46094,37193.57031,37251.03125,36700,125.371094,0.0,125.371094,55.34378144,36102.35156,37731.51172,71.72215363,-28.27784637,-196.48686819999998,-257.05585940000003,-0.009841571,63001500,1,0.0
BSESN,9/12/2019,37104.28125,37435.14844,37048.67188,37330.46875,27500,-166.539063,166.539063,0.0,50.53626109,36102.35156,37731.51172,61.4997662,-38.5002338,-178.94324939999998,-241.43333739999997,-0.009280146999999999,62974000,-1,0.0
BSESN,9/13/2019,37384.98828,37413.5,37000.08984,37175.85938,34300,280.70703100000003,0.0,280.70703100000003,57.68503227,36102.35156,37731.51172,78.72993415,-21.27006585,-140.766426,-221.2999551,0.00852624,63008300,1,0.0
BSESN,9/16/2019,37123.30859,37302.05859,37028.94141,37204.55859,19900,-261.679687,261.679687,0.0,49.92401596,36409.53906,37731.51172,53.99276057,-46.00723943,-130.12636640000002,-203.0652374,-0.005611166,62988400,-1,0.0
BSESN,9/17/2019,36481.08984,37169.55859,36419.08984,37169.46094,20500,-642.21875,642.21875,0.0,36.15082555,36409.53906,37731.51172,5.412425187,-94.58757481,-171.5383412,-196.7598581,-0.002237795,62967900,-1,0.0
BSESN,9/18/2019,36563.87891,36712.98828,36465.92188,36621.37891,25400,82.789062,0.0,82.789062,38.66764781,36409.53906,37687.82031,12.0740129,-87.92598709999999,-195.42451210000002,-196.4927889,-0.004380137,62993300,1,0.0
BSESN,9/19/2019,36093.46875,36613.92969,35987.80078,36613.92969,31700,-470.410156,470.410156,0.0,30.72680936,35987.80078,37435.14844,7.300800777999999,-92.69919922,-249.437285,-207.0816881,-0.015035116000000001,62961600,-1,0.5574
BSESN,9/20/2019,38014.62109,38378.01953,36085.73828,36214.92188,61000,1921.152344,0.0,1921.152344,64.79527542,35987.80078,38378.01953,84.79643602,-15.20356398,-135.6580765,-192.7969658,0.027928667999999997,63022600,1,0.0
BSESN,9/23/2019,39090.03125,39441.12109,38674.03906,38844.0,2800,1075.4101560000001,0.0,1075.4101560000001,73.28216997,35987.80078,39441.12109,89.83326734,-10.16673266,40.81884387,-146.0738039,0.052350478,63025400,1,0.0
BSESN,9/24/2019,39097.14063,39306.37109,38913.05859,39135.28125,30600,7.109375,0.0,7.109375,73.33121064,35987.80078,39441.12109,90.03913805,-9.960861948,179.1861949,-81.02180412,0.049001345,63056000,1,0.0
BSESN,9/25/2019,38593.51953,39087.19922,38510.96875,39087.19922,28800,-503.621094,503.621094,0.0,63.76465541,35987.80078,39441.12109,75.45546065,-24.54453935,245.3767537,-15.74209256,0.040136562,63027200,-1,0.4215
BSESN,9/26/2019,38989.73828,39158.07031,38676.10938,38700.48047,33200,396.21875,0.0,396.21875,67.60147189,35987.80078,39441.12109,86.92901984,-13.07098016,326.046331,52.61559215,0.042924983,63060400,1,0.4019
BSESN,9/27/2019,38822.57031,39107.37109,38782.60156,39003.12891,39200,-167.167968,167.167968,0.0,64.28762848,35987.80078,39441.12109,82.08823031,-17.91176969,372.1980271,116.53207909999999,0.045773445,63021200,-1,0.0
BSESN,9/30/2019,38667.32813,38873.12109,38401.08984,38873.12109,49000,-155.242188,155.242188,0.0,61.079330500000005,35987.80078,39441.12109,77.59278321,-22.40721679,391.7311982,171.571903,0.059927987,62972200,-1,0.3182
BSESN,10/1/2019,38305.41016,38923.78125,37929.89063,38813.48047,75400,-361.91796899999997,361.91796899999997,0.0,53.85024629,35987.80078,39441.12109,67.11249363,-32.88750637,373.6998425,211.9974909,0.047629828,62896800,-1,0.1531
BSESN,10/3/2019,38106.87109,38310.92969,37957.55859,38137.87109,59200,-198.539062,198.539062,0.0,50.09718172,35987.80078,39441.12109,61.36327131,-38.63672869,339.47615030000003,237.4932228,0.05578301,62837600,-1,-0.4019
BSESN,10/4/2019,37673.30859,38403.53906,37633.35938,38401.48828,52900,-433.5625,433.5625,0.0,42.61373609,35987.80078,39441.12109,48.80832533,-51.19167467,274.2078599,244.8361502,-0.008978453,62784700,-1,0.128
BSESN,10/7/2019,37531.98047,37919.46875,37480.53125,37853.80078,40400,-141.328125,141.328125,0.0,40.34688439,35987.80078,39441.12109,44.71579663,-55.28420337,208.6728206,237.60348430000005,-0.039858008,62744300,-1,0.0
BSESN,10/9/2019,38177.94922,38209.83984,37415.82813,37628.05078,36400,645.96875,0.0,645.96875,53.41587997,35987.80078,39441.12109,63.42152594,-36.57847406,206.4799371,231.3787748,-0.023510451,62780700,1,0.6249
BSESN,10/10/2019,37880.39844,38130.23047,37802.92969,38130.23047,27300,-297.55078100000003,297.55078100000003,0.0,47.8447779,35987.80078,39441.12109,54.80515809,-45.19484191,178.6725737,220.8375346,-0.018477742,62753400,-1,-0.0296
BSESN,10/11/2019,38127.07813,38345.41016,37737.85156,37994.48047,39400,246.679687,0.0,246.679687,52.57615627,36085.73828,39441.12109,60.83776301,-39.16223699,174.52817480000002,211.57566260000002,-0.022125312999999997,62792800,1,0.0772
BSESN,10/14/2019,38214.46875,38513.69141,38066.12891,38208.23828,28500,87.390625,0.0,87.390625,54.27187056,37415.82813,39441.12109,39.43333815,-60.56666185,176.26354550000002,204.5132392,-0.015663609,62821300,1,0.25
BSESN,10/15/2019,38506.08984,38635.19141,38238.26953,38316.48828,26200,291.62109399999997,0.0,291.62109399999997,59.80566222,37415.82813,39306.37109,57.66923772,-42.33076228,198.8776862,203.38612859999998,-0.0041698840000000004,62847500,1,0.0
BSESN,10/16/2019,38598.98828,38666.37891,38416.67188,38637.05078,27500,92.898437,0.0,92.898437,61.51741478,37415.82813,39158.07031,67.91020009,-32.08979991,221.7396069,207.0568243,0.007664143000000001,62875000,1,-0.34
BSESN,10/17/2019,39052.05859,39104.69141,38557.42969,38647.44141,47100,453.070313,0.0,453.070313,68.95694716,37415.82813,39158.07031,93.91521341,-6.084786589,273.26678230000005,220.2988159,0.024803598,62922100,1,-0.4767
BSESN,10/18/2019,39298.37891,39361.05859,38963.60156,39087.82813,42400,246.320312,0.0,246.320312,72.31445477,37415.82813,39361.05859,96.77777574,-3.222224256,330.17240860000004,242.27353440000002,0.043135852999999995,62964500,1,0.0
BSESN,10/22/2019,38963.83984,39426.46875,38924.85156,39233.39844,54500,-334.539062,334.539062,0.0,61.83411739,37415.82813,39426.46875,76.99096993,-23.00903007,344.30706339999995,262.68024019999996,0.038150382000000004,62910000,-1,0.0
BSESN,10/23/2019,39058.82813,39196.67188,38866.07813,39063.83984,41000,94.988281,0.0,94.988281,63.56413427,37415.82813,39426.46875,81.71524934,-18.28475066,359.03490869999996,281.95117389999996,0.023072976000000002,62951000,1,0.4748
BSESN,10/24/2019,39020.39063,39327.14844,38840.76172,39223.01172,36600,-38.4375,38.4375,0.0,62.24671361,37415.82813,39426.46875,79.8035452,-20.1964548,363.41601360000004,298.2441419,0.030094514,62914400,-1,0.0
BSESN,10/25/2019,39058.05859,39241.60938,38718.26953,39201.67188,48600,37.667969,0.0,37.667969,63.11122661,37415.82813,39426.46875,81.67697641,-18.32302359,365.7118624,311.737686,0.024417829,62963000,1,0.0
BSESN,10/29/2019,39831.83984,39917.01172,39254.12109,39293.48828,50500,773.78125,0.0,773.78125,76.08915922,37415.82813,39917.01172,96.59473718,-3.4052628210000004,425.0690874,334.40396630000004,0.042323527,63013500,1,0.0
BSESN,10/30/2019,40051.87109,40178.12109,39805.10938,40055.62891,37200,220.03125,0.0,220.03125,78.56360081,37415.82813,40178.12109,95.42952173,-4.570478274,484.28229400000004,364.37963179999997,0.040143812,63050700,1,0.0
BSESN,10/31/2019,40129.05078,40392.21875,40054.89063,40211.98828,87900,77.179687,0.0,77.179687,79.42535092,37737.85156,40392.21875,90.08547234,-9.914527662000001,531.3123051,397.7661665,0.039639964,63138600,1,0.0258
BSESN,11/1/2019,40165.03125,40283.30078,40014.23047,40196.07031,57000,35.980469,0.0,35.980469,79.86084522,37737.85156,40392.21875,91.44099200000001,-8.559008003999999,564.9745756,431.2078483,0.028499717999999997,63195600,1,-0.1027
BSESN,11/4/2019,40301.96094,40483.21094,40186.28906,40293.85156,62600,136.929688,0.0,136.929688,81.57350634,38066.12891,40483.21094,92.50128884,-7.498711157000001,595.8328586,464.1328504,0.025537492000000002,63258200,1,0.0
BSESN,11/5/2019,40248.23047,40466.55078,40053.55078,40445.67188,45400,-53.73046899999999,53.73046899999999,0.0,78.5490853,38238.26953,40483.21094,89.53289078,-10.46710922,608.9332668,493.0929337,0.032963656,63212800,-1,-0.29600000000000004
BSESN,11/6/2019,40469.78125,40606.91016,40037.53125,40311.85156,37700,221.550781,0.0,221.550781,81.76559759,38416.67188,40606.91016,93.73908733,-6.260912668,629.9312755,520.460602,0.036123796,63250500,1,0.0
BSESN,11/7/2019,40653.73828,40688.26953,40421.07031,40625.64063,30200,183.957031,0.0,183.957031,84.05607335,38557.42969,40688.26953,98.37945352,-1.620546477,653.8786378,547.1442092,0.041858823999999996,63280700,1,0.0
BSESN,11/8/2019,40323.60938,40749.32813,40263.94141,40630.55859,42600,-330.12890600000003,330.12890600000003,0.0,66.70559365,38718.26953,40749.32813,79.03956335,-20.96043665,638.8541384,565.4861950000001,0.032401783999999996,63238100,-1,-0.4019
BSESN,11/11/2019,40345.07813,40417.44141,40150.96875,40316.5,29500,21.46875,0.0,21.46875,67.21341353,38718.26953,40749.32813,80.09658603,-19.90341397,621.5150247,576.691961,0.012885126,63267600,1,-0.3818
BSESN,11/13/2019,40116.05859,40447.17188,40061.23047,40346.42969,37700,-229.019531,229.019531,0.0,56.58942942,38718.26953,40749.32813,68.82071581,-31.17928419,582.5780925,577.8691873,0.0016026089999999998,63229900,-1,0.3612
BSESN,11/14/2019,40286.48047,40348.60938,40026.98828,40178.92969,27800,170.421875,0.0,170.421875,61.77692572,38718.26953,40749.32813,77.21150648,-22.78849352,559.0277897999999,574.1009078,0.003923085,63257700,1,0.0
BSESN,11/15/2019,40356.69141,40650.05859,40308.08984,40408.19922,25800,70.210937,0.0,70.210937,63.83149235,38718.26953,40749.32813,80.66837066,-19.33162934,539.8068834,567.2421029,0.004771816,63283500,1,0.0
BSESN,11/18/2019,40284.19141,40542.39844,40221.96875,40431.07813,28700,-72.5,72.5,0.0,59.98954566,39254.12109,40749.32813,68.89148396,-31.10851604,512.8126474999999,556.3562118,-0.00044091,63254800,-1,0.0258
BSESN,11/19/2019,40469.69922,40544.12891,40290.21094,40455.35938,39100,185.507813,0.0,185.507813,66.02662797,39805.10938,40749.32813,70.38515641,-29.61484359,500.6176426,545.2084980000001,0.0055025709999999995,63293900,1,0.7506
BSESN,11/20/2019,40651.64063,40816.37891,40575.96094,40729.80078,32300,181.941406,0.0,181.941406,70.98163038,40014.23047,40816.37891,79.46286829,-20.53713171,499.8719516,536.1411887,0.004493708,63326200,1,0.0
BSESN,11/21/2019,40575.17188,40744.85156,40534.12109,40737.30859,21800,-76.46875,76.46875,0.0,66.29272532,40014.23047,40816.37891,69.92987583,-30.07012417,487.49110310000003,526.4111716,-0.001932575,63304400,-1,0.0
BSESN,11/22/2019,40359.41016,40653.17188,40276.82813,40653.17188,21700,-215.761719,215.761719,0.0,54.55912757,40026.98828,40816.37891,42.11120128,-57.88879872,455.02379289999993,512.1336958,0.0008878369999999999,63282700,-1,0.0
BSESN,11/25/2019,40889.23047,40931.71094,40393.89844,40439.66016,28600,529.8203129999999,0.0,529.8203129999999,69.7362673,40026.98828,40931.71094,95.30458659,-4.695413414,466.6658535,503.0401274,0.013487453,63311300,1,0.0
BSESN,11/26/2019,40821.30078,41120.28125,40710.19922,41022.85156,32800,-67.929688,67.929688,0.0,66.45277996,40026.98828,41120.28125,72.65321579,-27.34678421,465.05010419999996,495.4421228,0.017580046999999998,63278500,-1,0.0
BSESN,11/27/2019,41020.60938,41075.76172,40848.69922,40979.39063,32400,199.308594,0.0,199.308594,71.06504058,40026.98828,41120.28125,90.88333339,-9.116666605,474.38374860000005,491.23044789999994,0.018222711000000003,63310900,1,-0.836
BSESN,11/28/2019,41130.17188,41163.78906,40996.07813,41161.53906,30900,109.5625,0.0,109.5625,73.38591998,40026.98828,41163.78906,97.04282505,-2.9571749539999996,485.0303788,489.9904341,0.019166102,63341800,1,0.0
BSESN,11/29/2019,40793.80859,41143.21875,40664.17969,41138.26172,46700,-336.36328100000003,336.36328100000003,0.0,57.14814878,40026.98828,41163.78906,67.4542387,-32.5457613,461.0119455,484.1947364,0.01265055,63295100,-1,0.0
BSESN,12/2/2019,40802.17188,41093.98828,40707.62891,41072.94141,39800,8.363281,0.0,8.363281,57.41845195,40026.98828,41163.78906,68.18992442,-31.81007558,437.60754360000004,474.8772978,0.008215348,63334900,1,-0.6908
BSESN,12/3/2019,40675.44922,40885.03125,40554.03906,40852.60938,33700,-126.722656,126.722656,0.0,51.71516826,40026.98828,41163.78906,57.04261892,-42.95738108,404.17485110000007,460.7368085,0.000585674,63301200,-1,-0.8481
BSESN,12/4/2019,40850.28906,40886.87109,40475.82813,40606.01172,44500,174.839844,0.0,174.839844,58.30784641,40221.96875,41163.78906,66.71339579,-33.28660421,387.32250289999996,446.05394739999997,0.006780431999999999,63345700,1,-0.5859
BSESN,12/5/2019,40779.58984,41002.41016,40720.17188,40988.14063,33000,-70.699219,70.699219,0.0,54.81580745,40221.96875,41163.78906,59.20673894,-40.79326106,364.0653408,429.65622609999997,0.010410947,63312700,-1,-0.5106
BSESN,12/6/2019,40445.14844,40952.12891,40337.53125,40952.12891,33100,-334.44140600000003,334.44140600000003,0.0,41.31140491,40276.82813,41163.78906,18.9771957,-81.02280429999999,315.0159383,406.7281685,-0.010860611000000001,63279600,-1,-0.6705
BSESN,12/9/2019,40487.42969,40645.62891,40336.55859,40527.23828,32600,42.28125,0.0,42.28125,43.34734734,40276.82813,41163.78906,23.74417564,-76.25582436,276.36985719999996,380.65650619999997,-0.008178845,63312200,1,0.1027
BSESN,12/10/2019,40239.87891,40588.80859,40208.69922,40588.80859,31400,-247.55078199999997,247.55078199999997,0.0,35.11737744,40208.69922,41163.78906,3.264581567,-96.73541843,223.1944338,349.1640917,-0.019032639,63280800,-1,0.0
BSESN,12/11/2019,40412.57031,40466.12891,40135.37109,40285.19922,55500,172.691407,0.0,172.691407,43.71850997,40135.37109,41163.78906,26.95394551,-73.04605449,192.76520359999998,317.88431410000004,-0.017447083999999998,63336300,1,-0.29600000000000004
BSESN,12/12/2019,40581.71094,40712.64844,40490.69141,40561.33984,41300,169.140625,0.0,169.140625,51.05165635,40135.37109,41163.78906,43.40062673,-56.59937327,180.2205837,290.35156800000004,-0.005199261,63377600,1,0.0
BSESN,12/13/2019,41009.71094,41055.80078,40736.69922,40754.82031,27900,428.0,0.0,428.0,64.54109399,40135.37109,41163.78906,85.01794702,-14.98205298,202.480832,272.7774208,0.0050864709999999995,63405500,1,-0.2263
BSESN,12/16/2019,40938.71875,41185.03125,40917.92969,41168.85156,21600,-70.992188,70.992188,0.0,61.30750947,40135.37109,41185.03125,76.53407166,-23.46592834,211.95052919999998,260.6120425,0.0064724430000000005,63383900,-1,-0.2263
BSESN,12/17/2019,41352.17188,41401.64844,41005.17969,41052.35938,19000,413.453125,0.0,413.453125,71.05319098,40135.37109,41401.64844,96.09275462,-3.9072453780000003,249.9364326,258.4769205,0.012285906000000001,63402900,1,0.0
BSESN,12/18/2019,41558.57031,41614.76953,41358.46875,41442.75,24300,206.398438,0.0,206.398438,74.7207547,40135.37109,41614.76953,96.20121148,-3.798788521,293.31402230000003,265.4443409,0.019102214,63427200,1,0.0
BSESN,12/19/2019,41673.92188,41719.28906,41456.39844,41571.82031,33300,115.35156200000002,0.0,115.35156200000002,76.63015825,40135.37109,41719.28906,97.13576152,-2.8642384830000003,333.1585374,278.98718019999995,0.030381232,63460500,1,0.5267
BSESN,12/20/2019,41681.53906,41809.96094,41636.10938,41746.19922,33600,7.6171880000000005,0.0,7.6171880000000005,76.76388437,40135.37109,41809.96094,92.33114452,-7.668855478999999,361.1867106,295.4270863,0.029493336000000002,63494100,1,-0.5994
BSESN,12/23/2019,41642.66016,41701.62109,41474.60938,41548.26172,6200,-38.878907,38.878907,0.0,74.2612912,40135.37109,41809.96094,90.00944723,-9.990552767,375.92856639999997,311.52738230000006,0.034860474,63487900,-1,-0.29600000000000004
BSESN,12/24/2019,41461.26172,41702.98047,41423.07031,41684.51172,4400,-181.398437,181.398437,0.0,63.17370389,40135.37109,41809.96094,79.17703728,-20.82296272,368.7238366,322.96667310000004,0.025949634,63483500,-1,0.0
BSESN,12/26/2019,41163.76172,41543.80078,41132.89063,41543.80078,5600,-297.5,297.5,0.0,49.25681353,40135.37109,41809.96094,61.41149301,-38.58850699,335.14493039999996,325.40232460000004,0.014342687,63477900,-1,-0.8074
BSESN,12/27/2019,41575.14063,41611.26953,41264.92188,41297.07813,6100,411.37890600000003,0.0,411.37890600000003,62.45380087,40135.37109,41809.96094,85.97744314,-14.02255686,337.83390610000004,327.8886409,0.013787701999999999,63484000,1,0.0
BSESN,12/30/2019,41558.0,41714.73047,41453.37891,41686.26953,5700,-17.140625,17.140625,0.0,61.68255657,40135.37109,41809.96094,84.95387161,-15.04612839,334.72335110000006,329.255583,0.015127031,63478300,-1,0.0
BSESN,12/31/2019,41253.73828,41607.48828,41184.73047,41607.48828,5600,-304.26171899999997,304.26171899999997,0.0,49.23061838,40135.37109,41809.96094,66.78454375,-33.21545625,304.20020530000005,324.2445074,-0.002380373,63472700,-1,-0.6249
BSESN,1/2/2020,41626.64063,41649.28906,41328.44922,41340.26953,5300,372.90234399999997,0.0,372.90234399999997,60.50539751,40490.69141,41809.96094,86.10440789,-13.89559211,306.5665863,320.70892319999996,0.0016379370000000001,63478000,1,-0.3182
BSESN,1/3/2020,41464.60938,41636.17969,41348.67969,41634.51172,8900,-162.03125,162.03125,0.0,54.44356038,40736.69922,41809.96094,67.82224159,-32.17775841,292.00138239999995,314.9674151,-0.005022625,63469100,-1,-0.4215
BSESN,1/6/2020,40676.62891,41378.33984,40613.96094,41378.33984,8700,-787.9804690000001,787.9804690000001,0.0,34.85103544,40613.96094,41809.96094,5.239796656,-94.76020334,214.4034059,294.85461319999996,-0.024109237999999998,63460400,-1,0.0
BSESN,1/7/2020,40869.46875,41230.14063,40727.37109,40983.03906,11900,192.839844,0.0,192.839844,40.86068823,40613.96094,41809.96094,21.36352943,-78.63647057,166.54716230000002,269.193123,-0.018567291,63472300,1,0.0
BSESN,1/8/2020,40817.73828,40866.35938,40476.55078,40574.82813,18200,-51.730469,51.730469,0.0,39.72641218,40476.55078,41809.96094,25.5875882,-74.4124118,123.0283338,239.96016519999998,-0.015521077,63454100,-1,-0.8402
BSESN,1/9/2020,41452.35156,41482.12109,41175.71875,41216.67188,7800,634.613282,0.0,634.613282,56.72915838,40476.55078,41809.96094,73.18084213,-26.81915787,138.1547747,219.5990871,0.007010774,63461900,1,0.1531
BSESN,1/10/2020,41599.71875,41775.10938,41447.80078,41568.19922,13200,147.367187,0.0,147.367187,59.7699206,40476.55078,41809.96094,84.23274437,-15.76725563,160.18734840000002,207.71673940000002,0.000591174,63475100,1,-0.3612
BSESN,1/13/2020,41859.69141,41899.62891,41720.76172,41788.21094,10600,259.97265600000003,0.0,259.97265600000003,64.80435648,40476.55078,41899.62891,97.19358345,-2.8064165489999997,196.362399,205.44587130000002,0.007259526999999999,63485700,1,0.0
BSESN,1/14/2020,41952.62891,41994.26172,41770.89844,41883.08984,14100,92.9375,0.0,92.9375,66.53194995,40476.55078,41994.26172,97.25686809,-2.743131907,229.88074459999999,210.33284590000002,0.016941268,63499800,1,-0.128
BSESN,1/15/2020,41872.73047,41969.85938,41648.10938,41969.85938,6100,-79.898437,79.898437,0.0,63.44285968,40476.55078,41994.26172,91.99246398,-8.007536017,247.14816859999996,217.6959105,0.005911835,63493700,-1,0.0
BSESN,1/16/2020,41932.55859,42059.44922,41812.28125,41924.73828,6600,59.828125,0.0,59.828125,64.85281675,40476.55078,42059.44922,91.98365341,-8.016346593,262.63288769999997,226.6833059,0.011285508999999999,63500300,1,0.2755
BSESN,1/17/2020,41945.37109,42063.92969,41850.28906,41929.01953,9500,12.8125,0.0,12.8125,65.18462043,40476.55078,42063.92969,92.5311724,-7.468827605,272.7939026,235.9054253,0.031190937000000002,63509800,1,-0.6705
BSESN,1/20/2020,41528.91016,42273.87109,41503.37109,42263.0,7500,-416.460938,416.460938,0.0,48.14006587,40476.55078,42273.87109,58.55157633,-41.44842367,244.42409410000002,237.60915899999998,0.016135306999999998,63502300,-1,0.0
BSESN,1/21/2020,41323.80859,41532.58984,41294.30078,41487.57031,8900,-205.101562,205.101562,0.0,41.91239572,40476.55078,42273.87109,47.14005661,-52.85994339,203.05019819999998,230.69736690000002,0.012398293999999999,63493400,-1,0.0
BSESN,1/22/2020,41115.37891,41532.28906,41059.03906,41467.12891,7700,-208.429688,208.429688,0.0,36.39207557,40476.55078,42273.87109,35.54336533,-64.45663467,151.6939207,214.8966776,-0.008129157,63485700,-1,0.0
BSESN,1/23/2020,41386.39844,41413.96094,41098.91016,41191.5,9900,271.01953199999997,0.0,271.01953199999997,46.88765007,40476.55078,42273.87109,50.62245446,-49.37754554,131.34860700000002,198.1870635,-0.005127927,63495600,1,-0.3612
BSESN,1/24/2020,41613.19141,41697.03125,41275.60156,41377.03906,6600,226.79296800000003,0.0,226.79296800000003,54.18665843,40476.55078,42273.87109,63.24084899,-36.75915101,132.0034429,184.95033940000002,-0.00588872,63502200,1,-0.7652
BSESN,1/27/2020,41155.12109,41516.26953,41122.48047,41510.67969,7000,-458.070312,458.070312,0.0,41.04204533,40476.55078,42273.87109,37.7545565,-62.24544350000001,94.47095673,166.8544628,-0.019009722,63495200,-1,0.0
BSESN,1/28/2020,40966.85938,41333.25,40869.75,41299.67969,9800,-188.261719,188.261719,0.0,36.80782568,40869.75,42273.87109,6.916025649,-93.08397435,48.97054179,143.27767859999997,-0.021633915,63485400,-1,0.0
BSESN,1/29/2020,41198.66016,41334.85938,41108.19141,41131.57031,7800,231.800781,0.0,231.800781,44.88590072,40869.75,42273.87109,23.42462893,-76.57537107,31.25523008,120.8731889,-0.017501876,63493200,1,0.0
BSESN,1/30/2020,40913.82031,41380.14063,40829.91016,41380.14063,6700,-284.83984300000003,284.83984300000003,0.0,37.99864184,40829.91016,42273.87109,5.811109899,-94.1888901,-5.70273927,95.55800328,-0.02459272,63486500,-1,0.0
BSESN,1/31/2020,40723.48828,41154.48828,40671.01172,41146.55859,11500,-190.332032,190.332032,0.0,33.9788448,40671.01172,42273.87109,3.273934246,-96.72606575,-49.77660682,66.49108126,-0.019394245,63475000,-1,0.0
BSESN,2/3/2020,39872.30859,40014.89844,39563.07031,39701.01953,10600,-851.179687,851.179687,0.0,21.98032924,39563.07031,42273.87109,11.40763582,-88.59236418,-151.64053380000001,22.86475824,-0.03512503,63464400,-1,0.0
BSESN,2/4/2020,40789.37891,40818.94141,40117.46094,40178.73828,15300,917.070312,0.0,917.070312,45.78140012,39563.07031,42273.87109,45.2378722,-54.762127799999995,-156.5637505,-13.02094352,-0.007928906999999999,63479700,1,-0.3182
BSESN,2/5/2020,41142.66016,41177.0,40703.32031,40921.71094,13900,353.28125,0.0,353.28125,52.25552887,39563.07031,42273.87109,58.27022974,-41.72977026,-130.4547893,-36.50771267,-0.005889333,63493600,1,0.0
BSESN,2/6/2020,41306.03125,41405.42969,41113.10938,41209.12891,15000,163.371094,0.0,163.371094,55.11531621,39563.07031,42273.87109,64.29690257,-35.70309743,-95.47993416,-48.30215697,-0.007381316999999999,63508600,1,0.5106
BSESN,2/7/2020,41141.85156,41394.41016,41073.35938,41394.41016,15300,-164.179687,164.179687,0.0,51.5358967,39563.07031,41697.03125,73.98360591,-26.01639409,-80.08684682,-54.65909494,-0.000322427,63493300,-1,0.0772
BSESN,2/10/2020,40979.62109,41172.05859,40798.98047,41166.71875,15200,-162.230469,162.230469,0.0,47.98295412,39563.07031,41697.03125,66.3812892,-33.618710799999995,-80.05552696,-59.73838134,0.00031151299999999997,63478100,-1,-0.5994
BSESN,2/11/2020,41216.14063,41444.33984,41179.14063,41183.39063,7700,236.519531,0.0,236.519531,53.38866022,39563.07031,41697.03125,77.46488154,-22.53511846,-60.25102001,-59.84090907,0.00042429699999999997,63485800,1,0.1027
BSESN,2/12/2020,41565.89844,41671.85938,41330.85156,41330.85156,9600,349.757813,0.0,349.757813,60.40890947,39563.07031,41697.03125,93.85495724,-6.145042757000001,-16.14713894,-51.10215505,0.015937845,63495400,1,0.0
BSESN,2/13/2020,41459.78906,41709.30078,41338.30859,41707.21094,9100,-106.109375,106.109375,0.0,57.38351286,39563.07031,41709.30078,88.37442103,-11.62557897,10.12663128,-38.85639778,0.018080494,63486300,-1,-0.29600000000000004
BSESN,2/14/2020,41257.73828,41702.35938,41183.12891,41510.19141,9800,-202.050782,202.050782,0.0,51.69516755,39563.07031,41709.30078,78.96020457,-21.03979543,14.47807969,-28.18950229,0.034746663,63476500,-1,0.0
BSESN,2/17/2020,41055.69141,41420.33984,41030.57813,41324.03906,6900,-202.046875,202.046875,0.0,46.38930279,39563.07031,41709.30078,69.54617015,-30.45382985,1.6046423490000001,-22.23067336,0.006528966999999999,63469600,-1,-0.7269
BSESN,2/18/2020,40894.37891,41042.46094,40610.94922,41042.46094,12300,-161.3125,161.3125,0.0,42.38200584,39563.07031,41709.30078,62.03008544,-37.96991456,-21.367904199999998,-22.05811953,-0.006034643,63457300,-1,-0.3182
BSESN,2/19/2020,41323.0,41357.16016,41048.92969,41121.51172,5600,428.621094,0.0,428.621094,54.44649428,39563.07031,41709.30078,82.00096463,-17.99903537,-4.930833121,-18.63266225,0.000410806,63462900,1,0.1531
BSESN,2/20/2020,41170.12109,41399.92969,41134.30859,41334.96094,8400,-152.878906,152.878906,0.0,50.12689451,39563.07031,41709.30078,74.87782906,-25.12217094,-4.192062435,-15.74454228,0.000687123,63454500,-1,0.0
BSESN,2/24/2020,40363.23047,41037.01172,40306.35938,41037.01172,8100,-806.890625,806.890625,0.0,33.7974216,40117.46094,41709.30078,15.43933783,-84.56066217,-67.93282401,-26.18219863,-0.015041394,63446400,-1,0.0
BSESN,2/25/2020,40281.19922,40536.0,40220.58984,40497.71875,7300,-82.03125,82.03125,0.0,32.55344865,40220.58984,41709.30078,4.071265515,-95.92873448,-123.64180729999998,-45.67412036,-0.022683866,63439100,-1,0.3182
BSESN,2/26/2020,39888.96094,40255.39063,39760.39063,40194.89063,9000,-392.23828100000003,392.23828100000003,0.0,27.05864722,39760.39063,41709.30078,6.597036431,-93.40296357,-197.16908659999999,-75.97311362,-0.04034407,63430100,-1,0.128
BSESN,2/27/2020,39745.66016,39947.80078,39423.26953,39947.80078,9600,-143.300782,143.300782,0.0,25.26120263,39423.26953,41709.30078,14.10263421,-85.89736579,-263.9603897,-113.5705688,-0.041344371,63420500,-1,0.0
BSESN,2/28/2020,38297.28906,39087.46875,38219.96875,39087.46875,12700,-1448.371093,1448.371093,0.0,14.23413975,38219.96875,41709.30078,2.215905861,-97.78409414,-428.8212369,-176.6207024,-0.071755005,63407800,-1,0.5574
BSESN,3/2/2020,38144.01953,39083.17188,37785.98828,38910.94922,13400,-153.269532,153.269532,0.0,13.51384751,37785.98828,41709.30078,9.125738773,-90.87426123,-565.325496,-254.3616611,-0.070920055,63394400,-1,0.2263
BSESN,3/3/2020,38623.69922,38754.23828,38142.30078,38480.89063,10600,479.679688,0.0,479.679688,26.87611518,37785.98828,41709.30078,21.35213389,-78.64786611,-627.5657752000001,-329.002484,-0.055525472,63405000,1,0.0
BSESN,3/4/2020,38409.48047,38791.69922,37846.10156,38715.71875,15300,-214.21875,214.21875,0.0,24.89419679,37785.98828,41709.30078,15.89198383,-84.10801617,-686.2664552,-400.45527819999995,-0.070506002,63389700,-1,0.0
BSESN,3/5/2020,38470.60938,38887.80078,38386.67969,38604.25,13500,61.12890600000001,0.0,61.12890600000001,26.67456956,37785.98828,41702.35938,17.48100672,-82.51899328,-719.5599361000001,-464.2762098,-0.06556968099999999,63403200,1,-0.5574
BSESN,3/6/2020,37576.62109,37747.07031,37011.08984,37613.96094,19000,-893.988281,893.988281,0.0,19.05313152,37011.08984,41420.33984,12.82601916,-87.17398084,-808.7597634,-533.1729205,-0.069038314,63384200,-1,0.4019
BSESN,3/9/2020,35634.94922,36950.19922,35109.17969,36950.19922,18800,-1941.671875,1941.671875,0.0,11.10302719,35109.17969,41399.92969,8.357819512999999,-91.64218049,-1024.320236,-631.4023837,-0.115345374,63365400,-1,0.0
BSESN,3/11/2020,35697.39844,36021.51172,35261.92188,35468.89844,27900,62.44921899999999,0.0,62.44921899999999,12.45858826,35109.17969,41399.92969,9.350534515,-90.64946549,-1176.551777,-740.4322624,-0.10508076400000001,63393300,1,-0.6249
BSESN,3/12/2020,32778.14063,34472.5,32493.09961,34472.5,25200,-2919.2578129999997,2919.2578129999997,0.0,6.836062274,32493.09961,41399.92969,3.200252093,-96.79974791,-1515.288773,-895.4035644999999,-0.17530264899999998,63368100,-1,0.3612
BSESN,3/13/2020,34103.48047,34769.48047,29388.9707,31214.13086,32600,1325.3398439999999,0.0,1325.3398439999999,24.649624300000003,29388.9707,41037.01172,40.47470093,-59.52529907,-1657.687642,-1047.86038,-0.10950667,63400700,1,0.1285
BSESN,3/16/2020,31390.070310000003,33103.23828,31276.30078,33103.23828,18100,-2713.410156,2713.410156,0.0,16.97996803,29388.9707,40536.0,17.95186463,-82.04813537,-1966.8170519999999,-1231.651714,-0.177064434,63382600,-1,-0.5267
BSESN,3/17/2020,30579.089839999997,32047.98047,30394.93945,31611.570310000003,21500,-810.9804690000001,810.9804690000001,0.0,15.33453893,29388.9707,40255.39063,10.95226532,-89.04773468,-2251.292188,-1435.579809,-0.20828169100000002,63361100,-1,0.0
BSESN,3/18/2020,28869.50977,31101.76953,28613.05078,30968.839839999997,31300,-1709.5800780000002,1709.5800780000002,0.0,12.40954415,28613.05078,39947.80078,2.262590573,-97.73740943,-2584.892574,-1665.442362,-0.24837541600000002,63329800,-1,-0.7351
BSESN,3/19/2020,28288.23047,29370.5293,26714.46094,27773.35938,33200,-581.2792969999999,581.2792969999999,0.0,11.54554721,26714.46094,39087.46875,12.71937717,-87.28062283,-2863.1727920000003,-1904.988448,-0.26467942899999997,63296600,-1,0.0
BSESN,3/20/2020,29915.960939999997,30418.19922,27932.66992,28460.820310000003,32100,1627.7304689999999,0.0,1627.7304689999999,27.78982234,26714.46094,39083.17188,25.88386143,-74.11613857,-2918.722409,-2107.73524,-0.203867722,63328700,1,-0.2732
BSESN,3/23/2020,25981.24023,27900.83008,25880.83008,27608.80078,21800,-3934.720704,3934.720704,0.0,18.37678911,25880.83008,38887.80078,0.771971878,-99.22802812,-3242.863248,-2334.760842,-0.27090564699999997,63306900,-1,0.0
BSESN,3/24/2020,26674.0293,27462.86914,25638.90039,27056.23047,24700,692.7890629999999,0.0,692.7890629999999,23.63200123,25638.90039,38887.80078,7.8129420220000005,-92.18705798,-3404.5988159999997,-2548.728437,-0.252773858,63331600,1,0.0
BSESN,3/25/2020,28535.7793,28790.18945,26359.91016,26499.81055,141500,1861.75,0.0,1861.75,36.34083648,25638.90039,38887.80078,21.86505159,-78.13494841,-3344.0002,-2707.782789,-0.12942654,63473100,1,-0.2023
BSESN,3/26/2020,29946.76953,30099.910160000003,28566.339839999997,29073.710939999997,35000,1410.9902339999999,0.0,1410.9902339999999,44.42807632,25638.90039,37747.07031,35.57820189,-64.42179811,-3145.856762,-2795.397584,-0.12188524099999999,63508100,1,0.34
BSESN,3/27/2020,29815.589839999997,31126.0293,29346.99023,30747.81055,116900,-131.179687,131.179687,0.0,43.83075388,25638.90039,36950.19922,36.92493246,-63.07506754,-2965.2304329999997,-2829.364154,-0.050158552,63391200,-1,-0.5267
BSESN,3/30/2020,28440.320310000003,29497.570310000003,28290.99023,29226.55078,23200,-1375.2695310000001,1375.2695310000001,0.0,37.69941811,25638.90039,36021.51172,26.98184333,-73.01815667,-2899.63039,-2843.417401,-0.069942223,63368000,-1,-0.7506
BSESN,3/31/2020,29468.49023,29770.88086,28667.35938,29294.93945,26400,1028.1699210000002,0.0,1028.1699210000002,44.40776172,25638.90039,34769.48047,41.94245941,-58.05754059,-2733.1708710000003,-2821.368095,0.020747856999999998,63394400,1,-0.5994
BSESN,4/1/2020,28265.31055,29505.98047,28073.429689999997,29505.33008,18000,-1203.1796869999998,1203.1796869999998,0.0,38.77084106,25638.90039,34769.48047,28.76498682,-71.23501318,-2667.586768,-2790.611829,-0.0008102280000000001,63376400,-1,0.0
BSESN,4/3/2020,27590.94922,28639.11914,27500.789060000003,28623.5293,18900,-674.3613280000001,674.3613280000001,0.0,35.82957214,25638.90039,33103.23828,26.15166753,-73.84833247,-2639.598568,-2760.409177,-0.077718103,63357500,-1,-0.3612
BSESN,4/7/2020,30067.210939999997,30157.65039,28602.31055,28898.35938,21900,2476.261719,0.0,2476.261719,51.43850881,25638.90039,32047.98047,69.09432388,-30.90567612,-2390.0530489999996,-2686.337952,0.157266192,63379400,1,0.765
BSESN,4/8/2020,29893.960939999997,31227.9707,29602.93945,29701.91992,24700,-173.25,173.25,0.0,50.44789129,25638.90039,31227.9707,76.1318128,-23.8681872,-2181.123618,-2585.295085,0.120714108,63354700,-1,0.1779
BSESN,4/9/2020,31159.61914,31225.19922,30420.2207,30571.18945,18800,1265.658203,0.0,1265.658203,57.36843224,25638.90039,31227.9707,98.77704952,-1.2229504759999998,-1891.612173,-2446.558502,0.091949122,63373500,1,-0.5106
BSESN,4/13/2020,30690.01953,31195.7207,30474.15039,31195.7207,16100,-469.59961,469.59961,0.0,54.13182664,25638.90039,31227.9707,90.37494356,-9.62505644,-1680.6910690000002,-2293.385016,0.024819037999999998,63357400,-1,-0.4215
BSESN,4/15/2020,30379.81055,31568.35938,30222.070310000003,31277.10938,23600,-310.208984,310.208984,0.0,51.90000863,25638.90039,31568.35938,79.95518931,-20.04481069,-1521.032334,-2138.914479,0.018923681,63333800,-1,0.0
BSESN,4/16/2020,30602.60938,30800.19922,30016.16992,30095.50977,16900,222.798828,0.0,222.798828,53.48916513,25638.90039,31568.35938,83.71267931,-16.28732069,-1360.836754,-1983.298934,0.076028998,63350700,1,0.0
BSESN,4/17/2020,31588.7207,31718.73047,30960.93945,31656.679689999997,22200,986.111328,0.0,986.111328,60.20382417,26359.91016,31718.73047,97.57391070000001,-2.426089296,-1141.155133,-1814.870174,0.07194907,63372900,1,0.0
BSESN,4/20/2020,31648.0,32056.4707,31490.25977,32056.18945,17200,59.279297,0.0,59.279297,60.5983804,27500.789060000003,32056.4707,91.03381809,-8.966181908,-951.3064534,-1642.15743,0.11967635900000001,63390100,1,0.4215
BSESN,4/21/2020,30636.710939999997,30900.11914,30378.25977,30836.18945,19700,-1011.289062,1011.289062,0.0,50.70321161,27500.789060000003,32056.4707,68.83540429,-31.16459571,-872.3961429999999,-1488.205173,0.110389885,63370400,-1,0.0
BSESN,4/22/2020,31379.55078,31471.14063,30578.55078,30856.14063,21000,742.839843,0.0,742.839843,56.696352100000006,27500.789060000003,32056.4707,85.14119345,-14.85880655,-741.3721102000001,-1338.83856,0.043646877,63391400,1,0.5574
BSESN,4/23/2020,31863.08008,31959.01953,31292.91992,31646.44922,24400,483.529297,0.0,483.529297,60.31951847,27500.789060000003,32056.4707,95.75495743,-4.245042571,-591.6971307,-1189.410274,0.065870132,63415800,1,-0.3818
BSESN,4/24/2020,31327.2207,31842.24023,31278.26953,31426.61914,17600,-535.859375,535.859375,0.0,54.48971061,27500.789060000003,32056.4707,83.99251621,-16.00748379,-510.4340385,-1053.615027,0.005378806999999999,63398200,-1,0.0
BSESN,4/27/2020,31743.08008,32103.69922,31651.58008,31659.039060000003,12900,415.859375,0.0,415.859375,58.11466033,27500.789060000003,32103.69922,92.16540995,-7.834590048,-407.7754943,-924.4471205,0.034312801000000004,63411100,1,0.3612
BSESN,4/28/2020,32114.51953,32199.910160000003,31661.339839999997,32101.910160000003,15600,371.43945299999996,0.0,371.43945299999996,61.29212792,28602.31055,32199.910160000003,97.62645557,-2.373544426,-293.0674991,-798.1711962,0.057100717999999995,63426700,1,0.25
BSESN,4/29/2020,32720.160160000003,32897.58984,32171.65039,32311.039060000003,16000,605.640625,0.0,605.640625,66.12663601,29602.93945,32897.58984,94.61461257,-5.385387429,-151.54354980000002,-668.8456669,0.069195105,63442700,1,0.5859
BSESN,4/30/2020,33717.62109,33887.25,33354.92969,33381.19141,21100,997.460938,0.0,997.460938,72.62417645,30016.16992,33887.25,95.61804709,-4.381952907,40.633562700000006,-526.949821,0.067394321,63463800,1,-0.6486
BSESN,5/4/2020,31715.34961,32748.14063,31632.01953,32748.14063,18300,-2002.2714850000002,2002.2714850000002,0.0,50.28368467,30016.16992,33887.25,43.89420143,-56.10579857,31.01125535,-415.3576057,0.002128084,63445500,-1,0.0
BSESN,5/5/2020,31453.50977,32264.0,31403.570310000003,32182.90039,19200,-261.83984300000003,261.83984300000003,0.0,48.05322328,30016.16992,33887.25,37.13020178,-62.86979822,2.2314970880000002,-331.8397852,0.026660787000000002,63426300,-1,0.0
BSESN,5/6/2020,31685.75,31970.839839999997,31158.75,31577.63086,19200,232.240234,0.0,232.240234,50.30899442,30016.16992,33887.25,43.12956706,-56.87043294,-1.815890255,-265.8350062,0.009757921999999999,63445500,1,0.34
BSESN,5/7/2020,31443.38086,31705.25,31362.86914,31677.68945,19900,-242.369141,242.369141,0.0,47.80902833,30378.25977,33887.25,30.35406262,-69.64593738,-24.30051677,-217.5281083,-0.01317196,63425600,-1,0.5423
BSESN,5/8/2020,31642.69922,32088.50977,31598.0,32083.320310000003,15900,199.31836,0.0,199.31836,50.15915756,30378.25977,33887.25,36.03428248,-63.96571752,-25.73970806,-179.1704283,0.010070428000000001,63441500,1,-0.4767
BSESN,5/11/2020,31561.2207,32301.58008,31500.86914,32030.339839999997,18100,-81.478516,81.478516,0.0,49.11596906,30378.25977,33887.25,33.71228924,-66.28771076,-33.07366026,-149.9510747,-0.005729103,63423400,-1,0.0
BSESN,5/12/2020,31371.11914,31536.89063,30844.660160000003,31342.929689999997,23100,-190.101562,190.101562,0.0,46.51181698,30578.55078,33887.25,23.95407704,-76.04592296,-53.60752336,-130.6823644,-0.02314842,63400300,-1,0.0
BSESN,5/13/2020,32008.60938,32845.48047,31901.91992,32841.87109,18400,637.490234,0.0,637.490234,55.61712801,30844.660160000003,33887.25,38.25521279,-61.74478721,-18.230474100000002,-108.1919863,-0.021746556,63418700,1,0.0
BSESN,5/14/2020,31122.89063,31630.93945,31052.65039,31466.33008,15200,-885.71875,885.71875,0.0,43.69316426,30844.660160000003,33887.25,9.144527632,-90.85547237,-60.9612848,-98.74584603,-0.076954731,63403500,-1,0.1139
BSESN,5/15/2020,31097.73047,31296.2793,30770.48047,31296.2793,13000,-25.160156,25.160156,0.0,43.3882696,30770.48047,33887.25,10.49965346,-89.50034654,-95.75220267,-98.14711736,-0.019473824,63390500,-1,0.4939
BSESN,5/18/2020,30028.98047,31248.25977,29968.44922,31248.25977,19500,-1068.75,1068.75,0.0,32.33065352,29968.44922,33887.25,1.5446370809999999,-98.45536292,-207.1752614,-119.9527462,-0.045289995,63371000,-1,0.0
BSESN,5/19/2020,30196.16992,30739.960939999997,30116.820310000003,30450.74023,18700,167.18945300000001,0.0,167.18945300000001,35.30663074,29968.44922,33887.25,5.8109793210000005,-94.18902068,-278.77450760000005,-151.71709840000003,-0.047011040999999996,63389700,1,-0.765
BSESN,5/20/2020,30818.60938,30878.31055,30157.75,30159.589839999997,16100,622.4394530000001,0.0,622.4394530000001,45.58635732,29968.44922,33887.25,21.694395899999996,-78.3056041,-282.04057589999996,-177.7817939,-0.01986973,63405800,1,-0.4404
BSESN,5/21/2020,30932.90039,31188.789060000003,30765.320310000003,30904.289060000003,15500,114.29101599999998,0.0,114.29101599999998,47.35855626,29968.44922,32845.48047,33.52244339,-66.47755661,-272.2680917,-196.67905349999998,-0.022431677999999997,63421300,1,0.0772
BSESN,5/22/2020,30672.589839999997,31107.910160000003,30474.88086,30822.7793,20600,-260.31054700000004,260.31054700000004,0.0,43.6246437,29968.44922,32845.48047,24.47455602,-75.52544398,-282.27433039999994,-213.79810890000002,-0.028155782,63400700,-1,0.1027
BSESN,5/26/2020,30609.30078,31086.69922,30512.14063,30864.26953,188300,-63.289063,63.289063,0.0,42.68062358,29968.44922,32845.48047,22.27475152,-77.72524848,-291.9458748,-229.4276621,-0.024284067000000003,63212400,-1,0.3612
BSESN,5/27/2020,31605.2207,31660.59961,30525.679689999997,30793.10938,20500,995.919922,0.0,995.919922,58.84918716,29968.44922,32845.48047,56.89098733,-43.10901267,-216.74967369999996,-226.89206439999998,-0.012602505,63232900,1,0.0
BSESN,5/28/2020,32200.589839999997,32267.23047,31641.76953,31827.80078,27500,595.369141,0.0,595.369141,65.55182828,29968.44922,32845.48047,77.58485852,-22.41514148,-107.8713547,-203.08792250000002,0.034627221,63260400,1,0.0
BSESN,5/29/2020,32424.09961,32480.51953,31823.80078,32041.289060000003,37100,223.509765,0.0,223.509765,67.82212684,29968.44922,32845.48047,85.35362242,-14.64637758,-3.508686477,-163.1720753,0.042651638,63297500,1,-0.6486
BSESN,6/1/2020,33303.51953,33673.82813,32876.55078,32906.05078,22900,879.419922,0.0,879.419922,75.23258659,29968.44922,33673.82813,90.00618821,-9.993811791,148.450078,-100.8476446,0.109045962,63320400,1,-0.25
BSESN,6/2/2020,33825.53125,33866.62891,33301.28906,33450.19141,75600,522.0117190000001,0.0,522.0117190000001,78.60695355,29968.44922,33866.62891,98.94572187,-1.054278132,307.45631180000004,-19.18685333,0.12019277099999999,63396000,1,-0.7003
BSESN,6/3/2020,34109.53906,34488.69141,34027.5,34185.41016,18400,284.007813,0.0,284.007813,80.29250147,29968.44922,34488.69141,91.61212326,-8.38787674,451.1859636,74.88771005,0.106783848,63414400,1,0.0
BSESN,6/4/2020,33980.69922,34310.14063,33711.23828,34072.5,17900,-128.839844,128.839844,0.0,77.11226272,29968.44922,34488.69141,88.76183696,-11.23816304,548.3751225,169.5851925,0.09852935800000001,63396500,-1,0.34
BSESN,6/5/2020,34287.23828,34405.42969,33958.01953,34198.55078,24600,306.539062,0.0,306.539062,79.35688612,29968.44922,34488.69141,95.54331125,-4.45668875,642.7244443,264.2130429,0.11784620900000001,63421100,1,0.0
BSESN,6/8/2020,34370.57813,34927.80078,34211.82813,34841.17188,25700,83.339844,0.0,83.339844,79.97301417,30116.820310000003,34927.80078,88.41769033,-11.58230967,715.9685507,354.5641444,0.122880211,63446800,1,0.29600000000000004
BSESN,6/9/2020,33956.69141,34811.28906,33881.19141,34520.78906,19200,-413.88671899999997,413.88671899999997,0.0,68.29287807,30157.75,34927.80078,79.64152963,-20.35847037,732.1777442000001,430.0868643999999,0.074401338,63427600,-1,-0.128
BSESN,6/10/2020,34247.05078,34350.17188,33949.46094,34029.14063,15500,290.359375,0.0,290.359375,71.64511425,30474.88086,34927.80078,84.71227842,-15.28772158,759.6959201000001,496.0086755,0.063553523,63443100,1,-0.4215
BSESN,6/11/2020,33538.37109,34219.39063,33480.42188,34214.69141,20900,-708.6796870000001,708.6796870000001,0.0,55.20752562,30474.88086,34927.80078,68.79733498,-31.20266502,716.0653886,540.0200181,0.034365533999999996,63422200,-1,-0.2023
BSESN,6/12/2020,33780.89063,33856.26953,32348.09961,32436.68945,23000,242.519531,0.0,242.519531,58.928343299999995,30512.14063,34927.80078,74.02630376,-25.97369624,693.0679217999999,570.6295989,0.014333953,63445200,1,0.25
BSESN,6/15/2020,33228.80078,33670.55078,32923.73828,33670.55078,18400,-552.0898440000001,552.0898440000001,0.0,48.37349993,30525.679689999997,34927.80078,61.40496901,-38.59503099,623.1103985000001,581.1257588,-0.017641422,63426800,-1,0.0
BSESN,6/16/2020,33605.21875,34022.01172,32953.30078,33853.71875,27400,376.41796899999997,0.0,376.41796899999997,54.74964318,31641.76953,34927.80078,59.75138608,-40.24861392,591.2270442,583.1460159,-0.014785316000000001,63454200,1,0.0
BSESN,6/17/2020,33507.92188,33933.66016,33332.96094,33438.30859,20200,-97.296875,97.296875,0.0,52.80458124,31823.80078,34927.80078,54.25647854,-45.74352146,551.7480039,576.8664135,-0.013913113999999999,63434000,-1,-0.29600000000000004
BSESN,6/18/2020,34208.05078,34276.01172,33371.51953,33371.51953,21200,700.1289059999999,0.0,700.1289059999999,63.55484209,32348.09961,34927.80078,72.09948161,-27.90051839,570.3801444000001,575.5691597,-0.002309533,63455200,1,-0.5106
BSESN,6/19/2020,34731.73047,34848.37109,34136.39063,34335.37891,27900,523.6796879999999,0.0,523.6796879999999,69.5424085,32348.09961,34927.80078,92.39949518,-7.600504823,620.2529344,584.5059146000001,0.010507602,63483100,1,0.4939
BSESN,6/22/2020,34911.32031,35213.51953,34794.39844,34892.03125,25100,179.589844,0.0,179.589844,71.40156812,32348.09961,35213.51953,89.45358006,-10.54641994,666.5849035,600.9217123999999,0.028113131,63508200,1,0.0
BSESN,6/23/2020,35430.42969,35482.16016,34843.69141,35015.73047,25200,519.109375,0.0,519.109375,76.23896279,32348.09961,35482.16016,98.3494107,-1.650589299,736.6989046,628.0771507999999,0.034554184,63533400,1,-0.6486
BSESN,6/24/2020,34868.98047,35706.55078,34794.92969,35679.73828,26600,-561.4492190000001,561.4492190000001,0.0,62.95067037,32348.09961,35706.55078,75.06081616,-24.93918384,738.4481256,650.1513458,0.03967424,63506800,-1,0.0
BSESN,6/25/2020,34842.10156,35081.60938,34499.78125,34525.39063,24600,-26.878906,26.878906,0.0,62.35035407,32348.09961,35706.55078,74.26047979,-25.73952021,729.2590482999999,665.9728863,0.031414534,63482200,-1,0.0
BSESN,6/26/2020,35171.26953,35254.87891,34910.33984,35144.78125,24800,329.16796800000003,0.0,329.16796800000003,66.82124201,32348.09961,35706.55078,84.06166347,-15.93833653,740.0073977999999,680.7797886,0.058457382999999995,63507000,1,-0.5267
BSESN,6/29/2020,34961.51953,35032.35938,34662.05859,34926.94922,18300,-209.75,209.75,0.0,61.45554355,32348.09961,35706.55078,77.81622504,-22.18377496,723.2631428999999,689.2764595,0.040359826,63488700,-1,0.4215
BSESN,6/30/2020,34915.80078,35233.91016,34812.80078,35168.30078,18500,-45.71875,45.71875,0.0,60.23899424,32348.09961,35706.55078,76.45492045,-23.54507955,698.2550299,691.0721735000001,0.0420163,63470200,-1,0.0
