,symbol,datetime,close,high,low,open,volume,change_in_price,down_days,up_days,RSI,low_14,high_14,k_percent,r_percent,MACD,MACD_EMA,Price_Rate_Of_Change,On Balance Volume
0,BSESN,2003-07-14,3720.75,3726.560059,3704.629883,3704.629883,21200.0,,,,,,,,,0.0,0.0,,0.0
1,BSESN,2003-07-15,3686.340088,3733.879883,3657.179932,3719.169922,22800.0,-34.40991199999962,34.40991199999962,0.0,0.0,,,,,-0.7720172564099812,-0.42889847578332285,,-22800.0
2,BSESN,2003-07-16,3721.649902,3729.02002,3662.699951,3702.139893,18400.0,35.309813999999726,0.0,35.309813999999726,54.2129155905034,,,,,0.1112519993857859,-0.20752533022221273,,-4400.0
3,BSESN,2003-07-17,3668.909912,3750.0,3660.340088,3728.840088,22000.0,-52.739990000000496,52.739990000000496,0.0,28.026871126373905,,,,,-1.393903583159954,-0.6094149823013933,,-26400.0
4,BSESN,2003-07-18,3647.580078,3684.22998,3625.72998,3651.389893,22000.0,-21.329833999999664,21.329833999999664,0.0,22.871527229470317,,,,,-3.0312006178528463,-1.329841456465914,,-48400.0
5,BSESN,2003-07-21,3569.580078,3664.639893,3564.409912,3655.26001,19400.0,-78.0,78.0,0.0,12.877123108607975,,,,,-7.293787355577479,-2.9464023841026243,,-67800.0
6,BSESN,2003-07-22,3554.129883,3582.080078,3534.060059000001,3557.129883,22400.0,-15.450195000000349,15.450195000000349,0.0,11.70782503662656,,,,,-10.601712676918396,-4.8837571941194104,,-90200.0
7,BSESN,2003-07-23,3577.889893,3596.590088000001,3551.97998,3571.75,31800.0,23.76001000000042,0.0,23.76001000000042,23.959899529328112,,,,,-11.51929517699,-6.478401752722638,,-58400.0
8,BSESN,2003-07-24,3668.070068,3677.23999,3572.639893,3595.600098,44400.0,90.18017499999996,0.0,90.18017499999996,52.702989981491335,,,,,-7.5052660728629235,-6.715612504975206,,-14000.0
9,BSESN,2003-07-25,3726.459961,3737.76001,3661.689941,3685.310059,25800.0,58.38989300000003,0.0,58.38989300000003,63.11837520342527,,,,,-1.5410033324765209,-5.556199664685276,0.001534626352214019,11800.0
10,BSESN,2003-07-28,3739.76001,3775.649902,3730.070068,3745.98999,24600.0,13.300048999999944,0.0,13.300048999999944,65.13618412635363,,,,,3.499046587842713,-3.574963525730387,0.014491316787047293,36400.0
11,BSESN,2003-07-29,3764.439941,3771.350098,3694.939941,3731.850098,21800.0,24.67993099999967,0.0,24.67993099999967,68.79192632822097,,,,,8.502247138937946,-0.9812851736180715,0.01149759921721949,58200.0
12,BSESN,2003-07-30,3780.419922,3799.889893,3759.97998,3761.76001,22600.0,15.979981000000407,0.0,15.979981000000407,71.05913926298112,,,,,13.002650264310887,1.9782014094862317,0.03039322650994536,80800.0
13,BSESN,2003-07-31,3792.610107,3835.75,3785.120117,3796.530029,37000.0,12.190184999999929,0.0,12.190184999999929,72.79853946493697,3534.060059000001,3835.75,85.70058621874962,-14.299413781250381,16.908881119981288,5.101710744937044,0.03976061550361387,117800.0
14,BSESN,2003-08-01,3815.310059,3831.459961,3779.72998,3800.72998,26000.0,22.699952000000394,0.0,22.699952000000394,75.90951226856674,3534.060059000001,3835.75,93.22485166981416,-6.77514833018584,20.98607653641102,8.394436387423521,0.06884002477335649,143800.0
15,BSESN,2003-08-04,3832.5,3840.719971,3785.850098,3798.810059,19800.0,17.189940999999635,0.0,17.189940999999635,78.09818786024366,3534.060059000001,3840.719971,97.31951563333129,-2.6804843666687055,24.85861934139666,11.782642501935465,0.078323000611624,163600.0
16,BSESN,2003-08-05,3765.820068,3878.719971,3761.840088,3845.929932,26000.0,-66.67993200000001,66.67993200000001,0.0,55.521299211695066,3534.060059000001,3878.719971,67.24309991699869,-32.75690008300132,23.377021932874868,14.154937727594806,0.052525421580937426,137600.0
17,BSESN,2003-08-06,3741.659912,3798.870117,3722.080078,3754.649902,29000.0,-24.160156000000374,24.160156000000374,0.0,49.53463875803704,3534.060059000001,3878.719971,60.233246099128515,-39.766753900871485,20.43208192462862,15.433397246248845,0.02006227870126942,108600.0
18,BSESN,2003-08-07,3806.830078,3816.159912,3733.629883,3749.179932,24200.0,65.17016600000035,0.0,65.17016600000035,62.21521439515788,3534.060059000001,3878.719971,79.1417886162519,-20.858211383748106,22.10093650731369,16.78640398045867,0.0215674172917808,132800.0
19,BSESN,2003-08-08,3883.76001,3890.780029,3823.389893,3824.26001,29200.0,76.92993200000002,0.0,76.92993200000002,71.84960919631746,3534.060059000001,3890.780029,98.03206447903658,-1.9679355209634222,28.135131704358628,19.082623129602034,0.03850514461220733,162000.0
20,BSESN,2003-08-11,3893.409912,3915.899902,3842.139893,3842.139893,21800.0,9.649901999999656,0.0,9.649901999999656,72.85151865889426,3551.97998,3915.899902,93.82007176842602,-6.179928231573987,33.098534251024375,21.91190083475672,0.03426006870114651,183800.0
21,BSESN,2003-08-12,3889.409912,3938.909912,3879.350098,3907.030029,27400.0,-4.0,4.0,0.0,71.63214446940017,3572.639893,3938.909912,86.48538033903343,-13.51461966096657,36.278567081758865,24.80659314343327,0.028830127935189687,156400.0
22,BSESN,2003-08-13,3926.070068,3935.800049,3874.340088,3910.459961,25200.0,36.66015600000037,0.0,36.66015600000037,75.89822993370836,3661.689941,3938.909912,95.36835533396687,-4.631644666033129,40.805361410087244,28.0253469657228,0.035189475647305235,181600.0
23,BSESN,2003-08-14,3921.199951,3959.100098,3908.699951,3932.590088,22600.0,-4.870117000000391,4.870117000000391,0.0,74.18809546643436,3694.939941,3959.100098,85.65258764591064,-14.347412354089364,43.50478239932181,31.13592333402669,0.02775394145233756,159000.0
24,BSESN,2003-08-18,3977.72998,3985.459961,3928.169922,3932.370117,19400.0,56.530029000000006,0.0,56.530029000000006,80.1717945278658,3694.939941,3985.459961,97.33926047506125,-2.6607395249387475,49.0215622292576,34.72661636781931,0.037894319634703244,178400.0
25,BSESN,2003-08-19,4006.909912,4026.27002,3981.919922,3985.77002,24400.0,29.179932000000008,0.0,29.179932000000008,82.57735731648296,3722.080078,4026.27002,93.63552000677265,-6.364479993227342,54.790515213182516,38.75156078496295,0.06402054257681011,202800.0
26,BSESN,2003-08-20,4056.600098,4066.030029,4027.600098,4027.600098,21200.0,49.690186000000274,0.0,49.690186000000274,85.93108718276947,3722.080078,4066.030029,97.25834210105756,-2.741657898942431,62.167250018093,43.44604920811822,0.08417124843173074,224000.0
27,BSESN,2003-08-21,4095.389893,4106.709961,4073.060059,4075.169922,27000.0,38.78979500000014,0.0,38.78979500000014,88.00996623635913,3722.080078,4106.709961,97.05689326276307,-2.9431067372369375,69.96817781538402,48.760755065787365,0.07580055034964972,251000.0
28,BSESN,2003-08-22,4125.120117,4149.540039,4084.189941,4146.560059,28000.0,29.73022400000036,0.0,29.73022400000036,89.39569857649113,3722.080078,4149.540039,94.28720249193117,-5.712797508068835,77.38418346809749,54.49431299741329,0.062145989036021865,279000.0
29,BSESN,2003-08-25,4004.629883,4170.580078,3943.659912,4149.819824,34200.0,-120.49023400000078,120.49023400000078,0.0,58.031963123758956,3722.080078,4170.580078,62.99884169453737,-37.00115830546263,73.52421976297137,58.30501176710956,0.02856621149938654,244800.0
30,BSESN,2003-08-26,4152.290039,4160.02002,4021.909912,4021.909912,28800.0,147.66015600000082,0.0,147.66015600000082,71.94840267342238,3722.080078,4170.580078,95.92195340022307,-4.078046599776928,80.45707213400328,62.73981585772843,0.06758869158762004,273600.0
31,BSESN,2003-08-27,4205.560059,4222.3901369999985,4173.3598630000015,4173.3598630000015,25600.0,53.27001999999993,0.0,53.27001999999993,75.35076369663254,3733.629883,4222.3901369999985,96.55657802322072,-3.443421976779272,88.86450124720068,67.96889583960892,0.07118823305728128,299200.0
32,BSESN,2003-08-28,4212.290039,4256.069824,4179.330078,4256.069824,28600.0,6.729980000000068,0.0,6.729980000000068,75.77900989004095,3823.389893,4256.069824,89.88171582194329,-10.118284178056713,94.9076548045532,73.36006469181349,0.0742349514530023,327800.0
33,BSESN,2003-08-29,4244.72998,4277.6401369999985,4228.850098,4235.259765999999,35200.0,32.439940999999635,0.0,32.439940999999635,77.91321759943978,3842.139893,4277.6401369999985,92.44313695493624,-7.55686304506377,100.95297474345489,78.8814463752638,0.06712371159995123,363000.0
34,BSESN,2003-09-01,4324.759765999999,4329.569824,4248.069824,4248.069824,24800.0,80.02978599999916,0.0,80.02978599999916,82.34217503255569,3874.340088,4329.569824,98.94337789919749,-1.056622100802513,110.50696771311414,85.20911745116585,0.07932543056386021,387800.0
35,BSESN,2003-09-02,4339.200195,4358.299805,4291.959961,4341.72998,31200.0,14.440429000001133,0.0,14.440429000001133,83.04982671402875,3874.340088,4358.299805,96.05347111978759,-3.9465288802124237,117.7938447752922,91.72817847224489,0.06966427307915546,419000.0
36,BSESN,2003-09-03,4257.939941,4367.870117,4248.8598630000015,4361.870117,28800.0,-81.2602540000007,81.2602540000007,0.0,65.90144132548188,3908.699951,4367.870117,76.05894630358003,-23.94105369641996,116.00210673428,96.5842248263634,0.03969098235990587,390200.0
37,BSESN,2003-09-04,4310.509765999999,4328.370117,4257.410156,4276.399902,33000.0,52.56982499999958,0.0,52.56982499999958,70.45521644393887,3928.169922,4367.870117,86.95466782769994,-13.045332172300068,117.25351813029374,100.7189422343578,0.04494163654434957,423200.0
38,BSESN,2003-09-05,4369.169922,4371.97998,4314.680176,4314.680176,30800.0,58.66015600000082,0.0,58.66015600000082,74.7899623161155,3943.659912,4371.97998,99.3439350126364,-0.6560649873636148,121.35158262925415,104.846156064358,0.09102964559783766,454000.0
39,BSESN,2003-09-08,4434.25,4444.620117,4399.6098630000015,4399.6098630000015,25200.0,65.08007799999996,0.0,65.08007799999996,78.77616554378939,3943.659912,4444.620117,97.92995194099292,-2.070048059007079,128.13771984121013,109.50508809801735,0.06790468834106411,479200.0
40,BSESN,2003-09-09,4425.200195,4473.569824,4398.089844,4458.6401369999985,30400.0,-9.049804999999651,9.049804999999651,0.0,76.82704309513642,3943.659912,4473.569824,90.87210336990266,-9.127896630097343,131.28630527866335,113.86179481866996,0.05222613229121875,448800.0
41,BSESN,2003-09-10,4434.259765999999,4438.22998,4378.649902,4410.120117,26600.0,9.059570999998867,0.0,9.059570999998867,77.47092174929149,3943.659912,4473.569824,92.58174698947678,-7.418253010523217,132.94229364338207,117.67821924909697,0.05269573674767525,475400.0
42,BSESN,2003-09-11,4393.129883,4463.379883,4381.089844,4423.709961,25800.0,-41.12988299999961,41.12988299999961,0.0,67.62754824789127,3943.659912,4473.569824,84.82007239751339,-15.179927602486615,129.54498460035848,120.05173385238271,0.034960976010068645,449600.0
43,BSESN,2003-09-12,4305.910156,4437.0,4297.709961,4407.720215,26600.0,-87.2197269999997,87.2197269999997,0.0,51.588930935464056,4021.909912,4473.569824,62.87922316205026,-37.12077683794975,118.66087773517211,119.77354748303398,-0.0043585334261082576,423000.0
44,BSESN,2003-09-15,4193.830078,4310.169922,4184.1098630000015,4310.169922,33800.0,-112.08007799999996,112.08007799999996,0.0,38.16750494327319,4173.3598630000015,4473.569824,6.818632843431385,-93.18136715656861,100.09770545558877,115.83820766932139,-0.03350159256710683,389200.0
45,BSESN,2003-09-16,4274.75,4290.069824,4134.689941,4195.100098,40400.0,80.91992200000004,0.0,80.91992200000004,49.18137567403527,4134.689941,4473.569824,41.3302960801601,-58.6697039198399,90.69722449174242,110.8098358206191,0.003947932388180364,429600.0
46,BSESN,2003-09-17,4235.350098,4330.850098,4222.600098,4299.370117,32200.0,-39.39990200000011,39.39990200000011,0.0,44.7074319171631,4134.689941,4473.569824,29.70378651836353,-70.29621348163647,79.232864521583,104.49426550840649,-0.0174363757606667,397400.0
47,BSESN,2003-09-18,4134.149902,4251.540039,4126.220215,4243.009765999999,33600.0,-101.20019599999979,101.20019599999979,0.0,35.21372302910227,4126.220215,4473.569824,2.282912315009928,-97.71708768499006,61.461222657439976,95.88746500014807,-0.05379054241324144,363800.0
48,BSESN,2003-09-19,4217.120117,4224.72998,4097.549805,4159.720215,35400.0,82.97021500000028,0.0,82.97021500000028,46.05117000670719,4097.549805,4473.569824,31.798921854743213,-68.20107814525679,53.31722794066809,87.37326568986056,-0.04896654067767936,399200.0
49,BSESN,2003-09-22,4151.720215,4237.419922,4141.799805,4230.910156,24600.0,-65.39990200000011,65.39990200000011,0.0,39.970075902280236,4097.549805,4473.569824,14.40625691793302,-85.59374308206698,41.215246780399866,78.1415301482359,-0.061800589340342826,374600.0
50,BSESN,2003-09-23,4231.689941,4240.02002,4111.540039,4138.009765999999,25200.0,79.96972599999934,0.0,79.96972599999934,49.397800129435915,4097.549805,4473.569824,35.6736687468759,-64.3263312531241,37.52790900646505,70.01871317370745,-0.04568289538497905,399800.0
51,BSESN,2003-09-24,4356.3901369999985,4366.830078,4229.870117,4249.930176,30400.0,124.70019599999979,0.0,124.70019599999979,60.546296312975514,4097.549805,4473.569824,68.83684881681752,-31.16315118318248,43.98975657864321,64.81287430255689,-0.008363000179478441,430200.0
52,BSESN,2003-09-25,4297.149902,4360.720215,4285.009765999999,4347.22998,31000.0,-59.240234999999295,59.240234999999295,0.0,54.02224908633235,4097.549805,4473.569824,53.08230597158716,-46.91769402841284,43.89715682610131,60.62970023868706,-0.002034472082004024,399200.0
53,BSESN,2003-09-26,4382.569824,4388.830078,4299.660156,4299.660156,24800.0,85.41992200000004,0.0,85.41992200000004,61.011850922406175,4097.549805,4473.569824,75.79916084201892,-24.200839157981076,50.03817183423598,58.511382174095566,0.04500414716134826,424000.0
54,BSESN,2003-09-29,4402.049805,4426.299805,4385.540039,4392.870117,31600.0,19.479980999999498,0.0,19.479980999999498,62.511468118489304,4097.549805,4463.379883,83.23536480781114,-16.764635192188862,55.81006441454156,57.97111609546554,0.029779473653430033,455600.0
55,BSESN,2003-09-30,4453.240234000001,4456.410156,4413.720215,4428.160156,30400.0,51.19042900000113,0.0,51.19042900000113,66.426962267671,4097.549805,4463.379883,97.22831729544151,-2.771682704558488,63.72667157900105,59.12223149900667,0.05144560212457816,486000.0
56,BSESN,2003-10-01,4455.080078,4487.049805,4432.930176,4452.069824,26400.0,1.8398439999991751,0.0,1.8398439999991751,66.57175337263632,4097.549805,4487.049805,91.7921111681644,-8.207888831835607,69.34557009537366,61.16690533830652,0.07762906125990776,512400.0
57,BSESN,2003-10-03,4552.919922,4556.8901369999985,4465.439941,4465.439941,33000.0,97.83984400000007,0.0,97.83984400000007,73.56671122297072,4097.549805,4556.8901369999985,99.13567028118086,-0.8643297188191328,80.67689140419861,65.06891189493439,0.07962775441143544,545400.0
58,BSESN,2003-10-06,4631.3901369999985,4637.27002,4552.3901369999985,4567.680176,26400.0,78.47021499999937,0.0,78.47021499999937,77.85500134959089,4097.549805,4637.27002,98.91056832103251,-1.089431678967486,94.83027176841551,71.02119527194029,0.11553522327130095,571800.0
59,BSESN,2003-10-07,4632.939941,4688.330078,4601.160156,4644.8598630000015,33400.0,1.549804000000222,0.0,1.549804000000222,77.93657047785395,4097.549805,4688.330078,90.62424059646956,-9.375759403530438,104.95785715609964,77.80853805034468,0.09482027407357263,605200.0
60,BSESN,2003-10-08,4634.8598630000015,4667.490234000001,4586.959961,4646.629883,28800.0,1.919922000000952,0.0,1.919922000000952,78.05212775519374,4097.549805,4688.330078,90.94922131904049,-9.050778680959517,111.84573658720456,84.61598610362368,0.06392212755117699,634000.0
61,BSESN,2003-10-09,4698.680176,4710.279785,4643.319824,4643.319824,25400.0,63.82031299999925,0.0,63.82031299999925,81.72358548139243,4097.549805,4710.279785,98.10689710335377,-1.8931028966462309,121.0164400160711,91.89608402641242,0.09344106748827108,659400.0
62,BSESN,2003-10-10,4768.899902,4780.77002,4730.310059,4735.089844,33200.0,70.21972600000026,0.0,70.21972600000026,84.9250585325637,4111.540039,4780.77002,98.22630211780667,-1.7736978821933307,132.38077520792467,99.99302861588298,0.08815149410383927,692600.0
63,BSESN,2003-10-13,4849.27002,4859.930176,4786.689941,4787.75,29600.0,80.3701179999998,0.0,80.3701179999998,87.75724260798034,4111.540039,4859.930176,98.57558838993626,-1.4244116100637392,146.14141372996892,109.22271143226597,0.10159362906163216,722200.0
64,BSESN,2003-10-14,4782.029785,4900.919922,4765.350098,4866.120117,37600.0,-67.24023500000021,67.24023500000021,0.0,74.2847479648806,4229.870117,4900.919922,82.28296378090738,-17.71703621909262,149.92411975664163,117.36299718493323,0.07383153248498187,684600.0
65,BSESN,2003-10-15,4855.259765999999,4867.910156,4738.720215,4790.540039,31800.0,73.2299809999995,0.0,73.2299809999995,78.4434026969349,4285.009765999999,4900.919922,92.58655575733017,-7.413444242669829,156.98533807523563,125.28746854652735,0.08982547585983025,716400.0
66,BSESN,2003-10-16,4887.319824,4921.649902,4865.259765999999,4887.040039,39200.0,32.060058000000936,0.0,32.060058000000936,80.0714293805921,4299.660156,4921.649902,94.4806038651319,-5.5193961348681055,163.27048012421074,132.88407330351868,0.0734473497730892,755600.0
67,BSESN,2003-10-17,4930.529785,4949.22998,4901.589844,4912.27002,35400.0,43.20996099999957,0.0,43.20996099999957,82.16601097262735,4385.540039,4949.22998,96.68253881436561,-3.317461185634384,169.76214402377263,140.25968934391474,0.06458960250620782,791000.0
68,BSESN,2003-10-20,4851.669922,4951.1098630000015,4838.700195,4951.1098630000015,31000.0,-78.85986299999969,78.85986299999969,0.0,67.2758223771848,4413.720215,4951.1098630000015,81.49574682540197,-18.50425317459804,166.64991533592274,145.5377356279475,0.047211918087759264,760000.0
69,BSESN,2003-10-21,4755.720215,4880.660156,4727.430176,4868.0,39400.0,-95.94970699999978,95.94970699999978,0.0,53.631211765567656,4432.930176,4951.1098630000015,62.29307074323803,-37.70692925676197,154.6896858543223,147.36812597441406,0.026076376756247743,720600.0
70,BSESN,2003-10-22,4741.200195,4801.700195,4705.410156,4772.839844,34000.0,-14.520019999999931,14.520019999999931,0.0,51.796882801311355,4465.439941,4951.1098630000015,56.77935600055538,-43.22064399944461,142.40193572484714,146.37488779375042,0.009049353734945642,686600.0
71,BSESN,2003-10-23,4648.410156,4755.939941,4634.899902,4744.47998,31000.0,-92.79003900000043,92.79003900000043,0.0,41.36476994458118,4552.3901369999985,4951.1098630000015,24.08208391475487,-75.91791608524512,123.7764068757424,141.8551911341692,-0.025265731819925308,655600.0
72,BSESN,2003-10-24,4757.370117,4772.069824,4599.6098630000015,4654.27002,38400.0,108.95996100000048,0.0,108.95996100000048,53.93522717768247,4586.959961,4951.1098630000015,46.79670516566552,-53.20329483433448,116.43572154476533,136.77129678797115,-0.018951285991700595,694000.0
73,BSESN,2003-10-27,4698.279785,4814.319824,4689.089844,4802.069824,31400.0,-59.090332000000664,59.090332000000664,0.0,47.555649152424685,4586.959961,4951.1098630000015,30.569780024271314,-69.43021997572869,104.65810966351,130.34865893019398,-0.01751348355518456,662600.0
74,BSESN,2003-10-28,4707.799805,4748.189941,4666.189941,4710.220215,34600.0,9.520019999999931,0.0,9.520019999999931,48.68399342970135,4599.6098630000015,4951.1098630000015,30.77949985775196,-69.22050014224803,94.99498410862452,123.27792358462678,-0.030371178496487405,697200.0
75,BSESN,2003-10-29,4744.100098,4747.589844,4684.419922,4732.790039,34200.0,36.300293000000245,0.0,36.300293000000245,53.121479378074795,4599.6098630000015,4951.1098630000015,41.10675248933098,-58.89324751066902,89.22938971566964,116.46821651709243,-0.02930434904151269,731400.0
76,BSESN,2003-10-30,4780.52002,4805.720215,4735.77002,4751.830078,42200.0,36.419922000000035,0.0,36.419922000000035,57.387276692543004,4599.6098630000015,4951.1098630000015,51.46803897581748,-48.53196102418252,86.59315551277177,110.4932041100382,-0.030424674739085833,773600.0
77,BSESN,2003-10-31,4906.870117,4913.180176,4779.089844,4787.049805,32200.0,126.35009700000046,0.0,126.35009700000046,68.76494115994794,4599.6098630000015,4951.1098630000015,87.41401251778062,-12.585987482219377,93.59667440681278,107.11389807610068,0.011377566051988364,805800.0
78,BSESN,2003-11-03,5063.029785,5068.660156,4946.930176,4946.930176,40800.0,156.1596679999993,0.0,156.1596679999993,77.37841109063878,4599.6098630000015,5068.660156,98.79962317814814,-1.2003768218518551,110.4473073397312,107.78057994355083,0.06461893385374418,846600.0
79,BSESN,2003-11-04,5097.839844,5135.0,5055.569824,5096.160156,44200.0,34.810059000000365,0.0,34.810059000000365,78.87665427217254,4599.6098630000015,5135.0,93.05923784696093,-6.940762153039069,125.16137179525322,111.25673837530971,0.07522138579512139,890800.0
80,BSESN,2003-11-05,5064.910156,5127.790039,5021.970215,5116.8598630000015,36400.0,-32.92968800000017,32.92968800000017,0.0,73.55893507600537,4599.6098630000015,5135.0,86.90864116534888,-13.091358834651128,132.64036543047405,115.53346384679311,0.08960052706674282,854400.0
81,BSESN,2003-11-06,5047.540039,5118.080078,5030.040039,5080.049805,34000.0,-17.370116999999482,17.370116999999482,0.0,70.65951843214782,4599.6098630000015,5135.0,83.66425622069316,-16.33574377930683,135.60454977274003,119.54768107737453,0.060993766485206935,820400.0
82,BSESN,2003-11-07,4971.569824,5092.700195,4965.5,5071.200195,25200.0,-75.97021500000028,75.97021500000028,0.0,58.936306229227796,4599.6098630000015,5135.0,69.4745635555105,-30.525436444489507,130.33029477346827,121.70420383610175,0.05816810652114035,795200.0
83,BSESN,2003-11-10,4998.569824,5017.899902,4909.660156,4962.220215,34200.0,27.0,0.0,27.0,61.55217551901743,4599.6098630000015,5135.0,74.51761499297096,-25.48238500702904,126.86325837787808,122.73601475192423,0.061763462985656936,829400.0
84,BSESN,2003-11-11,5030.6401369999985,5039.200195,4988.879883,4998.790039,29000.0,32.07031299999926,0.0,32.07031299999926,64.63937897455105,4599.6098630000015,5135.0,80.50769788461722,-19.492302115382785,125.2558063309616,123.23997307064944,0.06039923970423744,858400.0
85,BSESN,2003-11-12,5005.77002,5059.97998,4998.259765999999,5040.549805,27200.0,-24.870116999999482,24.870116999999482,0.0,60.306466649616745,4599.6098630000015,5135.0,75.86246531844488,-24.137534681555113,120.587243359485,122.70942712595924,0.047118304924492316,831200.0
86,BSESN,2003-11-13,4949.160156,5053.060059,4941.490234000001,5051.709961,33400.0,-56.609864000000016,56.609864000000016,0.0,51.27867176145147,4666.189941,5135.0,60.359245619343696,-39.64075438065631,111.04442274092526,120.37642624030785,0.008618536458400383,797800.0
87,BSESN,2003-11-14,4865.830078,4961.370117,4854.160156,4948.77002,32600.0,-83.33007799999996,83.33007799999996,0.0,40.883656835786134,4666.189941,5135.0,42.58443972508707,-57.41556027491293,95.66193147124795,115.43352727184377,-0.038948952578599094,765200.0
88,BSESN,2003-11-17,4940.22998,4959.959961,4882.970215,4907.02002,23400.0,74.39990200000011,0.0,74.39990200000011,51.096502171115354,4684.419922,5135.0,56.77349498794308,-43.22650501205692,88.44913002427529,110.03664780953181,-0.030916990102288544,788600.0
89,BSESN,2003-11-18,4891.129883,4981.47998,4875.459961,4956.419922,26800.0,-49.10009700000046,49.10009700000046,0.0,45.1561282281972,4735.77002,5135.0,38.91487883750606,-61.08512116249395,77.87677968361731,103.60467417214657,-0.03431063289328762,761800.0
90,BSESN,2003-11-19,4823.72998,4868.430176,4800.669922,4868.430176,31400.0,-67.39990299999954,67.39990299999954,0.0,38.134122238661284,4779.089844,5135.0,12.542529412956677,-87.45747058704332,63.333992434821994,95.55053781245782,-0.04434042271497085,730400.0
91,BSESN,2003-11-20,4771.22998,4878.810059,4763.529785,4840.799805,28800.0,-52.5,52.5,0.0,33.45793804829111,4763.529785,5135.0,2.07289701544452,-97.92710298455548,47.03357981100271,85.84714620038525,-0.040297099526364843,701600.0
92,BSESN,2003-11-21,4838.540039,4851.669922,4736.700195,4770.75,29600.0,67.31005900000036,0.0,67.31005900000036,43.675430200203984,4736.700195,5135.0,25.568640185500513,-74.43135981449949,39.092241568971986,76.49616526501967,-0.03201511444966454,731200.0
93,BSESN,2003-11-24,4822.149902,4858.430176,4803.799805,4852.120117,20600.0,-16.390137000000323,16.390137000000323,0.0,41.869119695474964,4736.700195,5127.790039,21.849124519837886,-78.15087548016211,31.118306480506362,67.42059350106467,-0.04144407656325233,710600.0
94,BSESN,2003-11-25,4894.589844,4900.209961,4843.459961,4845.100098,22200.0,72.43994199999997,0.0,72.43994199999997,51.994081943612564,4736.700195,5118.080078,41.39957455490643,-58.60042544509357,30.291411457015784,59.9947570876386,-0.02221040430459087,732800.0
95,BSESN,2003-11-27,4989.040039,5000.410156,4907.379883,4907.379883,38800.0,94.45019500000036,0.0,94.45019500000036,61.96149806081557,4736.700195,5092.700195,70.88197865168542,-29.11802134831458,36.82849096087921,55.3615038599825,0.008057909169024047,771600.0
96,BSESN,2003-11-28,5044.819824,5050.560059,4991.240234000001,4995.149902,30800.0,55.77978499999973,0.0,55.77978499999973,66.676294829623,4736.700195,5059.97998,95.31051531725068,-4.689484682749319,45.97766743247212,53.48473657373374,0.03678503834510605,802400.0
97,BSESN,2003-12-01,5160.850098,5166.560059,5082.819824,5086.8598630000015,51200.0,116.03027399999974,0.0,116.03027399999974,74.31692231392357,4736.700195,5166.560059,98.67166919310232,-1.3283308068976813,61.873193479191286,55.16242795535924,0.044657863883494686,853600.0
98,BSESN,2003-12-02,5186.080078,5204.569824,5123.799805,5187.72998,33400.0,25.229980000000072,0.0,25.229980000000072,75.71401421359069,4736.700195,5204.569824,96.04809868947484,-3.9519013105251597,75.63344937682359,59.256632240694614,0.06030307966777837,887000.0
99,BSESN,2003-12-03,5221.899902,5246.740234000001,5178.220215,5194.160156,25400.0,35.819824000000146,0.0,35.819824000000146,77.70109655670866,4736.700195,5246.740234000001,95.12972902113658,-4.870270978863416,88.40845380993869,65.08699655573109,0.08254399057386719,912400.0
100,BSESN,2003-12-04,5225.899902,5252.209961,5174.8598630000015,5229.180176,32200.0,4.0,0.0,4.0,77.93373071942,4736.700195,5252.209961,94.8963025076814,-5.103697492318602,97.72870509796849,71.61533826524246,0.09529406964365195,944600.0
101,BSESN,2003-12-05,5131.720215,5263.1098630000015,5125.069824,5245.75,31400.0,-94.17968699999984,94.17968699999984,0.0,60.72333801151131,4736.700195,5263.1098630000015,75.04041890051288,-24.959581099487128,96.40688867387325,76.57364834761503,0.06059269400209244,913200.0
102,BSESN,2003-12-08,5131.540039,5163.009765999999,5089.569824,5144.950195,29400.0,-0.18017599999984668,0.18017599999984668,0.0,60.69375128621839,4736.700195,5263.1098630000015,75.00619156561524,-24.993808434384754,94.25819992488869,80.11055866343865,0.06416020722866378,883800.0
103,BSESN,2003-12-09,5229.339844,5232.490234000001,5143.189941,5143.189941,21600.0,97.79980499999964,0.0,97.79980499999964,69.88400389964458,4736.700195,5263.1098630000015,93.58484065683966,-6.415159343160343,99.29981217460136,83.94840936599141,0.0683918388811171,905400.0
104,BSESN,2003-12-10,5285.540039,5300.790039,5220.600098,5234.720215,29000.0,56.200195000000356,0.0,56.200195000000356,73.92620437326745,4736.700195,5300.790039,97.2965299478074,-2.7034700521926074,106.6000220213009,88.47873189735571,0.059430270689796005,934400.0
105,BSESN,2003-12-11,5299.959961,5317.410156,5253.810059,5306.620117,25600.0,14.419921999999133,0.0,14.419921999999133,74.92269777169582,4736.700195,5317.410156,96.99502399270875,-3.0049760072912477,112.25467324875808,93.2339201678901,0.05057467776870972,960000.0
106,BSESN,2003-12-12,5315.810059,5343.910156,5283.75,5321.490234000001,26400.0,15.850098000000797,0.0,15.850098000000797,76.08203897226186,4803.799805,5343.910156,94.79734151586375,-5.202658484136242,116.6697182828284,97.92107979107801,0.03002605347131726,986400.0
107,BSESN,2003-12-15,5390.879883,5399.080078,5351.029785,5366.930176,24400.0,75.06982399999924,0.0,75.06982399999924,80.90604377245747,4843.459961,5399.080078,98.52413641099314,-1.4758635890068652,124.78628012624813,103.29411985829566,0.0394902897602345,1010800.0
108,BSESN,2003-12-16,5437.049805,5445.0,5351.209961,5374.149902,30800.0,46.169922000000035,0.0,46.169922000000035,83.29674997966968,4907.379883,5445.0,98.52122442062556,-1.4787755793744495,133.40557034670928,109.31640995614305,0.04120146058671037,1041600.0
109,BSESN,2003-12-17,5418.22998,5457.879883,5401.089844,5437.259765999999,23600.0,-18.819824999999586,18.819824999999586,0.0,78.66428411434606,4991.240234000001,5457.879883,91.50310028627686,-8.496899713723135,137.13721545354838,114.88057105574582,0.03680324568145554,1018000.0
110,BSESN,2003-12-18,5455.0,5466.299805,5407.459961,5432.459961,30800.0,36.77001999999993,0.0,36.77001999999993,81.04123596563315,5082.819824,5466.299805,97.05335204968635,-2.946647950313648,141.4306886444465,120.19059457357885,0.06299637771658984,1048800.0
111,BSESN,2003-12-19,5541.350098,5555.680176,5486.629883,5486.629883,33000.0,86.35009799999989,0.0,86.35009799999989,85.43736168499612,5089.569824,5555.680176,96.92560400374889,-3.0743959962511123,150.06989590672947,126.16645484029264,0.07986102727162203,1081800.0
112,BSESN,2003-12-22,5577.959961,5590.450195,5543.97998,5547.680176,29200.0,36.60986299999968,0.0,36.60986299999968,86.92096857454683,5089.569824,5590.450195,97.50634388505497,-2.493656114945015,158.0482419682421,132.54281226595393,0.06666618108593503,1111000.0
113,BSESN,2003-12-23,5564.330078,5616.25,5550.52002,5590.009765999999,29000.0,-13.629882999999607,13.629882999999607,0.0,83.27642793534005,5089.569824,5616.25,90.14203982494301,-9.857960175056988,161.41078160039615,138.31640613289412,0.05274580022909925,1082000.0
114,BSESN,2003-12-24,5641.919922,5648.240234000001,5560.22998,5566.049805,30800.0,77.58984400000007,0.0,77.58984400000007,86.887684134047,5089.569824,5648.240234000001,98.86868681661505,-1.1313131833849466,168.39444592879408,144.33201409211722,0.06452123478598493,1112800.0
115,BSESN,2003-12-26,5699.240234000001,5705.299805,5650.740234000001,5650.740234000001,24400.0,57.32031200000075,0.0,57.32031200000075,88.92605494786424,5089.569824,5705.299805,99.0158720239418,-0.9841279760582056,176.51890252006615,150.76939177774392,0.07213014963746289,1137200.0
116,BSESN,2003-12-29,5797.330078,5814.259765999999,5725.439941,5725.439941,18800.0,98.08984399999918,0.0,98.08984399999918,91.52687730595648,5143.189941,5814.259765999999,97.47720917119179,-2.522790828808205,188.6964973066879,158.35481288356752,0.07539589154670856,1156000.0
117,BSESN,2003-12-30,5791.850098,5920.759765999999,5762.600098,5852.700195,34200.0,-5.479980000000068,5.479980000000068,0.0,90.16187279647416,5220.600098,5920.759765999999,81.58853274593369,-18.41146725406632,195.64980710403688,165.81381172768877,0.06525603143707093,1121800.0
118,BSESN,2003-12-31,5838.959961,5876.549805,5801.52002,5812.379883,28200.0,47.10986299999968,0.0,47.10986299999968,91.42970552769881,5253.810059,5920.759765999999,87.73523638417315,-12.264763615826851,202.62557117054075,173.17616361628077,0.07765081632802895,1150000.0
119,BSESN,2004-01-02,6026.589844,6034.379883,5944.22998,5944.22998,31400.0,187.62988300000046,0.0,187.62988300000046,94.61741390817758,5283.75,6034.379883,98.96219972366868,-1.0378002763313285,220.74801989280695,182.69053487160832,0.10478273950504136,1181400.0
120,BSESN,2004-01-05,6039.0,6078.1098630000015,5964.649902,6050.47998,33600.0,12.410155999999914,0.0,12.410155999999914,94.76598720471608,5351.029785,6078.1098630000015,94.62096897117824,-5.379031028821752,233.4207236727607,192.83657263185785,0.08980661629367415,1215000.0
121,BSESN,2004-01-06,5943.6401369999985,6121.200195,5916.330078,6068.680176,37600.0,-95.35986300000059,95.35986300000059,0.0,76.13380941080064,5351.209961,6121.200195,76.93995973460598,-23.060040265394026,233.08290733319063,200.8858395721365,0.06555804963763867,1177400.0
122,BSESN,2004-01-07,5957.02002,5985.299805,5870.549805,5970.350098,36200.0,13.379883000000518,0.0,13.379883000000518,76.8700511008181,5401.089844,6121.200195,77.20069225890069,-22.7993077410993,231.22925442058295,206.9545225418331,0.07057272600570541,1213600.0
123,BSESN,2004-01-08,6108.540039,6118.620117,5992.100098,5992.100098,31600.0,151.5200190000005,0.0,151.5200190000005,83.5150023395904,5407.459961,6121.200195,98.22622357590116,-1.7737764240988412,239.22810609185672,213.40923925184404,0.0827059092385325,1245200.0
124,BSESN,2004-01-09,6119.589844,6249.600098,6096.680176,6241.589844,45200.0,11.049804999999651,0.0,11.049804999999651,83.90410548968401,5486.629883,6249.600098,82.95998304468547,-17.040016955314535,243.6501456109063,219.45742052366117,0.07375537663640075,1290400.0
125,BSESN,2004-01-12,6067.759765999999,6152.220215,6037.299805,6152.220215,31600.0,-51.83007800000087,51.83007800000087,0.0,74.39975355893098,5543.97998,6249.600098,74.22971265113493,-25.77028734886506,240.2036811014541,223.6066726392223,0.04664728148328812,1258800.0
126,BSESN,2004-01-13,6132.970215,6147.740234000001,6011.569824,6084.649902,33200.0,65.21044900000106,0.0,65.21044900000106,78.01507931713262,5550.52002,6249.600098,83.31666333080663,-16.683336669193373,239.9677722485594,226.87889256109133,0.058896572119121915,1292000.0
127,BSESN,2004-01-14,6194.1098630000015,6215.02002,6162.180176,6162.180176,35600.0,61.139648000000314,0.0,61.139648000000314,80.92872459477336,5560.22998,6249.600098,91.95058887075254,-8.049411129247469,241.9252444398344,229.88816293684113,0.06082417149152319,1327600.0
128,BSESN,2004-01-15,6063.910156,6248.810059,6045.299805,6219.810059,38000.0,-130.1997070000007,130.1997070000007,0.0,61.048483945614194,5650.740234000001,6249.600098,68.9927555405516,-31.0072444594484,230.31604154461456,229.9737386583958,0.00619260858396653,1289600.0
129,BSESN,2004-01-16,5946.189941,6072.029785,5914.02002,6068.660156,47800.0,-117.72021500000028,117.72021500000028,0.0,48.594803498191474,5725.439941,6249.600098,42.11499043793211,-57.8850095620679,209.205422572506,225.82007544121683,-0.015368448253022082,1241800.0
130,BSESN,2004-01-19,6064.100098,6076.970215,5870.990234000001,5967.3901369999985,36200.0,117.91015700000023,0.0,117.91015700000023,58.40197232939024,5762.600098,6249.600098,61.90965092402464,-38.09034907597536,199.6872228309012,220.59350491915262,0.020267034716674903,1278000.0
131,BSESN,2004-01-20,5922.1098630000015,6130.089844,5899.709961,6099.939941,41000.0,-141.9902349999993,141.9902349999993,0.0,46.1643171657078,5801.52002,6249.600098,26.912565168764672,-73.08743483123533,178.6278471462656,212.2003733645739,-0.005860339042472851,1237000.0
132,BSESN,2004-01-21,5758.189941,5962.3598630000015,5728.319824,5927.419922,43200.0,-163.91992200000098,163.91992200000098,0.0,36.09066866172721,5728.319824,6249.600098,5.730145276895611,-94.26985472310439,147.01688978221318,199.16367664810008,-0.057354146123818284,1193800.0
133,BSESN,2004-01-22,5593.740234000001,5852.959961,5567.680176,5793.830078,51000.0,-164.44970699999882,164.44970699999882,0.0,28.812654175579908,5567.680176,6249.600098,3.821571589163945,-96.17842841083606,107.45697494403157,180.82233630728447,-0.0859288977537559,1142800.0
134,BSESN,2004-01-23,5816.6401369999985,5832.740234000001,5596.569824,5646.330078,37600.0,222.89990299999863,0.0,222.89990299999863,45.8810298498312,5567.680176,6249.600098,36.50867982707193,-63.49132017292807,93.0188457817876,163.26163820218366,-0.04138588848014735,1180400.0
135,BSESN,2004-01-27,5993.060059,6005.540039,5791.740234000001,5854.350098,45200.0,176.41992200000095,0.0,176.41992200000095,55.60252964149011,5567.680176,6249.600098,62.37974126821308,-37.62025873178692,94.71988877978856,149.55328831770373,-0.022812789088361818,1225600.0
136,BSESN,2004-01-28,5876.049805,6030.549805,5815.200195,5980.879883,47800.0,-117.01025400000073,117.01025400000073,0.0,48.88263370735735,5567.680176,6249.600098,45.220797787456306,-54.77920221254369,85.63925827109324,136.77048230838096,-0.051348791841731245,1177800.0
137,BSESN,2004-01-29,5802.75,5921.720215,5774.310059,5865.209961,45000.0,-73.29980499999965,73.29980499999965,0.0,44.9554838210289,5567.680176,6249.600098,34.47176368019355,-65.52823631980645,71.70171133589429,123.75672811388306,-0.043067946140592506,1132800.0
138,BSESN,2004-01-30,5695.669922,5854.290039,5685.6401369999985,5841.209961,38800.0,-107.08007799999996,107.08007799999996,0.0,39.593771385502144,5567.680176,6248.810059,18.79079881744083,-81.20920118255917,51.423046239244286,109.2899917389548,-0.04213118341084621,1094000.0
139,BSESN,2004-02-03,5620.97998,5715.459961,5550.169922,5715.459961,39600.0,-74.68994199999997,74.68994199999997,0.0,36.12606111927446,5550.169922,6248.810059,10.135412245861277,-89.86458775413873,28.991131526427125,93.23021969644884,-0.07307269188154486,1054400.0
140,BSESN,2004-02-04,5756.759765999999,5769.790039,5574.680176,5633.149902,41800.0,135.77978599999915,0.0,135.77978599999915,46.039277646425795,5550.169922,6248.810059,29.570279899335226,-70.42972010066477,21.917130506982176,78.9676018585552,-0.027920808770041883,1096200.0
141,BSESN,2004-02-05,5720.629883,5820.450195,5648.1401369999985,5756.299805,44600.0,-36.12988299999961,36.12988299999961,0.0,43.94525108496825,5550.169922,6248.810059,24.398821649721434,-75.60117835027856,13.242946777770157,65.82267084239797,-0.006522893198183888,1051600.0
142,BSESN,2004-02-06,5786.350098,5800.939941,5683.6098630000015,5710.129883,37800.0,65.72021500000028,0.0,65.72021500000028,48.83007376312067,5550.169922,6130.089844,40.72634290359831,-59.2736570964017,11.538575466342081,54.965851767186635,0.0344331084288243,1089400.0
143,BSESN,2004-02-09,5926.220215,5935.680176,5807.72998,5810.209961,30400.0,139.8701170000004,0.0,139.8701170000004,57.85008304252195,5550.169922,6130.089844,64.845210301294,-35.15478969870598,21.229318795501968,48.21854517284962,0.01883906781562028,1119800.0
144,BSESN,2004-02-10,5932.52002,5972.939941,5866.620117,5937.459961,44400.0,6.299804999999652,0.0,6.299804999999652,58.23271262093051,5550.169922,6130.089844,65.93153356093876,-34.06846643906125,29.082392028470167,44.3913145439737,-0.010101690689564347,1164200.0
145,BSESN,2004-02-11,5949.779785,5958.910156,5905.22998,5936.410156,37200.0,17.259764999999792,0.0,17.259764999999792,59.397874490017244,5550.169922,6030.549805,83.1862193113528,-16.813780688647196,36.28049030807142,42.76914969679323,0.012547541706889875,1201400.0
146,BSESN,2004-02-12,5936.959961,5986.410156,5886.97998,5973.709961,37600.0,-12.819824000000153,12.819824000000153,0.0,58.010942997464284,5550.169922,6030.549805,80.51753470284262,-19.48246529715737,40.483919089650044,42.31210357536459,0.023128682262720135,1163800.0
147,BSESN,2004-02-13,6011.660156,6017.009765999999,5922.379883,5936.649902,32800.0,74.70019500000035,0.0,74.70019500000035,63.70836307893108,5550.169922,6030.549805,96.06776851644311,-3.9322314835568895,49.274774661088486,43.704637792509374,0.055479028512425144,1196600.0
148,BSESN,2004-02-16,6012.350098,6063.910156,6001.569824,6025.850098,30800.0,0.6899419999999736,0.0,0.6899419999999736,63.760766528727125,5550.169922,6063.910156,89.96378819728571,-10.036211802714295,55.65569703363872,46.09484964073525,0.06962666997436973,1227400.0
149,BSESN,2004-02-17,6035.799805,6058.990234000001,5999.129883,6018.950195,30800.0,23.449706999999762,0.0,23.449706999999762,65.70291858644609,5550.169922,6063.910156,94.52829481912832,-5.471705180871676,61.891355774564545,49.25415086750111,0.04847171852611232,1258200.0
150,BSESN,2004-02-18,6027.02002,6082.799805,6018.810059,6060.1401369999985,31200.0,-8.77978499999972,8.77978499999972,0.0,64.21615173503142,5550.169922,6082.799805,89.52747737587984,-10.472522624120165,65.37115143406754,52.47755098081441,0.0535588114012584,1227000.0
151,BSESN,2004-02-19,5855.100098,6041.3598630000015,5845.069824,6041.3598630000015,40400.0,-171.91992200000004,171.91992200000004,0.0,42.491576843173874,5550.169922,6082.799805,57.249918889736804,-42.75008111026319,53.63821155802543,52.70968309625662,0.011881410359833255,1186600.0
152,BSESN,2004-02-20,5850.720215,5893.620117,5770.870117,5847.970215,41000.0,-4.379882999999609,4.379882999999609,0.0,42.07317221542619,5550.169922,6082.799805,56.427606222011484,-43.57239377798852,43.48508589087032,50.86476365517936,-0.012739992315658477,1145600.0
153,BSESN,2004-02-23,5698.040039,5875.22998,5680.3598630000015,5869.6098630000015,28600.0,-152.68017599999985,152.68017599999985,0.0,30.13706648689559,5574.680176,6082.799805,24.277720434217002,-75.722279565783,22.85526681574447,45.26286428729237,-0.0395245157554478,1117000.0
154,BSESN,2004-02-24,5734.439941,5748.149902,5606.839844,5686.810059,42400.0,36.3999019999992,0.0,36.3999019999992,35.19454917104926,5606.839844,6082.799805,26.80899812074732,-73.19100187925268,9.335523402936815,38.077396110421255,-0.03619290995322111,1159400.0
155,BSESN,2004-02-25,5618.149902,5746.790039,5606.8598630000015,5746.790039,33800.0,-116.29003899999952,116.29003899999952,0.0,27.7810067698569,5606.839844,6082.799805,2.3762624856589643,-97.62373751434103,-10.639900858923284,28.33393671655234,-0.05369920988085963,1125600.0
156,BSESN,2004-02-26,5567.120117,5723.310059,5556.310059,5639.830078,34400.0,-51.02978499999973,51.02978499999973,0.0,25.10359360683735,5556.310059,6082.799805,2.053232390968549,-97.94676760903145,-30.23963912727595,16.619221547786676,-0.07394630226333099,1091200.0
157,BSESN,2004-02-27,5667.509765999999,5683.290039,5551.6401369999985,5595.830078,41600.0,100.38964899999884,0.0,100.38964899999884,38.54736267774972,5551.6401369999985,6082.799805,21.814462953538946,-78.18553704646105,-37.24269475587789,5.8468382870537585,-0.05735533133952253,1132800.0
158,BSESN,2004-03-01,5823.169922,5831.549805,5649.299805,5649.299805,32200.0,155.66015600000082,0.0,155.66015600000082,53.48519813242992,5551.6401369999985,6082.799805,51.12018124840023,-48.879818751599764,-29.887721968968435,-1.300073764150682,-0.03522812052577673,1165000.0
159,BSESN,2004-03-03,5842.200195,5870.629883,5792.970215,5830.77002,39400.0,19.030273000000307,0.0,19.030273000000307,55.02729487754112,5551.6401369999985,6082.799805,54.70295948750409,-45.29704051249591,-22.266600036814452,-5.493379018683438,-0.030665208409246247,1204400.0
160,BSESN,2004-03-04,5815.870117,5872.75,5769.339844,5842.410156,36200.0,-26.33007799999996,26.33007799999996,0.0,52.26127389265415,5551.6401369999985,6082.799805,49.74586662329214,-50.25413337670786,-18.142282248212723,-8.023159664589297,-0.006700138399580835,1168200.0
161,BSESN,2004-03-05,5880.350098,5892.779785,5818.77002,5834.370117,37600.0,64.4799809999995,0.0,64.4799809999995,58.19857477825825,5551.6401369999985,6082.799805,61.88533896741585,-38.114661032584145,-9.560545708533937,-8.330636873378225,0.005064313778675444,1205800.0
162,BSESN,2004-03-08,5935.189941,5951.029785,5898.569824,5899.259765999999,36400.0,54.83984299999975,0.0,54.83984299999975,62.74548477497258,5551.6401369999985,6082.799805,72.20988849627797,-27.79011150372202,1.646662759890205,-6.3351769467245385,0.04161955696640196,1242200.0
163,BSESN,2004-03-09,5850.6098630000015,5923.350098,5794.819824,5923.350098,37600.0,-84.58007799999905,84.58007799999905,0.0,52.56945187433067,5551.6401369999985,6082.799805,56.286225030173476,-43.713774969826524,3.661365392672451,-4.335868478845141,0.0202582855859057,1204600.0
164,BSESN,2004-03-10,5759.290039,5833.189941,5745.560059,5833.189941,35000.0,-91.31982400000015,91.31982400000015,0.0,43.73346939358724,5551.6401369999985,6041.3598630000015,42.40178432183487,-57.59821567816513,-2.08664053933353,-3.8860228909428187,0.02512217357350255,1169600.0
165,BSESN,2004-03-11,5649.8598630000015,5763.709961,5634.399902,5737.689941,36200.0,-109.43017599999985,109.43017599999985,0.0,35.48634405610591,5551.6401369999985,5951.029785,24.59245663773506,-75.40754336226495,-15.2957342427826,-6.167965161310776,0.014862216776559745,1133400.0
166,BSESN,2004-03-12,5700.399902,5735.939941,5570.810059,5632.129883,38400.0,50.540038999999524,0.0,50.540038999999524,41.37748596614169,5551.6401369999985,5951.029785,37.246775359585975,-62.75322464041403,-21.438754305991097,-9.222122990246843,0.005803278222352937,1171800.0
167,BSESN,2004-03-15,5520.660156,5764.200195,5505.97998,5745.060059,38400.0,-179.7397460000002,179.7397460000002,0.0,30.09889511992492,5505.97998,5951.029785,3.298546777253359,-96.70145322274664,-40.345526305623025,-15.44680365332208,-0.051949328295764596,1133400.0
168,BSESN,2004-03-16,5525.089844,5551.919922,5434.970215,5471.169922,40800.0,4.429688000000168,0.0,4.429688000000168,30.636543559443012,5434.970215,5951.029785,17.463028347676975,-82.53697165232302,-54.345380986526834,-23.226519119963037,-0.05427926815506878,1174200.0
169,BSESN,2004-03-17,5535.689941,5560.149902,5482.629883,5545.830078,33400.0,10.60009699999955,0.0,10.60009699999955,32.079001045305716,5434.970215,5951.029785,19.517073581253317,-80.48292641874669,-63.84901689816252,-31.351018675602937,-0.048175108859639715,1207600.0
170,BSESN,2004-03-18,5414.939941,5540.680176,5399.049805,5539.720215,36000.0,-120.75,120.75,0.0,25.192871684235485,5399.049805,5951.029785,2.8787522330067086,-97.12124776699329,-80.19972239002618,-41.120759418487594,-0.07914667481419069,1171600.0
171,BSESN,2004-03-19,5443.439941,5496.680176,5386.620117,5410.47998,30600.0,28.5,0.0,28.5,29.32456842698174,5386.620117,5951.029785,10.067124505740981,-89.93287549425902,-89.82264620220485,-50.86113677523105,-0.08285328774451095,1202200.0
172,BSESN,2004-03-22,5365.399902,5446.879883,5347.049805,5446.879883,25400.0,-78.04003899999951,78.04003899999951,0.0,24.96761397407603,5347.049805,5951.029785,3.0381962329281937,-96.96180376707181,-102.56376034264485,-61.20166148871383,-0.08293322787911916,1176800.0
173,BSESN,2004-03-23,5400.990234000001,5450.379883,5324.779785,5356.970215,31800.0,35.59033200000067,0.0,35.59033200000067,30.408504972086448,5324.779785,5951.029785,12.169333173652864,-87.83066682634714,-108.53818571534066,-70.66896633403921,-0.0622124953898332,1208600.0
174,BSESN,2004-03-24,5395.279785,5435.399902,5345.149902,5412.129883,26600.0,-5.710449000001062,5.710449000001062,0.0,30.00568505165785,5324.779785,5951.029785,11.25748502994012,-88.74251497005989,-112.43763436288555,-79.02269993980849,-0.0450595384970881,1182000.0
175,BSESN,2004-03-25,5414.439941,5438.8598630000015,5368.879883,5403.379883,27000.0,19.160155999999915,0.0,19.160155999999915,33.42024508797503,5324.779785,5951.029785,14.316990978043897,-85.6830090219561,-112.68297344884195,-85.7547546416152,-0.05016489472952079,1209000.0
176,BSESN,2004-03-26,5528.939941,5552.339844,5448.290039,5448.290039,32400.0,114.5,0.0,114.5,50.178914215061084,5324.779785,5923.350098,34.107965524845504,-65.89203447515449,-102.45716115042887,-89.09523594337794,0.0014997816866160196,1241400.0
177,BSESN,2004-03-29,5571.370117,5578.740234000001,5495.310059,5538.52002,27800.0,42.430176000000756,0.0,42.430176000000756,55.019912046303446,5324.779785,5833.189941,48.50224353110694,-51.497756468893066,-89.8931419290875,-89.25481714051986,0.008376383788629038,1269200.0
178,BSESN,2004-03-30,5520.439941,5608.310059,5509.580078,5595.930176,26600.0,-50.930176000000756,50.930176000000756,0.0,48.49377825888287,5324.779785,5764.200195,44.52687029262014,-55.473129707379854,-83.08791595700495,-88.02143690381689,-0.0027548508248359527,1242600.0
179,BSESN,2004-03-31,5590.600098,5599.600098,5493.120117,5513.120117,26200.0,70.16015700000025,0.0,70.16015700000025,56.66422701317222,5324.779785,5764.200195,60.49339242116674,-39.50660757883326,-71.21249865864775,-84.65964925478308,0.03243990864422419,1268800.0
180,BSESN,2004-04-01,5740.850098,5750.290039,5599.120117,5599.120117,28400.0,150.25,0.0,150.25,68.86741365602457,5324.779785,5764.200195,94.68616011714148,-5.313839882858519,-49.1111132717906,-77.54994205818458,0.05463643582432254,1297200.0
181,BSESN,2004-04-02,5788.080078,5799.160156,5700.600098,5762.810059,33000.0,47.22998000000007,0.0,47.22998000000007,71.75249455158782,5324.779785,5799.160156,97.66430512783592,-2.335694872164083,-27.467911493542488,-67.53353594525616,0.07877887645288872,1330200.0
182,BSESN,2004-04-05,5838.02002,5905.350098,5798.370117,5809.740234000001,24000.0,49.939941999999974,0.0,49.939941999999974,74.62182970873315,5324.779785,5905.350098,88.40276939892378,-11.59723060107621,-6.214152303362425,-55.269659216877415,0.08091660363479924,1354200.0
183,BSESN,2004-04-06,5822.419922,5897.560059,5780.939941,5886.02002,27400.0,-15.600097999999885,15.600097999999885,0.0,71.98623961819928,5324.779785,5905.350098,85.71573948184295,-14.284260518157051,9.264018301231772,-42.362923713255576,0.07916922829239348,1326800.0
184,BSESN,2004-04-07,5815.129883,5860.669922,5774.879883,5827.069824,22800.0,-7.290039000000434,7.290039000000434,0.0,70.64094044104262,5324.779785,5905.350098,84.4600709027297,-15.5399290972703,20.70367595886728,-29.749603778831005,0.0740039498759304,1304000.0
185,BSESN,2004-04-08,5838.450195,5864.549805,5783.740234000001,5824.370117,28600.0,23.32031200000074,0.0,23.32031200000074,72.53543974557144,5324.779785,5905.350098,88.47686464464476,-11.52313535535523,31.2907400307613,-17.541535016912544,0.055980035468430334,1332600.0
186,BSESN,2004-04-12,5783.790039,5867.069824,5760.25,5856.439941,19800.0,-54.66015599999992,54.66015599999992,0.0,61.75769686278907,5324.779785,5905.350098,79.06195747904192,-20.93804252095808,34.86850658320327,-7.059526696889378,0.038127052688860186,1312800.0
187,BSESN,2004-04-13,5904.52002,5920.180176,5743.580078,5823.529785,23400.0,120.7299809999995,0.0,120.7299809999995,72.26160773633875,5345.149902,5920.180176,97.2766379948893,-2.723362005110695,46.90511510993201,3.7334016644749033,0.0695741794322331,1336200.0
188,BSESN,2004-04-15,5843.970215,5927.040039,5824.209961,5923.839844,32400.0,-60.549804999999644,60.549804999999644,0.0,62.3510856950794,5368.879883,5927.040039,85.1172063955063,-14.882793604493694,50.97079337195646,13.180880005971217,0.04532073705122319,1303800.0
189,BSESN,2004-04-16,5862.819824,5903.129883,5843.77002,5870.410156,23000.0,18.849608999999877,0.0,18.849608999999877,64.11872745421843,5448.290039,5927.040039,86.58585587467357,-13.41414412532643,55.07896192493354,21.560496389763685,0.021245934646942244,1326800.0
190,BSESN,2004-04-19,5800.540039,5895.169922,5782.370117,5875.529785,22000.0,-62.27978499999973,62.27978499999973,0.0,54.384345788891224,5493.120117,5927.040039,70.84715552654437,-29.15284447345563,52.70174589606631,27.788746291024214,0.00215269326479417,1304800.0
191,BSESN,2004-04-20,5804.810059,5819.919922,5765.379883,5814.879883,20800.0,4.27001999999993,0.0,4.27001999999993,54.92570204261718,5493.120117,5927.040039,71.8312126724617,-28.168787327538297,50.57929323746157,32.34685568031169,-0.0056885657956341484,1325600.0
192,BSESN,2004-04-21,5876.419922,5890.02002,5783.919922,5803.700195,21400.0,71.60986299999969,0.0,71.60986299999969,63.343698437184464,5493.120117,5927.040039,88.33422610174594,-11.665773898254063,54.05246657697353,36.68797785964406,0.009274494234941866,1347000.0
193,BSESN,2004-04-22,5924.180176,5947.569824,5863.600098,5888.169922,23800.0,47.76025399999981,0.0,47.76025399999981,67.94997332027224,5599.120117,5947.569824,93.28751107258061,-6.712488927419394,59.96756484564685,41.34389525684462,0.018752855945453284,1370800.0
194,BSESN,2004-04-23,5925.580078,5979.25,5905.580078,5941.100098,31200.0,1.3999020000001108,0.0,1.3999020000001108,68.08560674000232,5700.600098,5979.25,80.73929988319178,-19.26070011680823,64.03018305772093,45.88115281701989,0.014923460865456484,1402000.0
195,BSESN,2004-04-27,5712.279785,5841.299805,5704.279785,5841.299805,30600.0,-213.30029300000027,213.30029300000027,0.0,39.03963962990469,5704.279785,5979.25,2.9094060242124744,-97.09059397578753,49.46805376029897,46.59853300567571,-0.01236390904887763,1371400.0
196,BSESN,2004-04-28,5713.089844,5757.52002,5659.830078,5709.430176,26000.0,0.8100590000003649,0.0,0.8100590000003649,39.15338665482352,5659.830078,5979.25,16.6739023873408,-83.3260976126592,37.559859684839466,44.79079834150847,-0.03242095468413697,1397400.0
197,BSESN,2004-04-29,5668.430176,5710.560059,5626.410156,5710.560059,32600.0,-44.65966800000024,44.65966800000024,0.0,34.999102716777244,5626.410156,5979.25,11.909091536725631,-88.09090846327436,24.239451623519017,40.680528997910585,-0.03003780521492616,1364800.0
198,BSESN,2004-04-30,5655.089844,5710.450195,5632.990234000001,5674.759765999999,25000.0,-13.340331999999762,13.340331999999762,0.0,33.764338203429475,5626.410156,5979.25,8.128245289667502,-91.8717547103325,12.462815625464827,35.03698632342144,-0.03543175233692808,1339800.0
199,BSESN,2004-05-03,5584.990234000001,5645.8598630000015,5506.0,5645.8598630000015,26800.0,-70.09960999999929,70.09960999999929,0.0,27.81461058717497,5506.0,5979.25,16.691016164817913,-83.30898383518208,-2.497910467894144,27.53000696515832,-0.037160299480866965,1313000.0
200,BSESN,2004-05-04,5647.149902,5677.1098630000015,5616.410156,5616.410156,22800.0,62.159667999999336,0.0,62.159667999999336,38.841148056209214,5506.0,5979.25,29.82565282620182,-70.17434717379818,-9.232205707849062,20.177564430556842,-0.027160261127848306,1335800.0
201,BSESN,2004-05-05,5686.189941,5695.180176,5648.6401369999985,5665.669922,31400.0,39.040038999999524,0.0,39.040038999999524,44.93655488680436,5506.0,5979.25,38.07500073956675,-61.92499926043325,-11.288848018476529,13.884281940750167,-0.03237174734362025,1367200.0
202,BSESN,2004-05-06,5757.299805,5772.6401369999985,5739.259765999999,5749.97998,25000.0,71.10986400000002,0.0,71.10986400000002,54.472880262372804,5506.0,5979.25,53.10085684099306,-46.89914315900694,-7.098948737590035,9.687635805082126,-0.028169361167654006,1392200.0
203,BSESN,2004-05-07,5669.580078,5748.339844,5645.790039,5748.339844,22800.0,-87.7197269999997,87.7197269999997,0.0,43.70034595787541,5506.0,5979.25,34.56525684099312,-65.43474315900689,-10.732948492107425,5.603518945644215,-0.04320252137853231,1369400.0
204,BSESN,2004-05-10,5555.839844,5628.6098630000015,5501.169922,5628.6098630000015,24800.0,-113.74023399999987,113.74023399999987,0.0,33.7227611879448,5501.169922,5979.25,11.435306450899644,-88.56469354910035,-22.531080321106856,-0.02340090770600086,-0.027386603403215415,1344600.0
205,BSESN,2004-05-11,5325.899902,5472.029785,5309.419922,5472.029785,33200.0,-229.939942,229.939942,0.0,22.003846994307224,5309.419922,5979.25,2.4603224819653544,-97.53967751803465,-49.86065160951421,-9.990851048067647,-0.06777242307971654,1311400.0
206,BSESN,2004-05-12,5358.350098,5387.870117,5296.25,5296.25,28800.0,32.45019599999978,0.0,32.45019599999978,26.181025808719255,5296.25,5979.25,9.092254465592955,-90.90774553440704,-68.11587695706294,-21.61585622986671,-0.05470298978240429,1340200.0
207,BSESN,2004-05-13,5399.470215,5487.339844,5131.029785,5234.509765999999,45200.0,41.12011700000039,0.0,41.12011700000039,31.541717237933753,5131.029785,5979.25,31.64749262666423,-68.35250737333577,-78.36191768275694,-32.96506852044477,-0.045201691936196164,1385400.0
208,BSESN,2004-05-14,5069.870117,5416.040039,5043.990234000001,5409.339844,49400.0,-329.6000979999999,329.6000979999999,0.0,18.868775856154556,5043.990234000001,5841.299805,3.2459014592714137,-96.75409854072858,-111.78931192343043,-48.72991720104191,-0.09223294856705033,1336000.0
209,BSESN,2004-05-17,4505.160156,5020.8901369999985,4227.5,5020.8901369999985,34000.0,-564.7099610000006,564.7099610000006,0.0,10.516022885463713,4227.5,5772.6401369999985,17.969901198676855,-82.03009880132315,-181.75299754712614,-75.33453327025877,-0.20222408928715563,1302000.0
210,BSESN,2004-05-18,4877.02002,4949.27002,4547.700195,4547.700195,37200.0,371.859864,0.0,371.859864,33.03837177785779,4227.5,5772.6401369999985,42.036317900659164,-57.96368209934083,-204.83255934436875,-101.23413848508078,-0.14230441286625317,1339200.0
211,BSESN,2004-05-19,5006.100098,5059.8901369999985,4892.459961,4941.720215,39600.0,129.08007799999996,0.0,129.08007799999996,39.17049028919041,4227.5,5772.6401369999985,50.390257773751735,-49.60974222624827,-210.28357738366412,-123.04402626479745,-0.13047778167598822,1378800.0
212,BSESN,2004-05-20,4932.1098630000015,5073.700195,4912.169922,5048.169922,37000.0,-73.99023499999929,73.99023499999929,0.0,36.93348059644147,4227.5,5772.6401369999985,45.60168014067983,-54.39831985932017,-218.06027844928576,-142.04727670169515,-0.13007492704118373,1341800.0
213,BSESN,2004-05-21,4961.569824,4978.560059,4804.899902,4922.47998,32200.0,29.45996099999957,0.0,29.45996099999957,38.54585431849201,4227.5,5772.6401369999985,47.50830079563203,-52.49169920436797,-219.31803575420054,-157.50142851219624,-0.10696313009126401,1374000.0
214,BSESN,2004-05-24,5123.22998,5132.899902,4993.450195,4993.450195,26600.0,161.66015599999992,0.0,161.66015599999992,47.107880499688726,4227.5,5772.6401369999985,57.97079232820427,-42.02920767179573,-204.9081412035739,-166.9827710504718,-0.03805364834661884,1400600.0
215,BSESN,2004-05-25,5102.220215,5143.930176,4976.009765999999,5117.52002,29000.0,-21.009764999999792,21.009764999999792,0.0,46.143818413847654,4227.5,5772.6401369999985,56.61106032093198,-43.38893967906801,-192.95919481104102,-172.17805580258565,-0.04780013965410734,1371600.0
216,BSESN,2004-05-26,5081.950195,5163.6098630000015,5049.209961,5116.580078,31400.0,-20.27001999999993,20.27001999999993,0.0,45.11598490851625,4227.5,5748.339844,56.182786002810715,-43.817213997189285,-183.01550104770558,-174.34554485160965,-0.05880577304008705,1340200.0
217,BSESN,2004-05-27,5058.549805,5107.600098,5019.3901369999985,5054.450195,25000.0,-23.400390000000698,23.400390000000698,0.0,43.815940451630546,4227.5,5628.6098630000015,59.31367888743488,-40.686321112565125,-175.0059087269301,-174.47761762667375,-0.0022328603571207806,1315200.0
218,BSESN,2004-05-28,4835.3901369999985,5026.919922,4821.589844,5026.919922,37000.0,-223.15966800000027,223.15966800000027,0.0,33.267496514915535,4227.5,5487.339844,48.25138210186647,-51.74861789813353,-184.5381278131017,-176.48971966395936,0.07330038657120697,1278200.0
219,BSESN,2004-05-31,4759.620117,4830.080078,4665.209961,4760.279785,35000.0,-75.77001999999902,75.77001999999902,0.0,30.400262157266056,4227.5,5487.339844,42.23712399113489,-57.76287600886511,-195.94772383513646,-180.3813204981948,-0.02407205681308633,1243200.0
220,BSESN,2004-06-01,4835.120117,4899.529785,4792.009765999999,4792.009765999999,30800.0,75.5,0.0,75.5,36.675264772303294,4227.5,5487.339844,48.229949218846926,-51.770050781153074,-196.63105171227107,-183.63126674101008,-0.0341543272513285,1274000.0
221,BSESN,2004-06-02,4923.689941,4946.149902,4846.089844,4846.089844,26400.0,88.56982399999924,0.0,88.56982399999924,43.56272466660324,4227.5,5416.040039,58.575219862660376,-41.424780137339624,-187.86021402077586,-184.47705619696325,-0.0017071643239675582,1300400.0
222,BSESN,2004-06-03,4817.990234000001,5012.52002,4789.629883,4972.27002,34000.0,-105.69970699999884,105.69970699999884,0.0,37.8882443889381,4227.5,5163.6098630000015,63.079159545186826,-36.92084045481317,-187.2795031234864,-185.0375455822679,-0.028938339092897447,1266400.0
223,BSESN,2004-06-04,4889.0,4902.27002,4759.350098,4803.310059,38400.0,71.00976599999922,0.0,71.00976599999922,43.584645732270545,4547.700195,5163.6098630000015,55.41393855827557,-44.58606144172443,-179.02569428954394,-183.83517532372312,-0.04571920076092306,1304800.0
224,BSESN,2004-06-07,4938.149902,4991.47998,4905.529785,4927.5,31800.0,49.149902000000104,0.0,49.149902000000104,47.43479543005315,4665.209961,5163.6098630000015,54.76324130577367,-45.23675869422633,-166.59806629417744,-180.387753517814,-0.03215665065134787,1336600.0
225,BSESN,2004-06-08,4962.629883,4970.3901369999985,4891.8598630000015,4960.870117,31000.0,24.479980999999494,0.0,24.479980999999494,49.41863772304016,4665.209961,5163.6098630000015,59.67495595534827,-40.32504404465174,-153.00994830049785,-174.91219247435077,-0.023479236793268243,1367600.0
226,BSESN,2004-06-09,4963.75,5000.589844,4945.240234000001,4972.339844,33000.0,1.1201170000003913,0.0,1.1201170000003913,49.51922314319473,4665.209961,5163.6098630000015,59.899698575783276,-40.10030142421672,-140.53092973087587,-168.0359399256558,-0.018740510354627204,1400600.0
227,BSESN,2004-06-10,4944.6401369999985,4975.75,4919.939941,4954.060059,27000.0,-19.109863000000587,19.109863000000587,0.0,47.65377196796059,4665.209961,5163.6098630000015,56.065455646898954,-43.934544353101046,-130.67686228211642,-160.56412439694793,0.022593833569710897,1373600.0
228,BSESN,2004-06-11,4832.709961,4945.8598630000015,4823.100098,4931.490234000001,27600.0,-111.93017599999985,111.93017599999985,0.0,37.983431214456616,4665.209961,5163.6098630000015,33.60755074947815,-66.39244925052185,-130.39614679746592,-154.53052887705155,0.015356234784146494,1346000.0
229,BSESN,2004-06-14,4746.009765999999,4810.419922,4725.3901369999985,4810.419922,29600.0,-86.70019500000035,86.70019500000035,0.0,32.152021304195955,4665.209961,5163.6098630000015,16.2118420721518,-83.7881579278482,-135.6064717736317,-150.7457174563676,-0.018429811223653836,1316400.0
230,BSESN,2004-06-15,4814.850098,4824.029785,4696.509765999999,4696.509765999999,30000.0,68.84033200000067,0.0,68.84033200000067,40.51832043377401,4665.209961,5107.600098,33.82537820909877,-66.17462179090123,-132.65172595452532,-147.12691915599916,-0.022105340568600917,1346400.0
231,BSESN,2004-06-16,4788.799805,4863.629883,4772.100098,4837.3598630000015,27400.0,-26.050293000000238,26.050293000000238,0.0,38.44822515807608,4665.209961,5026.919922,34.16821689353474,-65.83178310646525,-130.90313959202194,-143.88216324320373,-0.006058631832420058,1319000.0
232,BSESN,2004-06-17,4839.879883,4859.810059,4746.509765999999,4791.299805,28600.0,51.080077999999965,0.0,51.080077999999965,44.8258819643356,4665.209961,5012.52002,50.292215118364844,-49.707784881635156,-123.96662685241336,-139.89905596504568,-0.01004706831662927,1347600.0
233,BSESN,2004-06-18,4769.990234000001,4828.189941,4750.72998,4822.080078,28600.0,-69.88964899999883,69.88964899999883,0.0,38.52411361807099,4696.509765999999,5012.52002,23.252558127433865,-76.74744187256614,-122.69455458170978,-136.4581556883785,-0.03405317200514568,1319000.0
234,BSESN,2004-06-21,4738.620117,4790.930176,4731.720215,4770.649902,23800.0,-31.37011700000039,31.37011700000039,0.0,35.90957510516763,4696.509765999999,5012.52002,13.325628034842527,-86.67437196515748,-122.80214766105473,-133.72695408291375,-0.04513932557561218,1295200.0
235,BSESN,2004-06-22,4735.8598630000015,4767.350098,4717.779785,4732.950195,29200.0,-2.7602539999998044,2.7602539999998044,0.0,35.66383769365511,4696.509765999999,5012.52002,12.452158277117865,-87.54784172288214,-121.70718075586865,-131.32299941750472,-0.045910881289347505,1266000.0
236,BSESN,2004-06-23,4644.0,4752.470215,4635.169922,4742.799805,31400.0,-91.85986300000059,91.85986300000059,0.0,28.24241056784976,4635.169922,5000.589844,2.416419431012838,-97.58358056898716,-126.79017651823506,-130.4164348376508,-0.06080121680652828,1234600.0
237,BSESN,2004-06-24,4708.549805,4717.740234000001,4613.939941,4656.810059,40400.0,64.54980499999965,0.0,64.54980499999965,38.601756738844074,4613.939941,5000.589844,24.469129118079696,-75.5308708819203,-124.17840616541253,-129.16882910320314,-0.025691621678514354,1275000.0
238,BSESN,2004-06-25,4756.3901369999985,4775.660156,4680.419922,4717.830078,39400.0,47.84033199999976,0.0,47.84033199999976,45.34877053816647,4613.939941,5000.589844,36.8421651976979,-63.15783480230209,-116.90068606401019,-126.71520049536454,0.0021871786009297622,1314400.0
239,BSESN,2004-06-28,4837.600098,4844.720215,4772.870117,4784.580078,28600.0,81.20996100000049,0.0,81.20996100000049,55.028368516919436,4613.939941,5000.589844,57.84565191006914,-42.154348089930856,-103.3882796238413,-122.04981632105991,0.004724965375235701,1343000.0
240,BSESN,2004-06-29,4841.379883,4873.709961,4802.040039,4838.740234000001,34200.0,3.77978499999972,0.0,3.77978499999972,55.45209960248945,4613.939941,4975.75,62.861696722478285,-37.138303277521715,-91.3219010801613,-115.90423327288019,0.010979802902827851,1377200.0
241,BSESN,2004-06-30,4795.459961,4877.899902,4788.850098,4859.939941,35600.0,-45.919922000000035,45.919922000000035,0.0,48.98253714121188,4613.939941,4945.8598630000015,54.687895473776024,-45.312104526223976,-84.49060792434193,-109.62150820317255,-0.00917789760775356,1341600.0
242,BSESN,2004-07-01,4874.049805,4879.810059,4785.939941,4813.759765999999,33200.0,78.58984400000007,0.0,78.58984400000007,58.53565108269698,4613.939941,4879.810059,97.83343309006216,-2.1665669099378433,-71.90632397467652,-102.07847135747335,0.02181546835426884,1374800.0
243,BSESN,2004-07-02,4870.580078,4895.47998,4813.160156,4842.459961,32000.0,-3.4697269999996934,3.4697269999996934,0.0,57.98255543853432,4613.939941,4895.47998,91.15582206763845,-8.84417793236154,-61.50418429747242,-93.96361394547317,0.027847761108046543,1342800.0
244,BSESN,2004-07-05,4843.77002,4894.3901369999985,4831.850098,4861.149902,24200.0,-26.810058000000023,26.810058000000023,0.0,53.47748951148713,4613.939941,4895.47998,81.63317722634824,-18.366822773651766,-54.792151451459176,-86.12932144667037,0.022785758050628102,1318600.0
245,BSESN,2004-07-06,4928.589844,4939.399902,4839.180176,4846.419922,29600.0,84.81982400000015,0.0,84.81982400000015,63.75705576412992,4613.939941,4939.399902,96.67852906797343,-3.32147093202657,-42.142770547457076,-77.33201126682772,0.06128118949181749,1348200.0
246,BSESN,2004-07-07,4955.970215,4987.049805,4912.220215,4919.540039,35000.0,27.3803710000002,0.0,27.3803710000002,66.51304299033444,4613.939941,4987.049805,91.67012373599445,-8.329876264005545,-29.567838311711967,-67.77917667580456,0.05254705169249041,1383200.0
247,BSESN,2004-07-08,4843.839844,5004.169922,4808.629883,4972.060059,47800.0,-112.13037100000021,112.13037100000021,0.0,48.930990447870464,4613.939941,5004.169922,58.91395182165673,-41.08604817834327,-28.323600861748673,-59.88806151299338,0.018385730455483307,1335400.0
248,BSESN,2004-07-09,4945.47998,4954.8598630000015,4723.040039,4766.490234000001,23600.0,101.64013599999998,0.0,101.64013599999998,59.99209408699679,4613.939941,5004.169922,84.96016583615601,-15.03983416384399,-18.917949871226483,-51.694039184640005,0.02230028936137174,1359000.0
249,BSESN,2004-07-12,4944.540039,4967.919922,4917.379883,4949.419922,17000.0,-0.9399409999996352,0.9399409999996352,0.0,59.85376428397509,4613.939941,5004.169922,84.71929736223943,-15.280702637760562,-11.408241968381844,-43.63687974138838,0.02130800690981438,1342000.0
250,BSESN,2004-07-13,4898.990234000001,4978.490234000001,4878.060059,4961.870117,16000.0,-45.549804999999644,45.549804999999644,0.0,53.01811385243199,4613.939941,5004.169922,73.04674342794816,-26.953256572051842,-9.028161894553705,-36.715136172021445,0.021589226860818655,1326000.0
251,BSESN,2004-07-14,4848.299805,4933.339844,4835.339844,4911.220215,24600.0,-50.69042900000113,50.69042900000113,0.0,46.23748557466524,4680.419922,5004.169922,51.85479011583,-48.14520988417,-11.104222689852577,-31.59295347558767,-0.005283081016854707,1301400.0
252,BSESN,2004-07-15,4888.189941,4900.180176,4844.660156,4849.379883,26600.0,39.890135999999984,0.0,39.890135999999984,51.83118449658592,4723.040039,5004.169922,58.745054149935186,-41.254945850064814,-9.422103098762818,-27.158783400222703,0.003615557637485889,1328000.0
253,BSESN,2004-07-16,4951.169922,4961.319824,4874.459961,4894.399902,25800.0,62.97998100000041,0.0,62.97998100000041,59.506403567281225,4723.040039,5004.169922,81.14750398128253,-18.852496018717467,-2.972784686677187,-22.3215836575136,0.022172791349825527,1353800.0
254,BSESN,2004-07-19,4975.399902,5009.629883,4942.430176,4957.080078,21600.0,24.229980000000072,0.0,24.229980000000072,62.18143158708368,4723.040039,5009.629883,88.05610815713358,-11.94389184286642,4.046853889168233,-17.047896148177234,0.00949765743988329,1375400.0
255,BSESN,2004-07-20,4957.879883,4982.040039,4936.600098,4974.52002,21800.0,-17.520019000000502,17.520019000000502,0.0,58.93331024650135,4723.040039,5009.629883,81.94283535043895,-18.05716464956105,8.10284437917926,-12.017748042705934,0.00038532677097613544,1353600.0
256,BSESN,2004-07-21,4993.759765999999,5041.189941,4951.549805,4973.879883,20200.0,35.87988299999961,0.0,35.87988299999961,63.44540172536562,4723.040039,5041.189941,85.09187816754363,-14.908121832456366,14.050487481146774,-6.804100937935392,0.03095063561725775,1373800.0
257,BSESN,2004-07-22,5054.290039,5082.810059,5020.689941,5041.1401369999985,37400.0,60.53027300000122,0.0,60.53027300000122,69.88599944628945,4723.040039,5082.810059,92.07270800385203,-7.927291996147965,23.378828060356682,-0.767515138276975,0.022001920832768196,1411200.0
258,BSESN,2004-07-23,5073.339844,5086.029785,5034.200195,5073.100098,35000.0,19.04980499999965,0.0,19.04980499999965,71.69685834681675,4723.040039,5086.029785,96.50404973147653,-3.49595026852347,31.940574173890127,5.774102724156448,0.026048895141730588,1446200.0
259,BSESN,2004-07-26,5118.169922,5126.450195,5034.22998,5046.990234000001,28600.0,44.830077999999965,0.0,44.830077999999965,75.6696153328669,4723.040039,5126.450195,97.94743070375246,-2.0525692962475413,41.86068832217916,12.991419843760992,0.044739768305486205,1474800.0
260,BSESN,2004-07-27,5075.879883,5155.629883,5068.620117,5130.8598630000015,40800.0,-42.29003900000043,42.29003900000043,0.0,65.64083838188728,4723.040039,5155.629883,81.56452327623296,-18.435476723767042,45.78224828644761,19.54958553229832,0.0469401825698359,1434000.0
261,BSESN,2004-07-28,5070.290039,5104.660156,5045.459961,5087.660156,28000.0,-5.589843999999175,5.589843999999175,0.0,64.34031214356824,4723.040039,5155.629883,80.27234222354991,-19.727657776450098,47.88704704773227,25.217077835385112,0.03725307326391403,1406000.0
262,BSESN,2004-07-29,5120.450195,5133.799805,5051.490234000001,5082.6098630000015,28800.0,50.16015599999992,0.0,50.16015599999992,70.41035609066105,4835.339844,5155.629883,89.01630281421293,-10.98369718578707,52.99176453203745,30.772015174715584,0.03418995422633775,1434800.0
263,BSESN,2004-07-30,5170.319824,5200.850098,5134.919922,5134.919922,28800.0,49.86962899999981,0.0,49.86962899999981,75.24442169311406,4835.339844,5200.850098,91.64721819268038,-8.352781807319625,60.365496327015535,36.690711405175584,0.03917673470260086,1463600.0
264,BSESN,2004-08-02,5202.529785,5210.919922,5167.290039,5193.25,22000.0,32.20996099999957,0.0,32.20996099999957,77.93131943292255,4835.339844,5210.919922,97.76608571874243,-2.2339142812575705,68.02416631294818,42.95740238673011,0.0493456694743406,1485600.0
265,BSESN,2004-08-03,5194.629883,5242.149902,5181.990234000001,5213.549805,29400.0,-7.899902000000111,7.899902000000111,0.0,75.60895324943415,4844.660156,5242.149902,88.04496984432889,-11.955030155671105,72.61915299402608,48.88975250818931,0.040224225115437884,1456200.0
266,BSESN,2004-08-04,5169.069824,5201.560059,5145.220215,5189.879883,27200.0,-25.56005899999945,25.56005899999945,0.0,68.03944781574006,4874.459961,5242.149902,80.12453704845849,-19.875462951541515,73.352666025482,53.78233521164786,0.022709378392283375,1429000.0
267,BSESN,2004-08-05,5252.779785,5257.319824,5178.6098630000015,5178.6098630000015,24000.0,83.70996099999957,0.0,83.70996099999957,76.81192386955586,4936.600098,5257.319824,98.58442165169458,-1.4155783483054079,79.76914558416229,58.97969728615076,0.035369193966419354,1453000.0
268,BSESN,2004-08-06,5196.990234000001,5262.8901369999985,5166.189941,5249.72998,30200.0,-55.789550999998944,55.789550999998944,0.0,63.424714091238414,4936.600098,5262.8901369999985,79.80327465650952,-20.196725343490492,79.43680333262364,63.07111849544534,0.015400096753567905,1422800.0
269,BSESN,2004-08-09,5233.209961,5240.290039,5154.319824,5176.3901369999985,26200.0,36.21972699999878,0.0,36.21972699999878,67.64844979663332,4951.549805,5262.8901369999985,90.46696719010403,-9.533032809895973,81.1604814595803,66.68899108827233,0.03099562669458078,1449000.0
270,BSESN,2004-08-10,5252.049805,5266.990234000001,5214.990234000001,5248.459961,26000.0,18.839844000000085,0.0,18.839844000000085,69.74536541183043,5020.689941,5266.990234000001,93.93405959123197,-6.065940408768033,83.0889292960419,69.96897872982625,0.035848001712313726,1475000.0
271,BSESN,2004-08-11,5175.160156,5269.220215,5159.529785,5263.27002,28600.0,-76.88964899999974,76.88964899999974,0.0,53.435389485650795,5034.200195,5269.220215,59.977852525074084,-40.022147474925916,77.51929188127542,71.47904136011609,0.010684599774727355,1446400.0
272,BSESN,2004-08-12,5139.77002,5194.040039,5117.799805,5167.52002,27000.0,-35.390135999999984,35.390135999999984,0.0,47.532182854683306,5034.22998,5269.220215,44.91252157775823,-55.08747842224177,69.44906036014527,71.07304516012192,-0.005908687477743979,1419400.0
273,BSESN,2004-08-13,5102.919922,5144.700195,5084.509765999999,5126.910156,93800.0,-36.85009799999989,36.85009799999989,0.0,41.96256548633654,5045.459961,5269.220215,25.679252670136982,-74.32074732986301,59.395178157592454,68.73747175961603,-0.01914642820252488,1325600.0
274,BSESN,2004-08-16,5102.370117,5114.790039,5056.069824,5105.259765999999,24600.0,-0.549804999999651,0.549804999999651,0.0,41.87808772664911,5045.459961,5269.220215,25.43354102556598,-74.56645897443403,50.79747770652375,65.14947294899757,-0.017760604331394148,1301000.0
275,BSESN,2004-08-17,5102.939941,5148.529785,5083.029785,5124.290039,23400.0,0.5698239999992438,0.0,0.5698239999992438,42.0176782438401,5051.490234000001,5269.220215,23.630051664772328,-76.36994833522768,43.52795502025583,60.82516936324922,-0.01279338164343602,1324400.0
276,BSESN,2004-08-18,5038.279785,5103.970215,5025.490234000001,5103.970215,24200.0,-64.66015599999993,64.66015599999993,0.0,31.96582996990942,5025.490234000001,5269.220215,5.247426249132216,-94.75257375086778,32.17833984681329,55.09580345996204,-0.04083552114873212,1300200.0
277,BSESN,2004-08-19,5123.649902,5132.830078,5056.169922,5056.169922,23200.0,85.37011700000039,0.0,85.37011700000039,50.13781022063749,5025.490234000001,5269.220215,40.273940693410026,-59.726059306589974,29.72963825932493,50.02257041983462,-0.014112078087080149,1323400.0
278,BSESN,2004-08-20,5064.660156,5128.100098,5047.75,5128.100098,24000.0,-58.9897460000002,58.9897460000002,0.0,41.33516168419854,5025.490234000001,5269.220215,16.071031491197306,-83.9289685088027,22.76660584657293,44.57137750518229,-0.032207728383936596,1299400.0
279,BSESN,2004-08-23,5033.689941,5080.220215,5022.290039,5064.419922,27400.0,-30.97021500000028,30.97021500000028,0.0,37.36152467593991,5022.290039,5269.220215,4.616650012025751,-95.38334998797426,14.58123161142612,38.57334832643106,-0.04157612210610029,1272000.0
280,BSESN,2004-08-24,5067.3901369999985,5084.740234000001,5040.709961,5048.629883,21000.0,33.70019599999978,0.0,33.70019599999978,44.10768644355373,5022.290039,5269.220215,18.264312094443287,-81.7356879055567,10.690355960548004,32.99674985325445,-0.02082447996803627,1293000.0
281,BSESN,2004-08-25,5088.560059,5093.370117,5054.560059,5073.22998,19000.0,21.169922000000955,0.0,21.169922000000955,48.15491647796037,5022.290039,5269.220215,26.837554272832158,-73.16244572716784,9.208890399186203,28.2391779624408,-0.009963473229488873,1312000.0
282,BSESN,2004-08-26,5135.450195,5145.600098,5105.379883,5105.379883,22400.0,46.890135999999984,0.0,46.890135999999984,56.25114306362641,5022.290039,5269.220215,45.826783033597316,-54.173216966402684,11.683777056179679,24.928097781188576,0.006374835093875264,1334400.0
283,BSESN,2004-08-27,5117.009765999999,5148.75,5094.560059,5147.8598630000015,18800.0,-18.440429000001128,18.440429000001128,0.0,52.5288512781554,5022.290039,5269.220215,38.35891122517114,-61.641088774828866,12.018610989507579,22.34620042285238,0.0028691860183216455,1315600.0
284,BSESN,2004-08-30,5186.450195,5192.799805,5130.540039,5130.540039,14800.0,69.44042900000113,0.0,69.44042900000113,63.1297829970706,5022.290039,5269.220215,66.48039484651727,-33.519605153482736,17.683388480008944,21.413638034283696,0.016365125783478485,1330400.0
285,BSESN,2004-08-31,5192.080078,5202.509765999999,5155.959961,5192.180176,16200.0,5.629882999999609,0.0,5.629882999999609,63.88425946961389,5022.290039,5202.509765999999,94.21279336418075,-5.787206635819246,22.369191841602515,21.60474879574746,0.030526350175688055,1346600.0
286,BSESN,2004-09-01,5210.850098,5222.810059,5202.02002,5202.160156,16200.0,18.77001999999993,0.0,18.77001999999993,66.5198091398145,5022.290039,5222.810059,94.03552772436365,-5.964472275636358,27.28280926878233,22.740360890354438,0.01701915581038449,1362800.0
287,BSESN,2004-09-02,5198.720215,5233.319824,5189.290039,5218.950195,19200.0,-12.129882999999607,12.129882999999607,0.0,63.08696489892939,5022.290039,5233.319824,83.60439546483927,-16.39560453516072,29.85396833278719,24.16308237884099,0.026469704752288603,1343600.0
288,BSESN,2004-09-03,5218.459961,5223.939941,5178.569824,5190.689941,17600.0,19.73974599999929,0.0,19.73974599999929,66.34794089579131,5022.290039,5233.319824,92.95840490004736,-7.041595099952646,33.102873623818596,25.951040627836516,0.036706674857945876,1361200.0
289,BSESN,2004-09-06,5246.22998,5264.870117,5226.089844,5226.089844,17000.0,27.770019000000506,0.0,27.770019000000506,70.56843863780233,5022.290039,5264.870117,92.31588300503377,-7.684116994966225,37.48634368759576,28.258101239788367,0.03529229804000811,1378200.0
290,BSESN,2004-09-07,5264.669922,5270.8901369999985,5240.149902,5245.160156,19200.0,18.439941999999974,0.0,18.439941999999974,73.14861830213138,5022.290039,5270.8901369999985,97.4979032389607,-2.5020967610392937,41.96448405423689,30.999377802678076,0.03460897797374307,1397400.0
291,BSESN,2004-09-08,5298.160156,5305.669922,5270.660156,5281.1098630000015,20200.0,33.49023399999987,0.0,33.49023399999987,77.31599628974162,5022.290039,5305.669922,97.34992974077834,-2.6500702592216605,47.666356465778335,34.33277353529814,0.031683680071207476,1417600.0
292,BSESN,2004-09-09,5298.22998,5328.330078,5269.509765999999,5307.830078,21600.0,0.06982400000015332,0.0,0.06982400000015332,77.3244624852855,5022.290039,5328.330078,90.1646535863891,-9.83534641361091,51.595999084874165,37.78541864521335,0.035415256621966984,1439200.0
293,BSESN,2004-09-10,5370.049805,5376.120117,5281.060059,5305.419922,21200.0,71.81982499999958,0.0,71.81982499999958,84.28530787083702,5040.709961,5376.120117,98.19018241057653,-1.8098175894234774,59.816007129395985,42.19153634204988,0.035399859845757,1460400.0
294,BSESN,2004-09-13,5397.459961,5421.52002,5379.600098,5380.709961,21400.0,27.410155999999915,0.0,27.410155999999915,86.15667836429517,5054.560059,5421.52002,93.44341030164858,-6.556589698351421,67.76108562403715,47.30544619844734,0.03955637815954338,1481800.0
295,BSESN,2004-09-14,5428.77002,5434.330078,5376.040039,5409.52002,26400.0,31.31005900000036,0.0,31.31005900000036,88.03468948469157,5094.560059,5434.330078,98.36358192627937,-1.6364180737206344,75.7113246423196,52.9866218872218,0.04182041661180014,1508200.0
296,BSESN,2004-09-15,5420.089844,5456.850098,5399.339844,5441.959961,27600.0,-8.680175999999847,8.680175999999847,0.0,84.37322317800216,5094.560059,5456.850098,89.85336331590396,-10.14663668409604,80.38490157530214,58.46627782483788,0.04258156235476496,1480600.0
297,BSESN,2004-09-16,5477.680176,5483.589844,5401.0,5415.459961,23400.0,57.59033199999976,0.0,57.59033199999976,88.14714655146201,5130.540039,5483.589844,98.32610925815402,-1.673890741845968,87.7245692280012,64.31793610547055,0.049673700083410655,1504000.0
298,BSESN,2004-09-17,5561.149902,5569.470215,5493.370117,5493.720215,26400.0,83.46972600000026,0.0,83.46972600000026,91.55706742653024,5155.959961,5569.470215,97.98788230291379,-2.012117697086214,99.1338645423939,71.28112179285522,0.060027852991682895,1530400.0
299,BSESN,2004-09-20,5545.819824,5585.569824,5535.569824,5562.680176,25600.0,-15.330077999999958,15.330077999999958,0.0,86.29598323571673,5178.569824,5585.569824,90.23341523341524,-9.766584766584767,105.7201282726428,78.16892308881273,0.05340313944947073,1504800.0
300,BSESN,2004-09-21,5605.930176,5611.600098,5536.0,5547.490234000001,27600.0,60.110351999999686,0.0,60.110351999999686,89.12360420949912,5178.569824,5611.600098,98.69064073797297,-1.3093592620270347,114.47064641675752,85.42926775440169,0.05808998047208136,1532400.0
301,BSESN,2004-09-22,5616.870117,5638.790039,5571.839844,5609.959961,28000.0,10.939941000000543,0.0,10.939941000000543,89.57530443717822,5178.569824,5638.790039,95.2370797097646,-4.76292029023541,120.89465853052843,92.52234590962705,0.060140865572618996,1560400.0
302,BSESN,2004-09-23,5539.47998,5609.040039,5530.8598630000015,5597.319824,27400.0,-77.39013700000031,77.39013700000031,0.0,66.89778346666608,5226.089844,5638.790039,75.93651270264114,-24.06348729735887,118.37642736616363,97.69316220093438,0.03155095039197686,1533000.0
303,BSESN,2004-09-24,5527.75,5575.399902,5513.680176,5527.220215,22600.0,-11.729980000000069,11.729980000000069,0.0,64.06141045947228,5240.149902,5638.790039,72.1452937891198,-27.854706210880202,114.11871021616844,100.9782718039812,0.02413913951033031,1510400.0
304,BSESN,2004-09-27,5511.810059,5545.72998,5486.410156,5530.0,15800.0,-15.939940999999635,15.939940999999635,0.0,60.06810190263445,5269.509765999999,5638.790039,65.61419894747542,-34.385801052524585,108.21083156918758,102.42478375702248,0.015296289710942768,1494600.0
305,BSESN,2004-09-28,5462.6098630000015,5518.209961,5454.850098,5506.830078,20400.0,-49.20019599999978,49.20019599999978,0.0,49.155331219137665,5269.509765999999,5638.790039,52.29093215060574,-47.70906784939426,98.42417788792409,101.62466258320282,0.00784489191578075,1474200.0
306,BSESN,2004-09-29,5527.560059,5533.330078,5428.200195,5477.6098630000015,23400.0,64.95019599999978,0.0,64.95019599999978,60.17579308168929,5281.060059,5638.790039,68.9067212091086,-31.0932787908914,94.81614089079267,100.2629582447208,0.009106023242931416,1497600.0
307,BSESN,2004-09-30,5583.6098630000015,5598.549805,5545.259765999999,5545.259765999999,24400.0,56.04980400000022,0.0,56.04980400000022,67.24503778678653,5376.040039,5638.790039,78.99898154138955,-21.001018458610442,95.3800148912178,99.28636957402021,0.004038726054106823,1522000.0
308,BSESN,2004-10-01,5675.540039,5685.680176,5573.560059,5587.459961,24400.0,91.93017599999985,0.0,91.93017599999985,75.48165568315488,5376.040039,5685.680176,96.72518650254975,-3.2748134974502454,102.06830611183614,99.84275688158341,0.02339062917958956,1546400.0
309,BSESN,2004-10-04,5766.299805,5785.040039,5706.319824,5706.319824,20600.0,90.75976599999922,0.0,90.75976599999922,80.94114289453876,5399.339844,5785.040039,95.14124331723484,-4.858756682765163,113.3853440295461,102.55127431117597,0.028607139933096493,1567000.0
310,BSESN,2004-10-05,5758.669922,5786.540039,5741.700195,5761.660156,22800.0,-7.629882999999609,7.629882999999609,0.0,79.22985918932417,5401.0,5786.540039,92.77114847207858,-7.228851527921426,120.35117687073034,106.11125482308687,0.02524534163088954,1544200.0
311,BSESN,2004-10-06,5713.75,5799.919922,5699.319824,5761.439941,26800.0,-44.919922000000035,44.919922000000035,0.0,69.27974659833697,5428.200195,5799.919922,76.81857707810053,-23.181422921899465,120.85385922937166,109.05977570434383,0.03145963531399931,1517400.0
312,BSESN,2004-10-07,5773.660156,5793.080078,5718.6401369999985,5718.6401369999985,24600.0,59.91015599999992,0.0,59.91015599999992,74.25525121049475,5428.200195,5799.919922,92.93560064408415,-7.064399355915849,124.64960447054636,112.17774145758435,0.04448648292704993,1542000.0
313,BSESN,2004-10-08,5776.850098,5803.819824,5755.419922,5782.629883,19600.0,3.1899419999999736,0.0,3.1899419999999736,74.50889905452942,5428.200195,5803.819824,92.81993700068314,-7.180062999316865,126.45743894187217,115.03368095444193,0.04808584406264638,1561600.0
314,BSESN,2004-10-11,5717.540039,5792.080078,5706.970215,5764.8598630000015,13000.0,-59.310058999999455,59.310058999999455,0.0,61.50814302562346,5428.200195,5803.819824,77.03001165575408,-22.96998834424592,121.70143629768518,116.36723202309058,0.04666820117005277,1548600.0
315,BSESN,2004-10-12,5676.72998,5762.600098,5663.790039,5750.3598630000015,18200.0,-40.810059000000365,40.810059000000365,0.0,54.024122696400006,5428.200195,5803.819824,66.16528152739319,-33.83471847260681,113.3328091628855,115.76034745104957,0.02698657624843359,1530400.0
316,BSESN,2004-10-14,5713.100098,5738.6098630000015,5645.660156,5677.870117,17600.0,36.37011799999982,0.0,36.37011799999982,59.136922715832604,5428.200195,5803.819824,75.84798051115685,-24.152019488843145,108.38597043141363,114.2854720471224,0.023191132292044614,1548000.0
317,BSESN,2004-10-15,5686.72998,5758.1098630000015,5673.75,5735.490234000001,16200.0,-26.37011799999982,26.37011799999982,0.0,54.103436304726245,5428.200195,5803.819824,68.82754921202476,-31.17245078797523,101.17147516968907,111.66267267163575,0.001971608150608928,1531800.0
318,BSESN,2004-10-18,5679.830078,5727.959961,5670.370117,5706.830078,12400.0,-6.899902000000111,6.899902000000111,0.0,52.747951865942106,5428.200195,5803.819824,66.99061059985226,-33.00938940014774,93.81572202538791,108.09328254238619,-0.0149957043379918,1519400.0
319,BSESN,2004-10-19,5738.1098630000015,5751.600098,5686.970215,5691.470215,14800.0,58.27978500000063,0.0,58.27978500000063,62.021233798842545,5428.200195,5803.819824,82.50624942713026,-17.49375057286974,91.632642188305,104.80115447156994,-0.0035702791232142816,1534200.0
320,BSESN,2004-10-20,5673.02002,5750.1401369999985,5662.759765999999,5738.439941,18400.0,-65.08984300000066,65.08984300000066,0.0,49.501976724642226,5545.259765999999,5803.819824,49.41221586514351,-50.58778413485649,83.68565321987171,100.57805422123032,-0.0071284147888864835,1515800.0
321,BSESN,2004-10-21,5641.060059,5685.180176,5617.370117,5680.439941,19000.0,-31.95996099999957,31.95996099999957,0.0,44.421837668906015,5573.560059,5803.819824,29.31471766246268,-70.68528233753732,73.95618459541402,95.25368029606707,-0.022966384133676687,1496800.0
322,BSESN,2004-10-25,5581.490234000001,5645.879883,5573.189941,5633.47998,18200.0,-59.56982499999958,59.56982499999958,0.0,36.390179041984695,5573.189941,5803.819824,3.598966834666923,-96.40103316533308,60.73856718777188,88.35065767440804,-0.033817713924693016,1478600.0
323,BSESN,2004-10-26,5651.089844,5654.819824,5558.1401369999985,5591.009765999999,22000.0,69.59960999999929,0.0,69.59960999999929,48.85625191342841,5558.1401369999985,5803.819824,37.83369644231147,-62.16630355768853,55.24281227073425,81.72908859367328,-0.011622165222584524,1500600.0
324,BSESN,2004-10-27,5662.870117,5699.180176,5623.040039,5656.709961,19800.0,11.780273000000308,0.0,11.780273000000308,50.74156111739633,5558.1401369999985,5803.819824,42.628668767394345,-57.37133123260566,51.247210540614105,75.63271298306145,-0.0024415223286698984,1520400.0
325,BSESN,2004-10-28,5715.620117,5733.75,5700.990234000001,5700.990234000001,23400.0,52.75,0.0,52.75,58.622367978428535,5558.1401369999985,5803.819824,64.0997153338122,-35.900284666187794,51.74071675724281,70.85431373789773,0.0004410948446156304,1543800.0
326,BSESN,2004-10-29,5672.27002,5731.350098,5664.040039,5724.459961,22600.0,-43.35009700000046,43.35009700000046,0.0,50.90041921261439,5558.1401369999985,5803.819824,46.454749431523275,-53.54525056847672,48.07960173318861,66.2993713369559,-0.002542754808273817,1521200.0
327,BSESN,2004-11-01,5704.100098,5714.3598630000015,5649.029785,5678.649902,15600.0,31.83007799999996,0.0,31.83007799999996,55.829760098893985,5558.1401369999985,5792.080078,62.392065406223416,-37.607934593776584,47.202442603396776,62.47998559024408,0.004273018676035134,1536800.0
328,BSESN,2004-11-02,5754.759765999999,5765.1401369999985,5713.240234000001,5713.240234000001,14400.0,50.659667999999336,0.0,50.659667999999336,62.70561978816544,5558.1401369999985,5765.1401369999985,94.98532801932402,-5.014671980675984,50.01851717000682,59.98769190619663,0.0029016354509623365,1551200.0
329,BSESN,2004-11-03,5842.540039,5845.5,5771.72998,5772.319824,17000.0,87.78027300000122,0.0,87.78027300000122,71.55768623826268,5558.1401369999985,5845.5,98.96994626559955,-1.0300537344004619,58.65724674583544,59.72160287412439,0.02988179460011864,1568200.0
330,BSESN,2004-11-04,5832.879883,5883.3901369999985,5814.370117,5871.620117,15000.0,-9.660156000000823,9.660156000000823,0.0,69.46407216072541,5558.1401369999985,5883.3901369999985,84.4703292851656,-15.529670714834404,63.986412781081526,60.574564855515824,0.03400421587321367,1553200.0
331,BSESN,2004-11-05,5891.3598630000015,5900.509765999999,5823.439941,5833.330078,14000.0,58.47998000000097,0.0,58.47998000000097,74.64566760579766,5558.1401369999985,5900.509765999999,97.32747819170675,-2.672521808293253,72.0975650561686,62.87916489564638,0.05551736471962454,1567200.0
332,BSESN,2004-11-08,5930.470215,5955.939941,5912.52002,5912.52002,14400.0,39.110351999999686,0.0,39.110351999999686,77.58126145915936,5558.1401369999985,5955.939941,93.59735079205839,-6.402649207941612,80.75074588641473,66.45348109380006,0.0494383169817465,1581600.0
333,BSESN,2004-11-09,5929.600098,5957.939941,5910.410156,5937.339844,14800.0,-0.8701170000003913,0.8701170000003913,0.0,77.35135796682489,5558.1401369999985,5957.939941,92.91149152239213,-7.088508477607874,86.54065605385586,70.47091608581123,0.0471015537155397,1566800.0
334,BSESN,2004-11-10,5973.75,5979.779785,5918.950195,5918.950195,14400.0,44.149902000000104,0.0,44.149902000000104,80.69985093794976,5558.1401369999985,5979.779785,98.56991982879188,-1.4300801712081173,93.61262166018787,75.09925720068655,0.04516218323051979,1581200.0
335,BSESN,2004-11-11,5954.310059,5995.330078,5943.330078,5980.029785,13800.0,-19.43994099999964,19.43994099999964,0.0,75.06167551996494,5558.1401369999985,5995.330078,90.61734611135542,-9.382653888644581,96.53576042686473,79.3865578459222,0.049722604531439396,1567400.0
336,BSESN,2004-11-12,5964.009765999999,6001.990234000001,5945.97998,5985.049805,3800.0,9.699706999998853,0.0,9.699706999998853,76.02598877298065,5558.1401369999985,6001.990234000001,91.44295151522715,-8.55704848477286,98.49961203691237,83.20916868412024,0.04556541146448856,1571200.0
337,BSESN,2004-11-16,5996.700195,6002.029785,5949.240234000001,5970.040039,13800.0,32.69042900000113,0.0,32.69042900000113,79.15973617975018,5623.040039,6002.029785,98.59373767859161,-1.4062623214083951,101.52352302440795,86.8720395521778,0.04204179476429615,1585000.0
338,BSESN,2004-11-17,6016.580078,6036.700195,5997.740234000001,6000.1098630000015,14800.0,19.87988299999961,0.0,19.87988299999961,80.91061589332905,5649.029785,6036.700195,94.80999413909348,-5.190005860906526,104.321580441675,90.36194773007725,0.029788420419586625,1599800.0
339,BSESN,2004-11-18,6025.470215,6035.220215,5985.569824,6019.850098,14800.0,8.890137000000323,0.0,8.890137000000323,81.70376941986277,5649.029785,6036.700195,97.103214557954,-2.8967854420460024,106.03412546726122,93.49638327751406,0.03301805212229847,1614600.0
340,BSESN,2004-11-19,5961.709961,6044.549805,5953.419922,6030.810059,15000.0,-63.760254000000714,63.760254000000714,0.0,60.79878905991287,5649.029785,6044.549805,79.0554612128104,-20.94453878718961,101.08120885236985,95.01334839248523,0.011941232522872047,1599600.0
341,BSESN,2004-11-22,5963.799805,5979.100098,5877.970215,5921.009765999999,14000.0,2.0898440000000846,0.0,2.0898440000000846,61.17448511201016,5713.240234000001,6044.549805,75.62702467173811,-24.37297532826188,96.21550722130178,95.25378015824855,0.00562005857742931,1613600.0
342,BSESN,2004-11-23,6009.8598630000015,6031.589844,5977.759765999999,5988.279785,14600.0,46.060058000000936,0.0,46.060058000000936,68.78281599391295,5771.72998,6044.549805,87.2846696533149,-12.715330346685109,94.98118142804378,95.19926041220761,0.013535443145157977,1628200.0
343,BSESN,2004-11-24,6035.950195,6053.189941,6001.459961,6001.459961,12800.0,26.090331999999762,0.0,26.090331999999762,72.32710982604135,5814.370117,6053.189941,92.78127514238544,-7.218724857614559,95.01299047972407,95.16200642571091,0.010412252772546537,1641000.0
344,BSESN,2004-11-25,6035.029785,6081.740234000001,6014.97998,6033.799805,20000.0,-0.9204100000006292,0.9204100000006292,0.0,71.99438572912919,5823.439941,6081.740234000001,81.91622299088881,-18.083777009111195,93.88171995919129,94.905949132407,0.013556520436484698,1621000.0
345,BSESN,2004-11-29,6157.77002,6166.720215,6029.819824,6033.419922,23000.0,122.74023500000021,0.0,122.74023500000021,83.60175879011135,5877.970215,6166.720215,96.90036536796525,-3.0996346320347525,101.7167635689002,96.26811201970565,0.03248825230042396,1644000.0
346,BSESN,2004-11-30,6234.290039,6248.430176,6194.6098630000015,6195.02002,18800.0,76.5200190000005,0.0,76.5200190000005,87.36792552435877,5877.970215,6248.430176,96.18308630119425,-3.8169136988057475,112.80032616260087,99.5745548482847,0.03962009709908476,1662800.0
347,BSESN,2004-12-01,6227.830078,6272.680176,6176.089844,6259.279785,26600.0,-6.459961000000477,6.459961000000477,0.0,85.45610077659278,5877.970215,6272.680176,88.63720138038272,-11.362798619617289,119.68323072276416,103.5962900231806,0.03511130862737932,1636200.0
348,BSESN,2004-12-02,6328.430176,6335.1401369999985,6275.410156,6275.410156,26200.0,100.60009799999986,0.0,100.60009799999986,89.56078879671651,5877.970215,6335.1401369999985,98.5322829265223,-1.4677170734776999,131.7369873471198,109.22442948796846,0.05027988691169716,1662400.0
349,BSESN,2004-12-03,6322.759765999999,6361.529785,6304.220215,6348.319824,20600.0,-5.670410000000629,5.670410000000629,0.0,87.94649784731983,5877.970215,6361.529785,91.98236961787345,-8.017630382126558,139.22719715426865,115.22498302122851,0.060561450886053914,1641800.0
350,BSESN,2004-12-06,6322.5,6386.290039,6312.129883,6351.040039,18800.0,-0.25976599999921746,0.25976599999921746,0.0,87.86278644329687,5877.970215,6386.290039,87.45080636477391,-12.54919363522608,143.48823835184248,120.87763408735131,0.060146250164076376,1623000.0
351,BSESN,2004-12-07,6316.279785,6354.259765999999,6287.459961,6324.069824,17800.0,-6.22021500000028,6.22021500000028,0.0,85.61130592194213,5877.970215,6386.290039,86.22712499207965,-13.772875007920346,144.69526785590188,125.64116084106145,0.05098620084080285,1605200.0
352,BSESN,2004-12-08,6261.52002,6359.200195,6250.240234000001,6333.040039,26000.0,-54.75976499999979,54.75976499999979,0.0,67.92952885982933,5877.970215,6386.290039,75.45442591276935,-24.545574087230655,139.6236969789652,128.4376680686422,0.03737105471593427,1579200.0
353,BSESN,2004-12-09,6304.27002,6319.009765999999,6241.27002,6259.5,19400.0,42.75,0.0,42.75,72.9601490755919,5877.970215,6386.290039,83.86448548188031,-16.135514518119695,137.46934718103057,130.2440038911199,0.04461290906454085,1598600.0
354,BSESN,2004-12-10,6233.540039,6336.899902,6221.399902,6328.100098,17600.0,-70.7299809999995,70.7299809999995,0.0,56.14673146882117,5877.970215,6386.290039,69.95002107177312,-30.049978928226878,128.57258635153175,129.90972038320226,0.012304782210752485,1581000.0
355,BSESN,2004-12-13,6268.720215,6274.240234000001,6220.580078,6231.470215,14600.0,35.180175999999854,0.0,35.180175999999854,61.26909404766093,5977.759765999999,6386.290039,71.2212700575069,-28.778729942493097,122.94337083723258,128.5164504740083,0.005522710009417953,1595600.0
356,BSESN,2004-12-14,6325.529785,6331.569824,6280.490234000001,6280.560059,14000.0,56.80956999999944,0.0,56.80956999999944,68.19183871284645,6001.459961,6386.290039,84.21114734176246,-15.788852658237534,121.66377029653904,127.14591443851445,0.01568759997886371,1609600.0
357,BSESN,2004-12-15,6402.290039,6423.27002,6334.27002,6334.27002,22400.0,76.7602540000007,0.0,76.7602540000007,75.12394201907614,6014.97998,6423.27002,94.86150066261732,-5.138499337382687,125.39807765300975,126.79634708141353,0.011671119210591607,1632000.0
358,BSESN,2004-12-16,6420.379883,6437.0,6373.549805,6401.189941,18600.0,18.08984399999917,0.0,18.08984399999917,76.51565972056048,6029.819824,6437.0,95.91824013554128,-4.081759864458725,128.33784359151923,127.1046463834347,0.015439479058644956,1650600.0
359,BSESN,2004-12-17,6346.47998,6436.080078,6329.709961,6420.899902,16800.0,-73.89990299999954,73.89990299999954,0.0,60.548434156283065,6176.089844,6437.0,65.30605730809499,-34.69394269190501,123.2833905280595,126.34039521235968,0.003792800316330558,1633800.0
360,BSESN,2004-12-20,6403.0,6409.52002,6345.870117,6360.1098630000015,16800.0,56.52001999999993,0.0,56.52001999999993,66.68380566596096,6176.089844,6437.0,86.96869431176914,-13.03130568823086,122.42712957488402,125.55774208486454,0.013729634840740301,1650600.0
361,BSESN,2004-12-21,6451.299805,6461.6401369999985,6400.560059,6429.25,14600.0,48.299804999999644,0.0,48.299804999999644,71.11340062008682,6220.580078,6461.6401369999985,95.71047479084915,-4.289525209150851,124.21406478735207,125.28900662536208,0.030308900138276584,1665200.0
362,BSESN,2004-12-22,6413.660156,6480.200195,6396.430176,6465.509765999999,16200.0,-37.639648999999736,37.639648999999736,0.0,63.519517416520735,6220.580078,6480.200195,74.37022994639497,-25.62977005360503,121.19594727247932,124.47039475478554,0.01735175296314484,1649000.0
363,BSESN,2004-12-23,6441.850098,6455.689941,6409.290039,6410.299805,12000.0,28.189941999999967,0.0,28.189941999999967,66.60153750401057,6220.580078,6480.200195,85.22838004883866,-14.771619951161336,119.69894519361787,123.51610484255202,0.033417617869896166,1661000.0
364,BSESN,2004-12-24,6498.060059,6507.939941,6463.850098,6485.259765999999,14600.0,56.209961000000476,0.0,56.209961000000476,72.03688638788685,6220.580078,6507.939941,96.56184343322877,-3.43815656677122,121.64597526637499,123.14207892731663,0.036584795003488546,1675600.0
365,BSESN,2004-12-27,6513.029785,6566.6401369999985,6469.959961,6484.839844,16200.0,14.969725999999357,0.0,14.969725999999357,73.36869516040676,6220.580078,6566.6401369999985,84.50836766458535,-15.491632335414648,122.97931343430173,123.10952582871366,0.029641785964651834,1691800.0
366,BSESN,2004-12-28,6563.47998,6568.569824,6517.899902,6517.899902,14600.0,50.450195000000356,0.0,50.450195000000356,77.53021658651512,6220.580078,6568.569824,98.53735805192373,-1.4626419480762751,126.6469949227394,123.81701964751882,0.0251769195113154,1706400.0
367,BSESN,2004-12-29,6567.939941,6617.149902,6552.060059,6594.3901369999985,12400.0,4.459960999999566,0.0,4.459960999999566,77.88275531224104,6220.580078,6617.149902,87.59109795504752,-12.408902044952482,128.4330443176941,124.74022458155389,0.022983072760338175,1718800.0
368,BSESN,2004-12-30,6522.540039,6608.299805,6507.299805,6583.740234000001,13200.0,-45.3999019999992,45.3999019999992,0.0,65.76376651579679,6220.580078,6617.149902,76.1429495452484,-23.857050454751604,124.74710172607865,124.74160001045884,0.027741371524818037,1705600.0
369,BSESN,2004-12-31,6602.689941,6609.779785,6541.379883,6541.379883,12200.0,80.1499019999992,0.0,80.1499019999992,74.00382818819324,6280.490234000001,6617.149902,95.70487279159306,-4.295127208406949,126.83135994944041,125.15955199825517,0.031186934405747158,1717800.0
370,BSESN,2005-01-03,6679.200195,6684.220215,6626.490234000001,6626.490234000001,12000.0,76.5102540000007,0.0,76.5102540000007,79.45128411198327,6329.709961,6684.220215,98.58395633317846,-1.4160436668215304,133.12233625606677,126.7521088498175,0.03532627484206663,1729800.0
371,BSESN,2005-01-04,6651.009765999999,6696.310059,6640.899902,6683.560059,16600.0,-28.19042900000113,28.19042900000113,0.0,72.95219299228586,6329.709961,6696.310059,87.64313123560565,-12.356868764394342,134.28529103469373,128.25874528679276,0.03700688908157357,1713200.0
372,BSESN,2005-01-05,6458.839844,6629.97998,6337.6098630000015,6628.8901369999985,24000.0,-192.16992199999916,192.16992199999916,0.0,44.39092294543407,6329.709961,6696.310059,35.22363570126493,-64.77636429873506,118.33632688650505,126.27426160673522,0.002637401637966663,1689200.0
373,BSESN,2005-01-06,6367.3901369999985,6481.22998,6325.3598630000015,6447.27002,22200.0,-91.44970700000069,91.44970700000069,0.0,36.53655011051068,6325.3598630000015,6696.310059,11.330435851824468,-88.66956414817552,97.19700425317933,120.45881013602407,-0.020109066523480434,1667000.0
374,BSESN,2005-01-07,6420.459961,6440.169922,6348.75,6374.189941,17800.0,53.06982400000015,0.0,53.06982400000015,43.25899980201595,6325.3598630000015,6696.310059,25.636891158294027,-74.36310884170597,83.76068895637582,113.11918590009442,-0.014213020215751992,1684800.0
375,BSESN,2005-01-10,6308.540039,6469.089844,6286.850098,6440.330078,13200.0,-111.91992199999912,111.91992199999912,0.0,34.393748459944234,6286.850098,6696.310059,5.297206825065008,-94.702793174935,63.351038590434655,103.16555643816247,-0.03884219069408967,1671600.0
376,BSESN,2005-01-11,6222.870117,6329.8901369999985,6208.819824,6317.3901369999985,16200.0,-85.66992200000004,85.66992200000004,0.0,29.122514127635057,6208.819824,6696.310059,2.8821691166798926,-97.11783088332011,39.80455476993575,90.49335610451713,-0.05253851696266587,1655400.0
377,BSESN,2005-01-12,6102.740234000001,6263.709961,6070.330078,6250.350098,20800.0,-120.1298829999996,120.1298829999996,0.0,23.335863337542733,6070.330078,6696.310059,5.177506786754703,-94.8224932132453,11.319831141115174,74.65865111183675,-0.06436139946859731,1634600.0
378,BSESN,2005-01-13,6221.060059,6242.950195,6138.049805,6138.049805,20200.0,118.31982499999958,0.0,118.31982499999958,37.458640292465205,6070.330078,6696.310059,24.07904175453181,-75.92095824546819,-1.687642427233186,59.38939240402276,-0.05779915237731126,1654800.0
379,BSESN,2005-01-14,6173.819824,6249.3901369999985,6144.080078,6232.419922,18200.0,-47.24023500000021,47.24023500000021,0.0,34.52837819047828,6070.330078,6696.310059,16.53243700136796,-83.46756299863203,-15.627902374774749,44.38593344826325,-0.07566480360602523,1636600.0
380,BSESN,2005-01-17,6194.069824,6232.970215,6087.549805,6202.740234000001,19000.0,20.25,0.0,20.25,36.96721012972287,6070.330078,6696.310059,19.767364733026522,-80.23263526697349,-24.756278090088017,30.557491140592997,-0.06870234115966556,1655600.0
381,BSESN,2005-01-18,6192.350098,6267.6098630000015,6173.089844,6221.279785,21800.0,-1.7197260000002643,1.7197260000002643,0.0,36.83276495095182,6070.330078,6696.310059,19.492639334100343,-80.50736066589965,-31.7632026979245,18.093352372889495,-0.04125969252009842,1633800.0
382,BSESN,2005-01-19,6173.319824,6230.620117,6160.660156,6211.279785,16600.0,-19.030273999999736,19.030273999999736,0.0,35.198270062371805,6070.330078,6696.310059,16.452562242561577,-83.54743775743843,-38.4090691604988,6.792868066211832,-0.030478784686410743,1617200.0
383,BSESN,2005-01-20,6183.240234000001,6197.209961,6091.080078,6170.330078,26600.0,9.920410000000631,0.0,9.920410000000631,36.8829916387236,6070.330078,6696.310059,18.03734295458256,-81.96265704541744,-42.38686266638433,-3.043078080307404,-0.03694746613808819,1643800.0
384,BSESN,2005-01-24,6106.430176,6215.779785,6089.52002,6201.600098,18000.0,-76.81005800000094,76.81005800000094,0.0,29.931131172393933,6070.330078,6696.310059,5.766973241273647,-94.23302675872635,-51.147624453998105,-12.663987355045547,-0.032037501823011016,1625800.0
385,BSESN,2005-01-25,6162.97998,6174.0,6069.330078,6093.660156,21400.0,56.54980400000022,0.0,56.54980400000022,39.60186351322728,6069.330078,6629.97998,16.703811356414022,-83.29618864358598,-52.91749477245594,-20.71468883852763,-0.009624198460512434,1647200.0
386,BSESN,2005-01-27,6239.430176,6252.240234000001,6188.379883,6188.379883,22200.0,76.45019599999978,0.0,76.45019599999978,50.301579485580575,6069.330078,6481.22998,41.296464790127544,-58.703535209872456,-47.60250579948024,-26.092252230718156,0.02239812555652665,1669400.0
387,BSESN,2005-01-28,6419.089844,6430.720215,6245.259765999999,6245.259765999999,23600.0,179.65966800000027,0.0,179.65966800000027,66.42819667144943,6069.330078,6469.089844,87.4924881760112,-12.507511823988807,-28.56403658362342,-26.58660910129921,0.0318321609375094,1693000.0
388,BSESN,2005-01-31,6555.939941,6565.0,6455.549805,6463.52002,22000.0,136.85009699999955,0.0,136.85009699999955,73.8780631492769,6069.330078,6565.0,98.17215881015262,-1.827841189847377,-2.4055240574298296,-21.750392092525335,0.06189362953459576,1715000.0
389,BSESN,2005-02-01,6552.470215,6586.25,6508.990234000001,6565.209961,28400.0,-3.4697259999993553,3.4697259999993553,0.0,73.4015476693794,6069.330078,6586.25,93.46518027989649,-6.534819720103517,17.83966315890575,-13.832381042239117,0.05786185838773017,1686600.0
390,BSESN,2005-02-02,6530.060059,6600.02002,6510.419922,6560.620117,88400.0,-22.410155999999915,22.410155999999915,0.0,70.03507778435143,6069.330078,6600.02002,86.81716847009707,-13.18283152990293,31.710271318041123,-4.723850570183067,0.054536638861726106,1598200.0
391,BSESN,2005-02-03,6619.970215,6630.680176,6550.75,6550.75,14400.0,89.91015599999993,0.0,89.91015599999993,75.2828969686564,6069.330078,6630.680176,98.09210668384,-1.9078933161599927,49.388506436246644,6.098620831102879,0.07235173354595337,1612600.0
392,BSESN,2005-02-04,6618.22998,6684.160156,6571.509765999999,6635.850098,16800.0,-1.7402350000002116,1.7402350000002116,0.0,74.98959581207441,6069.330078,6684.160156,89.27668337006767,-10.72331662993232,62.53732139852764,17.386360944587835,0.07034980520538503,1595800.0
393,BSESN,2005-02-07,6535.169922,6658.330078,6514.8598630000015,6652.330078,12400.0,-83.06005800000003,83.06005800000003,0.0,61.7421679014859,6069.330078,6684.160156,75.76725028081664,-24.23274971918337,65.50054990289755,27.009198736249783,0.07021119273336973,1583400.0
394,BSESN,2005-02-08,6544.77002,6573.930176,6508.330078,6528.810059,12600.0,9.600097999999887,0.0,9.600097999999887,62.622748788076954,6069.330078,6684.160156,77.32867324034854,-22.671326759651468,67.84154244731417,35.175667478462664,0.06194893399605039,1596000.0
395,BSESN,2005-02-09,6593.529785,6613.540039,6553.399902,6556.529785,13000.0,48.75976499999979,0.0,48.75976499999979,67.0653361527765,6069.330078,6684.160156,85.25928150834542,-14.740718491654567,72.79219828755504,42.698973640281146,0.05675191467997287,1609000.0
396,BSESN,2005-02-10,6577.830078,6608.959961,6533.970215,6600.850098,12600.0,-15.699706999999762,15.699706999999762,0.0,64.22912554387234,6069.330078,6684.160156,82.70577809955486,-17.294221900445145,74.58897825028089,49.0769745622811,0.024729399004810082,1596400.0
397,BSESN,2005-02-11,6633.759765999999,6640.1098630000015,6594.319824,6594.319824,15200.0,55.92968799999925,0.0,55.92968799999925,69.52650822919547,6069.330078,6684.160156,91.80254971195461,-8.19745028804539,79.60832252591717,55.18324415500833,0.011870124757141998,1611600.0
398,BSESN,2005-02-14,6679.330078,6719.169922,6659.6401369999985,6673.3901369999985,13600.0,45.57031200000075,0.0,45.57031200000075,73.25069765239633,6069.330078,6719.169922,93.86928265974407,-6.130717340255929,86.26887842818633,61.40037100964393,0.01936061650606069,1625200.0
399,BSESN,2005-02-15,6670.060059,6694.790039,6640.430176,6694.790039,20800.0,-9.270018999999593,9.270018999999593,0.0,71.20808792661526,6188.379883,6719.169922,90.74777983917674,-9.252220160823258,89.76465286525581,67.07322738076633,0.021439312768195107,1604400.0
400,BSESN,2005-02-16,6607.779785,6714.129883,6581.529785,6673.709961,14800.0,-62.280274000000645,62.280274000000645,0.0,58.55119298126496,6245.259765999999,6719.169922,76.49551595598214,-23.504484044017858,86.5123214884261,70.96104620229828,-0.0018414629679720518,1589600.0
401,BSESN,2005-02-17,6589.290039,6599.47998,6533.129883,6598.77002,14400.0,-18.48974599999929,18.48974599999929,0.0,55.19077951411868,6455.549805,6719.169922,50.7321806552421,-49.2678193447579,81.5033377203863,73.06950450591589,-0.004372761461516883,1575200.0
402,BSESN,2005-02-18,6584.319824,6642.77002,6564.549805,6595.189941,14400.0,-4.97021500000028,4.97021500000028,0.0,54.225500914047394,6508.330078,6719.169922,36.04145428982587,-63.95854571017413,76.25362288536508,73.70632818180573,0.007520829999315248,1560800.0
403,BSESN,2005-02-21,6534.680176,6602.529785,6521.069824,6585.879883,11800.0,-49.639648000000314,49.639648000000314,0.0,45.1295418193414,6508.330078,6719.169922,12.49768426123474,-87.50231573876526,67.31175332647035,72.42741321073866,-0.0015416651722164332,1549000.0
404,BSESN,2005-02-22,6589.410156,6603.1401369999985,6515.72998,6531.580078,11000.0,54.72998000000007,0.0,54.72998000000007,54.779488239591664,6508.330078,6719.169922,38.455766453706886,-61.544233546293114,63.90485389056721,70.72290134670438,-0.0006247987245574516,1560000.0
405,BSESN,2005-02-23,6582.5,6607.779785,6565.419922,6593.850098,12200.0,-6.910155999999915,6.910155999999915,0.0,53.41104170887554,6508.330078,6719.169922,35.17832331539764,-64.82167668460235,59.95613272693299,68.56954762275011,0.0007099487132722349,1547800.0
406,BSESN,2005-02-24,6574.209961,6621.680176,6565.810059,6616.370117,26800.0,-8.290039000000434,8.290039000000434,0.0,51.62581485768712,6508.330078,6719.169922,31.24641042705362,-68.75358957294638,55.51783089528908,65.9592042772579,-0.008976780453402888,1521000.0
407,BSESN,2005-02-25,6569.720215,6622.620117,6543.910156,6588.290039,14400.0,-4.489745999999286,4.489745999999286,0.0,50.56956971308991,6508.330078,6719.169922,29.11695239159838,-70.88304760840161,51.049690680806634,62.97730155796764,-0.01641030787818476,1506600.0
408,BSESN,2005-02-28,6713.859863,6720.939941,6545.939941,6584.339844,23200.0,144.1396479999994,0.0,144.1396479999994,71.88085126095602,6515.72998,6720.939941,96.54983707150552,-3.450162928494476,58.46556766739832,62.07495477985378,0.006566628128167995,1529800.0
409,BSESN,2005-03-01,6651.080078,6725.919922,6628.220215,6725.919922,16800.0,-62.77978499999973,62.77978499999973,0.0,59.07997372287631,6515.72998,6725.919922,64.3941839995369,-35.60581600046309,58.601379407122295,61.38023970530748,0.006552926158086336,1513000.0
410,BSESN,2005-03-02,6686.8901369999985,6708.779785,6647.1098630000015,6658.939941,26000.0,35.81005899999945,0.0,35.81005899999945,63.37297745638668,6515.72998,6725.919922,81.4311833246514,-18.568816675348597,60.896605511954476,61.28351286663688,0.014811929270427182,1539000.0
411,BSESN,2005-03-03,6784.720215,6793.240234000001,6691.180176,6700.790039,18200.0,97.83007800000088,0.0,97.83007800000088,72.47547334260811,6515.72998,6793.240234000001,96.9298363295792,-3.0701636704207984,69.80498995862399,62.98780828503432,0.030436004987111298,1557200.0
412,BSESN,2005-03-04,6849.47998,6864.620117,6798.620117,6798.620117,18200.0,64.75976499999979,0.0,64.75976499999979,76.86662676761055,6515.72998,6864.620117,95.66048581075243,-4.339514189247576,81.15501612101525,66.62124985223052,0.04817371248805258,1575400.0
413,BSESN,2005-03-07,6878.97998,6902.490234000001,6854.959961,6863.580078,14600.0,29.5,0.0,29.5,78.6563736718141,6515.72998,6902.490234000001,93.9212331782157,-6.0787668217842965,91.4759196257819,71.5921838069408,0.04394472602928379,1590000.0
414,BSESN,2005-03-08,6915.089844,6929.589844,6872.720215,6885.72998,15200.0,36.109864000000016,0.0,36.109864000000016,80.75886880617098,6515.72998,6929.589844,96.49639859737643,-3.50360140262357,101.40019591440978,77.5537862284346,0.05052637204709454,1605200.0
415,BSESN,2005-03-09,6892.819823999998,6954.859863,6843.439941,6895.620117,17400.0,-22.27002000000084,22.27002000000084,0.0,75.4686227052192,6515.72998,6954.859863,85.87205257447683,-14.127947425523168,106.24354245490849,83.29173747372938,0.04846359713031356,1587800.0
416,BSESN,2005-03-10,6907.649901999999,6917.600098000001,6849.97998,6888.72998,27200.0,14.830077999999958,0.0,14.830077999999958,76.6441998499015,6515.72998,6954.859863,89.24920329323146,-10.750796706768535,110.01046072504414,88.63548212399235,0.05143745485971185,1615000.0
417,BSESN,2005-03-11,6853.72998,6948.540039,6839.350098000001,6921.02002,14200.0,-53.91992199999913,53.91992199999913,0.0,63.81484918203719,6515.72998,6954.859863,76.97039374567008,-23.02960625432993,107.40676518483724,92.38973873616133,0.020833040881717446,1600800.0
418,BSESN,2005-03-14,6810.040039,6882.22998,6794.919922,6854.919922,124800.0,-43.689940999999635,43.689940999999635,0.0,55.179442431318826,6543.910156,6954.859863,64.75972082880708,-35.24027917119292,100.65758660279516,94.04330830948811,0.02389987177057118,1476000.0
419,BSESN,2005-03-15,6752.450195,6823.459961,6730.22998,6815.589844,12800.0,-57.5898440000001,57.5898440000001,0.0,45.76118306747049,6543.910156,6954.859863,50.74587849748742,-49.25412150251258,89.62861199176132,93.16036904594276,0.009804267253808119,1463200.0
420,BSESN,2005-03-16,6746.879883,6806.720215,6732.330078,6757.490234000001,13000.0,-5.57031200000074,5.57031200000074,0.0,44.90576781311406,6543.910156,6954.859863,49.39040557583359,-50.6095944241664,79.52191341056187,90.43267791886659,-0.005577287021554911,1450200.0
421,BSESN,2005-03-17,6669.52002,6737.290039,6642.600098,6719.109863,13000.0,-77.35986299999969,77.35986299999969,0.0,34.55496047779657,6545.939941,6954.859863,30.221095219714016,-69.77890478028598,64.52617002745137,85.25137634058355,-0.026273521570319258,1437200.0
422,BSESN,2005-03-18,6700.339844,6710.97998,6595.529785,6664.649902,15600.0,30.819824000000157,0.0,30.819824000000157,40.82503205800752,6595.529785,6954.859863,29.16818418969101,-70.83181581030898,54.50058872128284,79.10121881672342,-0.025968986175185838,1452800.0
423,BSESN,2005-03-21,6656.689941,6734.720215,6633.52002,6716.410156,10000.0,-43.64990300000046,43.64990300000046,0.0,35.29849607345078,6595.529785,6954.859863,17.020605772946155,-82.97939422705385,42.54265567831408,71.78950618904155,-0.03736754096177153,1442800.0
424,BSESN,2005-03-22,6535.450195,6656.310059,6520.149902,6655.779785,13600.0,-121.23974599999927,121.23974599999927,0.0,24.61804370170546,6520.149902,6954.859863,3.5196554881796813,-96.48034451182032,23.01754144033839,62.03511323930091,-0.05184665175138892,1429200.0
425,BSESN,2005-03-23,6454.459961,6568.200195,6435.819824,6533.649902,23400.0,-80.99023400000078,80.99023400000078,0.0,19.962382566835146,6435.819824,6954.859863,3.5912715011181304,-96.40872849888187,0.9970196933163606,49.827494530104005,-0.06560696436986269,1405800.0
426,BSESN,2005-03-24,6442.870117,6514.72998,6412.8901369999985,6456.02002,17200.0,-11.589843999999175,11.589843999999175,0.0,19.35790657434886,6412.8901369999985,6954.859863,5.531670601099557,-94.46832939890044,-17.191433842879633,36.42370885550728,-0.05994689960050037,1388600.0
427,BSESN,2005-03-28,6510.740234000001,6555.100098,6471.470215,6471.470215,11600.0,67.87011700000039,0.0,67.87011700000039,33.055139413415674,6412.8901369999985,6954.859863,18.05453188726672,-81.94546811273328,-25.831592563911727,23.972648571623473,-0.04394978638685798,1400200.0
428,BSESN,2005-03-29,6367.8598630000015,6512.97998,6326.72998,6512.97998,14400.0,-142.8803710000002,142.8803710000002,0.0,23.40046849099997,6326.72998,6954.859863,6.547990171007586,-93.45200982899242,-43.70443491726837,10.437231873845102,-0.056955671036978184,1385800.0
429,BSESN,2005-03-30,6381.399902,6400.069824,6321.310059,6371.399902,14600.0,13.540038999999526,0.0,13.540038999999526,25.77111432139779,6321.310059,6948.540039,9.580193057736134,-90.41980694226388,-56.12920077340641,-2.8760546556052047,-0.05417022198970711,1400400.0
430,BSESN,2005-03-31,6492.819824,6509.02002,6404.779785,6404.779785,13400.0,111.41992200000004,0.0,111.41992200000004,42.629621625706484,6321.310059,6948.540039,27.3439998834239,-72.6560001165761,-56.335856019401035,-13.568014928364374,-0.026493690021189842,1413800.0
431,BSESN,2005-04-01,6605.040039,6618.080078,6468.52002,6506.600098,11400.0,112.22021500000028,0.0,112.22021500000028,54.60982493537474,6321.310059,6882.22998,50.582974392168225,-49.417025607831775,-46.903721399943606,-20.235156222680224,-0.01422313005292386,1425200.0
432,BSESN,2005-04-04,6604.419922,6649.419922,6586.25,6616.830078,11200.0,-0.6201170000003913,0.6201170000003913,0.0,54.537211021368236,6321.310059,6823.459961,56.379551578604136,-43.620448421395864,-39.02882501831846,-23.993889981807875,-0.007852253817330013,1414000.0
433,BSESN,2005-04-05,6550.290039,6621.910156,6532.939941,6611.529785,12200.0,-54.12988299999961,54.12988299999961,0.0,48.0959757817566,6321.310059,6806.720215,47.172474075717545,-52.82752592428245,-36.732314815982136,-26.54157494864273,0.0022706689756970544,1401800.0
434,BSESN,2005-04-06,6606.410156,6617.069824,6551.680176,6555.919922,12200.0,56.120116999999475,0.0,56.120116999999475,54.52154134007297,6321.310059,6737.290039,68.53697550540761,-31.463024494592386,-30.03763435755991,-27.240786830426167,0.023541891330666642,1414000.0
435,BSESN,2005-04-07,6545.6401369999985,6644.689941,6530.970215,6629.120117,11000.0,-60.770019000000495,60.770019000000495,0.0,47.217954337932284,6321.310059,6734.720215,54.263320516973025,-45.736679483026975,-29.29795592024675,-27.652220648390287,0.015950968766052176,1403000.0
436,BSESN,2005-04-08,6479.540039,6560.879883,6456.839844,6544.810059,11400.0,-66.10009799999898,66.10009799999898,0.0,40.42205270481432,6321.310059,6734.720215,38.274333057265316,-61.72566694273469,-33.65749822810449,-28.853276164333128,-0.004792111784320374,1391600.0
437,BSESN,2005-04-11,6397.52002,6444.330078,6382.129883,6426.209961,9000.0,-82.0200190000005,82.0200190000005,0.0,33.51563241516256,6321.310059,6656.310059,22.74924208955211,-77.25075791044789,-43.232440318555746,-31.729108995177654,0.004657790472484491,1382600.0
438,BSESN,2005-04-12,6464.6098630000015,6472.040039,6404.350098,6407.3901369999985,8800.0,67.08984300000066,0.0,67.08984300000066,42.747945660492825,6321.310059,6649.419922,43.67433599519722,-56.32566400480279,-44.88960188436704,-34.361207573015534,0.013039452514787886,1391400.0
439,BSESN,2005-04-13,6467.919922,6515.819824,6449.330078,6466.919922,13600.0,3.3100589999994554,0.0,3.3100589999994554,43.19698997834024,6321.310059,6649.419922,44.683162419899524,-55.316837580100476,-45.41233513525276,-36.57143308546298,-0.003834990447133646,1405000.0
440,BSESN,2005-04-15,6248.339844,6339.72998,6232.370117,6339.72998,14000.0,-219.580078,219.580078,0.0,26.992243979021097,6232.370117,6649.419922,3.8292133957477112,-96.17078660425229,-62.82072398839409,-41.8212912660492,-0.054004244167156434,1391000.0
441,BSESN,2005-04-18,6156.779785,6220.97998,6118.419922,6220.97998,12800.0,-91.56005900000036,91.56005900000036,0.0,22.865315228250324,6118.419922,6649.419922,7.224079661016888,-92.77592033898311,-83.04780572816799,-50.06659415847297,-0.06777887267719984,1378200.0
442,BSESN,2005-04-19,6134.8598630000015,6269.75,6121.419922,6181.3901369999985,13800.0,-21.919921999999133,21.919921999999133,0.0,21.938740361096663,6118.419922,6649.419922,3.0960340866292757,-96.90396591337073,-99.6974184675546,-59.992759020289306,-0.06342164599224687,1364400.0
443,BSESN,2005-04-20,6243.740234000001,6259.279785,6151.259765999999,6169.830078,16200.0,108.88037100000021,0.0,108.88037100000021,36.651610331709115,6118.419922,6649.419922,23.600812052730834,-76.39918794726917,-102.92022029507916,-68.57825127524728,-0.05489667057238634,1380600.0
444,BSESN,2005-04-21,6299.200195,6305.879883,6174.299805,6249.290039,14600.0,55.45996099999957,0.0,55.45996099999957,42.96917073391339,6118.419922,6649.419922,34.045249152542425,-65.95475084745756,-99.84817104547528,-74.83223522929289,-0.03764947917117645,1395200.0
445,BSESN,2005-04-22,6346.569824,6374.029785,6302.8598630000015,6329.850098,12800.0,47.36962899999981,0.0,47.36962899999981,48.072777956524554,6118.419922,6649.419922,42.9660832391714,-57.0339167608286,-92.52465013429901,-78.37071821029411,-0.020521551560706452,1408000.0
446,BSESN,2005-04-25,6377.850098,6391.72998,6308.47998,6338.669922,11000.0,31.280273999999732,0.0,31.280273999999732,51.38740617417103,6118.419922,6644.689941,49.296020414189705,-50.70397958581029,-83.23714437044964,-79.34400344232523,-0.0030746167168695937,1419000.0
447,BSESN,2005-04-26,6339.97998,6377.540039,6323.529785,6374.279785,8800.0,-37.87011799999982,37.87011799999982,0.0,47.18038026296255,6118.419922,6644.689941,42.10007220646939,-57.8999277935306,-78.0330151438393,-79.08180578262805,-0.0192787941795709,1410200.0
448,BSESN,2005-04-27,6278.5,6357.560059,6258.069824,6323.899902,14000.0,-61.47998000000007,61.47998000000007,0.0,40.907006593807175,6118.419922,6644.689941,30.417860075741853,-69.58213992425814,-77.97082665981361,-78.85960995806516,-0.02928606480666318,1396200.0
449,BSESN,2005-04-28,6284.200195,6292.910156,6233.290039,6271.6098630000015,14800.0,5.700195000000348,0.0,5.700195000000348,41.735798348824204,6118.419922,6560.879883,37.46785870190873,-62.53214129809127,-76.5788306491404,-78.40345409628021,0.005739180629625196,1411000.0
450,BSESN,2005-04-29,6154.439941,6288.439941,6138.470215,6283.069824,14000.0,-129.7602540000007,129.7602540000007,0.0,30.499901386019715,6118.419922,6515.819824,9.063922466694414,-90.93607753330558,-84.96678759064616,-79.71612079515342,-0.0003800434775498296,1397000.0
451,BSESN,2005-05-02,6195.149902,6223.779785,6141.370117,6183.069824,12200.0,40.709961000000476,0.0,40.709961000000476,36.67159656243536,6118.419922,6515.819824,19.30800174178202,-80.69199825821798,-87.32274799107745,-81.23744623433822,0.009827451701645895,1409200.0
452,BSESN,2005-05-03,6216.77002,6246.240234000001,6189.160156,6200.3901369999985,12600.0,21.62011799999982,0.0,21.62011799999982,39.93981440976659,6118.419922,6515.819824,24.748395131712904,-75.25160486828709,-86.44877310262837,-82.27971160799626,-0.004319560550122836,1421800.0
453,BSESN,2005-05-04,6289.549805,6294.850098,6218.950195,6218.950195,9600.0,72.77978499999972,0.0,72.77978499999972,49.96874200990048,6118.419922,6391.72998,62.61382557681049,-37.38617442318951,-78.9730689238977,-81.61838307117655,-0.001532002429079915,1431400.0
454,BSESN,2005-05-05,6359.649902,6391.319824,6322.02002,6322.02002,9800.0,70.10009700000046,0.0,70.10009700000046,57.80006849112415,6118.419922,6391.72998,88.26238659683723,-11.737613403162776,-66.62402721208582,-78.61951189935841,0.002060968107612471,1441200.0
455,BSESN,2005-05-06,6388.47998,6402.350098,6334.009765999999,6367.25,13800.0,28.83007799999996,0.0,28.83007799999996,60.717921883109796,6121.419922,6402.350098,95.06278812853489,-4.93721187146511,-53.8897686263399,-73.67356324475472,0.001666687337686712,1455000.0
456,BSESN,2005-05-09,6481.350098,6486.069824,6391.799805,6391.799805,11600.0,92.8701179999998,0.0,92.8701179999998,68.74929241393951,6138.470215,6486.069824,98.6421946751959,-1.35780532480411,-35.89021452495581,-66.11689350079493,0.022298196279162408,1466600.0
457,BSESN,2005-05-10,6454.709961,6494.910156,6439.689941,6486.080078,12600.0,-26.640137000000323,26.640137000000323,0.0,64.39182352338639,6138.470215,6494.910156,88.72174793677222,-11.278252063227782,-23.50413361333176,-57.59434152330229,0.028065614557617247,1454000.0
458,BSESN,2005-05-11,6445.129883,6454.410156,6380.759765999999,6420.25,10600.0,-9.580077999999958,9.580077999999958,0.0,62.74175039755177,6138.470215,6494.910156,86.0340362361354,-13.9659637638646,-14.29630853883009,-48.93473492640785,0.025608618918290027,1443400.0
459,BSESN,2005-05-12,6456.819824,6482.3901369999985,6432.169922,6442.8598630000015,10000.0,11.689941000000546,0.0,11.689941000000546,64.03920719515145,6138.470215,6494.910156,89.31367458620475,-10.686325413795252,-5.986748773464569,-40.3451376958192,0.04913199022149661,1453400.0
460,BSESN,2005-05-13,6451.540039,6462.850098,6418.779785,6447.720215,29000.0,-5.27978499999972,5.27978499999972,0.0,62.89775577414463,6138.470215,6494.910156,87.83241943135674,-12.167580568643267,0.17063570109075954,-32.2419830164372,0.0413856227945717,1424400.0
461,BSESN,2005-05-16,6528.029785,6532.149902,6456.970215,6456.970215,8400.0,76.4897459999993,0.0,76.4897459999993,71.41478046102642,6138.470215,6532.149902,98.95343419128444,-1.0465658087155492,11.094598879719342,-23.57466663720589,0.05006776251954714,1432800.0
462,BSESN,2005-05-17,6466.0,6568.6098630000015,6450.8598630000015,6545.220215,11800.0,-62.02978499999973,62.02978499999973,0.0,58.78731198789732,6138.470215,6568.6098630000015,76.1449883829353,-23.8550116170647,14.578580357223473,-15.944017238320018,0.028054503179182788,1421000.0
463,BSESN,2005-05-18,6447.0,6457.370117,6380.529785,6457.370117,14800.0,-19.0,19.0,0.0,55.32961398138573,6138.470215,6568.6098630000015,71.72781826426726,-28.272181735732755,15.62638829136813,-9.629936132382388,0.013735048209576828,1406200.0
464,BSESN,2005-05-19,6478.939941,6537.740234000001,6460.240234000001,6461.069824,11400.0,31.93994099999964,0.0,31.93994099999964,59.90400104755182,6141.370117,6568.6098630000015,79.0118024272017,-20.9881975727983,18.81715745582278,-3.940517414741353,0.014159856692546047,1417600.0
465,BSESN,2005-05-20,6499.5,6512.959961,6438.600098,6462.160156,11400.0,20.56005900000036,0.0,20.56005900000036,62.73810815580158,6189.160156,6568.6098630000015,81.78681872061605,-18.21318127938394,22.742725952695764,1.396131258746072,0.002800327358585486,1429000.0
466,BSESN,2005-05-23,6539.830078,6549.569824,6499.209961,6504.490234000001,8200.0,40.330077999999965,0.0,40.330077999999965,67.87714744271463,6218.950195,6568.6098630000015,91.76920084474786,-8.230799155252141,28.776351641668043,6.872175335330469,0.013187287657277391,1437200.0
467,BSESN,2005-05-24,6565.370117,6579.049805,6522.799805,6563.02002,10400.0,25.540039000000434,0.0,25.540039000000434,70.81799532256152,6322.02002,6579.049805,94.6777810205929,-5.322218979407104,35.21299765278127,12.54033979882063,0.01865598307291716,1447600.0
468,BSESN,2005-05-25,6597.600098,6612.25,6537.6098630000015,6566.839844,10800.0,32.2299809999995,0.0,32.2299809999995,74.25051756743156,6334.009765999999,6612.25,94.73480100652874,-5.265198993471257,42.42571882214088,18.517415603484682,0.021803345584573863,1458400.0
469,BSESN,2005-05-26,6670.779785,6685.330078,6587.569824,6599.27002,13800.0,73.17968699999983,0.0,73.17968699999983,80.31626317460672,6380.529785,6685.330078,95.22628641305137,-4.773713586948627,53.430923045174495,25.50011709182265,0.0339825444273274,1472200.0
470,BSESN,2005-05-27,6707.720215,6772.740234000001,6689.1401369999985,6689.560059,15400.0,36.94043000000056,0.0,36.94043000000056,82.69115139415938,6380.529785,6772.740234000001,83.42216043305865,-16.57783956694135,64.39114956698086,33.2783235868543,0.027525981945255573,1487600.0
471,BSESN,2005-05-30,6663.549805,6724.990234000001,6642.6098630000015,6697.149902,9600.0,-44.17041000000063,44.17041000000063,0.0,70.89061477760576,6380.529785,6772.740234000001,72.16024476696163,-27.83975523303838,68.72085388387131,40.366829646257706,0.030552088617383122,1478000.0
472,BSESN,2005-05-31,6715.109863,6721.609863,6647.700195,6666.169922,8600.0,51.56005800000002,0.0,51.56005800000002,75.58364564261235,6380.529785,6772.740234000001,85.30626321992739,-14.693736780072616,75.44298179159068,47.382060075324304,0.041586763300760055,1486600.0
473,BSESN,2005-06-01,6729.899901999999,6763.279785,6710.370117,6729.390137,9800.0,14.790038999999526,0.0,14.790038999999526,76.82052624238477,6380.529785,6772.740234000001,89.07720788438212,-10.922792115617874,81.02968931141004,54.11158592254146,0.03873472563187019,1496400.0
474,BSESN,2005-06-02,6655.560059,6756.620117,6647.3598630000015,6733.459961,9400.0,-74.33984299999885,74.33984299999885,0.0,59.376032809817026,6380.529785,6772.740234000001,70.12313789732815,-29.876862102671847,78.55308021370365,58.999884780773904,0.02401108685283493,1487000.0
475,BSESN,2005-06-03,6748.850098000001,6761.129883,6647.689941,6664.97998,12200.0,93.29003900000043,0.0,93.29003900000043,69.42826850780614,6380.529785,6772.740234000001,93.90884764520898,-6.091152354791016,83.15946559625627,63.831800943870384,0.03196107811778548,1499200.0
476,BSESN,2005-06-06,6758.189941,6813.910156,6740.629883,6747.200195,9800.0,9.339842999998837,0.0,9.339842999998837,70.27786467699619,6380.529785,6813.910156,87.14288446626479,-12.857115533735202,86.56582947607421,68.37860665031116,0.02936922375491413,1509000.0
477,BSESN,2005-06-07,6781.25,6795.029785,6737.089844,6756.600098000001,8400.0,23.06005900000036,0.0,23.06005900000036,72.45834088635475,6438.600098,6813.910156,91.29782021455979,-8.702179785440206,90.08767677250216,72.72042067474936,0.02783586444647823,1517400.0
478,BSESN,2005-06-08,6858.240234000001,6862.830078,6768.200195,6768.200195,10000.0,76.99023400000078,0.0,76.99023400000078,78.52693962858959,6438.600098,6862.830078,98.91807646409167,-1.0819235359083237,97.96198973953233,77.76873448770596,0.0281017294891861,1527400.0
479,BSESN,2005-06-09,6832.529785,6862.790039,6813.200195,6858.700195,14600.0,-25.710449000001066,25.710449000001066,0.0,72.38156684918978,6499.209961,6862.830078,91.66704712324808,-8.332952876751923,100.96397132065704,82.40778185429618,0.018606853893651687,1512800.0
480,BSESN,2005-06-10,6781.990234000001,6883.669922,6774.140137,6833.580078,10200.0,-50.539550999998944,50.539550999998944,0.0,61.47052743737326,6522.799805,6883.669922,71.82374399817674,-28.17625600182327,98.13371953013575,85.5529693894641,0.017774374389927905,1502600.0
481,BSESN,2005-06-13,6832.680176000002,6843.620117,6757.040039,6790.330078,8400.0,50.689941999999974,0.0,50.689941999999974,67.19366496310496,6537.6098630000015,6883.669922,85.2656367951441,-14.73436320485589,98.84159490188995,88.21069449194927,0.017508323080134502,1511000.0
482,BSESN,2005-06-14,6860.180176000002,6865.180176000002,6819.310059,6847.620117,9200.0,27.5,0.0,27.5,69.98456667422964,6587.569824,6883.669922,92.06695770833605,-7.933042291663944,100.46353036521123,90.66126166660167,0.019358426707251075,1520200.0
483,BSESN,2005-06-15,6906.97998,6916.330078,6858.080078,6876.790039,9800.0,46.79980399999931,0.0,46.79980399999931,74.28093282261028,6642.6098630000015,6916.330078,96.5840674208151,-3.415932579184896,104.32271168416355,93.39355167011406,0.03777592250257222,1530000.0
484,BSESN,2005-06-16,6900.410156,6933.259765999999,6869.470215,6906.120117,12600.0,-6.569824000000152,6.569824000000152,0.0,72.59772671617418,6642.6098630000015,6933.259765999999,88.69787684050954,-11.302123159490462,105.63333545617206,95.84150842732568,0.022457167635848485,1517400.0
485,BSESN,2005-06-17,6906.52002,6921.600098000001,6855.549805,6913.069823999998,11000.0,6.109864000000017,0.0,6.109864000000017,73.24821346535776,6647.3598630000015,6933.259765999999,90.64716506741888,-9.352834932581107,105.94377530653674,97.8619618031679,0.02194819623226696,1528400.0
486,BSESN,2005-06-20,6984.549805,7001.549805,6940.060059,6940.060059,24400.0,78.02978499999972,0.0,78.02978499999972,80.18103008716551,6647.3598630000015,7001.549805,95.20031542849398,-4.7996845715060115,111.20425917441025,100.53042127741638,0.029979694746543828,1552800.0
487,BSESN,2005-06-21,7076.52002,7083.580078,6967.950195,6985.910156,19000.0,91.97021500000028,0.0,91.97021500000028,85.34582423897216,6647.3598630000015,7083.580078,98.38153809538606,-1.6184619046139461,121.39509121705487,104.70335526534409,0.03182737532550517,1571800.0
488,BSESN,2005-06-22,7145.339844,7167.319823999998,7079.870117,7079.870117,37200.0,68.81982400000015,0.0,68.81982400000015,88.03742617584206,6647.689941,7167.319823999998,95.77007005965469,-4.22992994034531,133.48584198303433,110.45985260888214,0.045782465476658096,1609000.0
489,BSESN,2005-06-23,7119.759765999999,7156.549805,7090.47998,7142.910156,20800.0,-25.580078000000874,25.580078000000874,0.0,81.60873867573908,6737.089844,7167.319823999998,88.9454337886915,-11.054566211308499,139.39687021298323,116.24725612970236,0.04980389536786212,1588200.0
490,BSESN,2005-06-24,7148.620117,7178.040039,7058.009765999999,7104.430176000002,15400.0,28.860351000001174,0.0,28.860351000001174,83.2052639954004,6737.089844,7178.040039,93.3280623676785,-6.671937632321495,144.74169958729635,121.94614482122117,0.04623953307660256,1603600.0
491,BSESN,2005-06-27,7151.080078,7228.209961,7133.939941,7136.390137,18400.0,2.4599609999995664,0.0,2.4599609999995664,83.34743789548925,6757.040039,7228.209961,83.63013439554832,-16.369865604451668,147.47600211603458,127.05211628018387,0.04240411979523473,1622000.0
492,BSESN,2005-06-28,7049.0,7175.149901999999,7036.060059,7158.660156,17400.0,-102.08007799999996,102.08007799999996,0.0,59.30814400371654,6757.040039,7228.209961,61.96489787817995,-38.03510212182005,139.79448360588867,129.60058974532484,0.020561811444544054,1604600.0
493,BSESN,2005-06-29,7119.879883,7125.209961,7034.47998,7059.370117,14200.0,70.87988299999961,0.0,70.87988299999961,66.94617021848043,6757.040039,7228.209961,77.0082781302835,-22.991721869716496,137.8373360255082,131.24793900136152,0.03180531621140914,1618800.0
494,BSESN,2005-06-30,7193.850098000001,7218.279785,7154.27002,7154.27002,28600.0,73.97021500000119,0.0,73.97021500000119,73.03982845020585,6757.040039,7228.209961,92.70754320349022,-7.29245679650978,140.63392033118816,133.12513526732684,0.04160272860542591,1647400.0
495,BSESN,2005-07-01,7210.77002,7228.569823999998,7154.930176000002,7165.450195,12600.0,16.919921999999133,0.0,16.919921999999133,74.29076379423685,6819.310059,7228.569823999998,95.65073199902793,-4.34926800097207,142.5720480198961,135.0145178178407,0.032388660875187325,1660000.0
496,BSESN,2005-07-04,7277.310059,7284.410156,7186.740234000001,7186.740234000001,9600.0,66.54003900000043,0.0,66.54003900000043,78.76226209479742,6855.549805,7284.410156,98.34442680853014,-1.6555731914698606,147.77380874444225,137.56637600316103,0.02837412152195129,1669600.0
497,BSESN,2005-07-05,7220.25,7308.720215,7209.859863,7275.0,12600.0,-57.06005900000037,57.06005900000037,0.0,67.19801387941648,6855.549805,7308.720215,80.47749520980415,-19.522504790195846,145.61343071672673,139.17578694587417,0.01048377790776489,1657000.0
498,BSESN,2005-07-06,7287.600098000001,7296.180176000002,7227.220215,7227.220215,13400.0,67.3500980000008,0.0,67.3500980000008,72.6642054498966,6855.549805,7308.720215,95.33947571731362,-4.660524282686385,147.63407192331306,140.86744394136196,0.023573875736863092,1670400.0
499,BSESN,2005-07-07,7145.129883,7306.540039,7123.109863,7281.069823999998,16800.0,-142.4702150000012,142.4702150000012,0.0,51.654270955438584,6940.060059,7308.720215,55.62570857263981,-44.37429142736019,136.16961045356402,139.92787724380239,-0.00048823884090587466,1653600.0
500,BSESN,2005-07-08,7212.080078,7240.390137,7158.140137,7171.52002,14600.0,66.95019500000035,0.0,66.95019500000035,58.20649367112882,6967.950195,7308.720215,71.64065753202105,-28.359342467978944,130.97644838520046,138.137591472082,0.008530179963676332,1668200.0
501,BSESN,2005-07-11,7306.740234000001,7320.25,7227.509765999999,7227.509765999999,13400.0,94.66015600000082,0.0,94.66015600000082,65.77395957167883,7034.47998,7320.25,95.27250409262692,-4.7274959073730765,132.96636008223595,137.1033451941128,0.036564084834728394,1681600.0
502,BSESN,2005-07-12,7303.950195,7352.459961,7217.600098000001,7297.950195,17000.0,-2.7900390000004336,2.7900390000004336,0.0,65.37140897499754,7034.47998,7352.459961,84.74439622033964,-15.25560377966036,132.78755433965944,136.24018702322212,0.025853008059799176,1664600.0
503,BSESN,2005-07-13,7247.910156,7338.009765999999,7236.779785,7303.189941,11600.0,-56.04003900000043,56.04003900000043,0.0,57.25087352290006,7034.47998,7352.459961,67.12063298098008,-32.879367019019924,126.66378542636267,134.32490670385022,0.007514760144227806,1653000.0
504,BSESN,2005-07-14,7187.700195,7263.029785,7163.850098000001,7262.859863,13600.0,-60.20996099999957,60.20996099999957,0.0,49.61090156779346,7034.47998,7352.459961,48.18549096019995,-51.81450903980005,115.61942502504553,130.58381036808927,-0.0031993566479048274,1639400.0
505,BSESN,2005-07-15,7271.540039,7283.040039,7178.089844,7192.450195,10400.0,83.83984400000007,0.0,83.83984400000007,58.5072517650836,7034.47998,7352.459961,74.55188161672378,-25.44811838327623,112.33691454509699,126.93443120349082,-0.0007928781312352973,1649800.0
506,BSESN,2005-07-18,7347.100098000001,7359.810059,7308.870117,7325.649901999999,17400.0,75.56005900000036,0.0,75.56005900000036,64.94350982318494,7034.47998,7359.810059,96.09321061272064,-3.9067893872793595,114.51253737083334,124.45005243695933,0.01756865731796009,1667200.0
507,BSESN,2005-07-19,7346.629883,7385.689941,7317.850098000001,7348.600098000001,11000.0,-0.4702150000011898,0.4702150000011898,0.0,64.87125519901443,7123.109863,7385.689941,85.12451580580304,-14.875484194196954,114.87458895942109,122.53495974145169,0.008100030765436639,1656200.0
508,BSESN,2005-07-20,7342.890137,7392.669922,7334.47998,7373.939941,9800.0,-3.739745999999286,3.739745999999286,0.0,64.21561724599657,7123.109863,7392.669922,81.53295217968488,-18.467047820315123,113.55080817031558,120.73812942722448,0.027677628991814363,1646400.0
509,BSESN,2005-07-21,7304.319823999998,7380.689941,7275.589844,7345.97998,12600.0,-38.57031300000108,38.57031300000108,0.0,57.32136354632346,7123.109863,7392.669922,67.22433645112031,-32.77566354887969,108.1427975900142,118.21906305978243,0.012789617558652822,1633800.0
510,BSESN,2005-07-22,7423.25,7429.950195,7273.189941,7306.640137,12200.0,118.93017600000076,0.0,118.93017600000076,69.11761924291221,7123.109863,7429.950195,97.81639038247411,-2.183609617525878,112.16066319701622,117.0073830872292,0.015945519105476258,1646000.0
511,BSESN,2005-07-25,7505.600098000001,7526.879883,7427.649901999999,7427.649901999999,17200.0,82.3500980000008,0.0,82.3500980000008,74.70373583065816,7123.109863,7526.879883,94.72972634273371,-5.270273657266286,120.5996179922804,117.72583006823945,0.027608334889529074,1663200.0
512,BSESN,2005-07-26,7552.77002,7564.790039,7473.240234000001,7524.100098000001,20200.0,47.16992199999913,0.0,47.16992199999913,77.40496363609458,7123.109863,7564.790039,97.27856950500751,-2.7214304949924855,129.59982287184903,120.10062862896139,0.04206176089912339,1683400.0
513,BSESN,2005-07-27,7605.029785,7620.370117,7504.959961,7559.759765999999,13200.0,52.25976499999979,0.0,52.25976499999979,80.11887676531329,7158.140137,7620.370117,96.68123387409862,-3.3187661259013685,139.3432145253919,123.9491458082475,0.058061630101142514,1696600.0
514,BSESN,2005-07-29,7635.419922,7708.589844,7545.790039,7556.169922,21800.0,30.390137000000323,0.0,30.390137000000323,81.6016504673975,7163.850098000001,7708.589844,86.56791200985725,-13.432087990142753,147.81325350722364,128.72196734804274,0.05004165294399465,1718400.0
515,BSESN,2005-08-01,7669.450195,7681.109863,7596.740234000001,7632.009765999999,13800.0,34.03027300000031,0.0,34.03027300000031,83.21875745607994,7163.850098000001,7708.589844,92.81498196388266,-7.18501803611734,155.47950806555582,134.07347549154537,0.04387446648341542,1732200.0
516,BSESN,2005-08-02,7756.040039,7762.799805,7683.129883,7683.129883,19400.0,86.58984400000007,0.0,86.58984400000007,86.66094408048508,7163.850098000001,7762.799805,98.87139672647018,-1.1286032735298142,166.62143855922932,140.58306810508216,0.05572761422858252,1751600.0
517,BSESN,2005-08-03,7756.470215,7843.77002,7740.830078,7774.290039,28600.0,0.4301759999998467,0.0,0.4301759999998467,86.67660986576979,7163.850098000001,7843.77002,87.16028135442696,-12.839718645573054,173.48636750374044,147.16372798481382,0.0563238820523837,1780200.0
518,BSESN,2005-08-04,7797.080078,7826.359863,7756.970215,7810.049805,23400.0,40.60986299999968,0.0,40.60986299999968,88.18771366255838,7178.089844,7843.77002,92.98613002409733,-7.013869975902661,180.12735369669008,153.75645312718908,0.06746148387162987,1803600.0
519,BSESN,2005-08-05,7754.0,7817.609863,7738.640137,7806.109863,17400.0,-43.080077999999965,43.080077999999965,0.0,77.43735561331124,7273.189941,7843.77002,84.26688499932717,-15.733115000672829,179.84108476299934,158.97337945435115,0.04455595594921369,1786200.0
520,BSESN,2005-08-08,7606.169922,7781.040039,7594.939941,7760.669922,16800.0,-147.83007799999996,147.83007799999996,0.0,52.22836298249333,7273.189941,7843.77002,58.358150460419466,-41.64184953958054,165.77461615953143,160.3336267953872,0.013399304877274032,1769400.0
521,BSESN,2005-08-09,7595.569823999998,7686.850098000001,7559.799805,7617.459961,23200.0,-10.600098000000797,10.600098000000797,0.0,50.85854184663015,7273.189941,7843.77002,56.500374770356906,-43.499625229643094,152.01911737152022,158.6707249106138,0.0056667691306186985,1746200.0
522,BSESN,2005-08-10,7729.819823999998,7741.350098000001,7615.899901999999,7615.899901999999,14000.0,134.25,0.0,134.25,64.47453991200678,7273.189941,7843.77002,80.02906161748392,-19.970938382516074,150.21900729690697,156.98038138787246,0.016408882348644127,1760200.0
523,BSESN,2005-08-11,7816.509765999999,7842.549805,7727.5,7749.009765999999,27000.0,86.68994199999996,0.0,86.68994199999996,70.55359463882812,7273.189941,7843.77002,95.22236141721298,-4.777638582787027,154.01220409546386,156.38674592939074,0.02371707723346339,1787200.0
524,BSESN,2005-08-12,7767.490234000001,7861.259765999999,7755.580078,7835.700195,16800.0,-49.019531999998435,49.019531999998435,0.0,63.46765939138537,7427.649901999999,7861.259765999999,78.37467738049465,-21.62532261950536,151.3185670790026,155.37311015931311,0.012783189995016375,1770400.0
525,BSESN,2005-08-16,7768.240234000001,7828.009765999999,7737.759765999999,7774.27002,11000.0,0.75,0.0,0.75,63.532317977346736,7473.240234000001,7861.259765999999,76.02710061513119,-23.972899384868803,147.54356865209957,153.8072018578704,0.0015729927822256684,1781400.0
526,BSESN,2005-08-17,7859.529785,7870.620117,7735.370117,7771.779785,11200.0,91.28955099999894,0.0,91.28955099999894,70.7925441183442,7504.959961,7870.620117,96.96703843226479,-3.032961567735219,150.18689795692353,153.08314107768103,0.013286916231650903,1792600.0
527,BSESN,2005-08-18,7811.330078,7921.390137,7791.910156,7902.839844,13200.0,-48.19970699999976,48.19970699999976,0.0,63.135095920802215,7545.790039,7921.390137,70.69754252300531,-29.302457476994693,146.70135998256046,151.80678485865693,0.0018276072398188958,1779400.0
528,BSESN,2005-08-19,7780.759765999999,7867.890137,7760.689941,7817.740234000001,10600.0,-30.57031200000074,30.57031200000074,0.0,58.503983091970476,7559.799805,7921.390137,61.10781772782552,-38.89218227217448,139.86005764956826,149.4174394168392,0.0034510918235748367,1768800.0
529,BSESN,2005-08-22,7750.600098000001,7845.959961,7711.180176000002,7814.930176000002,16000.0,-30.159667999998423,30.159667999998423,0.0,53.995344483741704,7559.799805,7921.390137,52.76697857065514,-47.23302142934486,130.5003166918168,145.63401487183472,0.018988555012720898,1752800.0
530,BSESN,2005-08-23,7615.990234000001,7770.830078,7601.339844,7764.859863,11000.0,-134.60986400000002,134.60986400000002,0.0,38.65427192569965,7559.799805,7921.390137,15.539804034362575,-84.46019596563742,110.94189440649279,138.69559077876633,0.0026884632059440694,1741800.0
531,BSESN,2005-08-24,7612.0,7639.680176000002,7537.5,7615.680176000002,15000.0,-3.990234000000783,3.990234000000783,0.0,38.28225194067221,7537.5,7921.390137,19.40659392351097,-80.59340607648903,94.03573982503804,129.76362058802067,-0.015242247126405761,1726800.0
532,BSESN,2005-08-25,7660.419922,7672.180176000002,7595.839844,7651.109863,10600.0,48.419922000000035,0.0,48.419922000000035,45.611352195863404,7537.5,7921.390137,32.019557199511986,-67.980442800488,83.58110263643448,120.52711699770343,-0.019969250813061556,1737400.0
533,BSESN,2005-08-26,7680.220215,7732.310059,7644.410156,7701.069823999998,11800.0,19.800293000000238,0.0,19.800293000000238,48.49715876442675,7537.5,7921.390137,37.177359156794424,-62.822640843205576,76.01716692870923,111.6251269839046,-0.011235291757175414,1749200.0
534,BSESN,2005-08-29,7634.430176000002,7699.560059,7566.209961,7693.0,7600.0,-45.790038999999524,45.790038999999524,0.0,42.48243531113903,7537.5,7921.390137,25.249457242503105,-74.7505427574969,65.57194732945209,102.41449105301409,-0.01722527290213549,1741600.0
535,BSESN,2005-08-30,7745.0,7758.359863,7679.439941,7681.669922,9800.0,110.56982399999924,0.0,110.56982399999924,57.25354147808126,7537.5,7921.390137,54.05192267286613,-45.94807732713387,65.46149688183414,95.02389221877812,-0.014572091223393646,1751400.0
536,BSESN,2005-08-31,7805.430176000002,7807.669922,7726.97998,7746.799805,9600.0,60.430176000000756,0.0,60.430176000000756,63.211408884315105,7537.5,7921.390137,69.79345134881687,-30.20654865118313,69.4496024868995,89.9090342724024,-0.0007553005622710218,1761000.0
537,BSESN,2005-09-01,7876.149901999999,7902.189941,7818.899901999999,7818.899901999999,11200.0,70.71972599999846,0.0,70.71972599999846,69.03844912465367,7537.5,7921.390137,88.21531718591638,-11.784682814083624,77.42419781295393,87.4120669805127,0.0122597456892104,1772200.0
538,BSESN,2005-09-02,7899.77002,7928.069823999998,7836.339844,7888.109863,12600.0,23.62011800000073,0.0,23.62011800000073,70.81965718298704,7537.5,7928.069823999998,92.75422670646503,-7.245773293534967,84.67399903065689,86.86445339054156,0.019246241595988423,1784800.0
539,BSESN,2005-09-05,7925.240234000001,7983.330078,7901.350098000001,7901.350098000001,10200.0,25.470214000000855,0.0,25.470214000000855,72.76885654487225,7537.5,7983.330078,86.9704071424272,-13.029592857572785,91.42090880486103,87.77574447340545,0.04060535669011478,1795000.0
540,BSESN,2005-09-06,7946.779785,7976.399901999999,7914.410156,7931.419922,10000.0,21.539550999998934,0.0,21.539550999998934,74.43518454359281,7537.5,7983.330078,91.80174357818895,-8.198256421811056,97.38337028829756,89.69726963638388,0.043980528770362515,1805000.0
541,BSESN,2005-09-08,8052.560059,8060.259765999999,7957.350098000001,7957.350098000001,10400.0,105.78027400000065,0.0,105.78027400000065,81.0173343270582,7537.5,8060.259765999999,98.52710413065743,-1.472895869342566,109.38334492873128,93.63448469485337,0.051190423109026995,1815400.0
542,BSESN,2005-09-09,8060.009765999999,8077.740234000001,8015.75,8060.890137,8800.0,7.449706999998851,0.0,7.449706999998851,81.40635444214884,7537.5,8077.740234000001,96.71804007103967,-3.281959928960333,118.13277923757414,98.53414360339754,0.04945034652238789,1824200.0
543,BSESN,2005-09-12,8138.419922,8142.810059,8072.990234000001,8072.990234000001,8200.0,78.41015600000081,0.0,78.41015600000081,85.11178393908689,7537.5,8142.810059,99.27472921774122,-0.7252707822587696,129.89644785860492,104.80660445443904,0.06601537172798655,1832400.0
544,BSESN,2005-09-13,8193.959961,8202.040039,8121.080078,8137.390137,9400.0,55.54003900000043,0.0,55.54003900000043,87.19706796210315,7537.5,8202.040039,98.78410968101215,-1.2158903189878456,142.06324036957085,112.25793163746543,0.057967716074887043,1841800.0
545,BSESN,2005-09-14,8189.47998,8260.009766,8144.319823999998,8207.530273,17400.0,-4.479981000000407,4.479981000000407,0.0,86.07500428322103,7566.209961,8260.009766,89.8342741678921,-10.165725832107892,149.61929595657148,119.73020450128665,0.04920290046035736,1824400.0
546,BSESN,2005-09-15,8283.759766,8294.240234,8203.769531,8208.209961,11800.0,94.27978599999916,0.0,94.27978599999916,89.39022309061511,7566.209961,8294.240234,98.56043513728974,-1.4395648627102555,161.35511393548495,128.05518638812632,0.051752425877076735,1836200.0
547,BSESN,2005-09-16,8380.959961,8388.799805,8268.599609,8296.879883,12800.0,97.20019500000126,0.0,97.20019500000126,91.73186776870104,7566.209961,8388.799805,99.04693158356085,-0.9530684164391502,176.46490011343212,137.7371291331875,0.060911892343924245,1849000.0
548,BSESN,2005-09-19,8444.839844,8461.099609,8382.959961,8399.509766,10600.0,63.87988299999961,0.0,63.87988299999961,92.9172573090665,7679.439941,8461.099609,97.91984086353031,-2.080159136469694,191.38788678716992,148.46728066398398,0.0655626321295435,1859600.0
549,BSESN,2005-09-20,8500.280273,8515.5,8376.120117,8412.709961,15600.0,55.44042900000022,0.0,55.44042900000022,93.80646399718344,7726.97998,8515.5,98.06983632451086,-1.930163675489139,205.32122524907572,159.83806958100234,0.06965091558781644,1875200.0
550,BSESN,2005-09-21,8487.139648,8521.75,8261.580078,8499.330078,26800.0,-13.140625,13.140625,0.0,90.69252503227797,7818.899901999999,8521.75,95.0757135698657,-4.924286430134304,212.84956050841447,170.4403677664848,0.053967879260247154,1848400.0
551,BSESN,2005-09-22,8221.639648,8519.599609,8186.129883,8480.620117,27200.0,-265.5,265.5,0.0,51.1266344522637,7836.339844,8521.75,56.21448713987254,-43.78551286012747,195.14270567731637,175.38083534865112,0.020053310937886648,1821200.0
552,BSESN,2005-09-23,8222.589844,8327.349609,8121.810059,8255.049805,20000.0,0.950195999999778,0.0,0.950195999999778,51.21452386835643,7901.350098000001,8521.75,51.779464336536876,-48.220535663463124,179.12176432899287,176.12902114471947,0.01034229282916077,1841200.0
553,BSESN,2005-09-26,8478.910156,8487.360352,8280.05957,8280.05957,18600.0,256.32031199999983,0.0,256.32031199999983,68.72193530248597,7914.410156,8521.75,92.94631425498899,-7.0536857450110055,184.9756754625978,177.89835200829515,0.03477563917278692,1859800.0
554,BSESN,2005-09-27,8525.519531,8585.759766,8444.980469,8497.25,20000.0,46.609375,0.0,46.609375,70.912124140277,7957.350098000001,8585.759766,90.41385929154745,-9.58614070845254,191.17221494946625,180.5531245965294,0.041033075582413314,1879800.0
555,BSESN,2005-09-28,8606.030273,8613.830078,8475.679688,8535.80957,18000.0,80.51074200000039,0.0,80.51074200000039,74.47453356449982,8015.75,8613.830078,98.69585941968117,-1.3041405803188364,200.27096217194776,184.49669211161307,0.03890389341356015,1897800.0
556,BSESN,2005-09-29,8650.169922,8722.169922,8588.469727,8588.469727,19800.0,44.139648999998826,0.0,44.139648999998826,76.30989562502677,8072.990234000001,8722.169922,88.90907997725273,-11.090920022747259,208.6384317146676,189.325040032224,0.03212161402187119,1917600.0
557,BSESN,2005-09-30,8634.480469,8683.570313,8527.379883,8672.660156,23400.0,-15.689452999999046,15.689452999999046,0.0,74.12397886145315,8121.080078,8722.169922,85.41158965247811,-14.588410347521888,211.56491522859687,193.7730150714986,0.022456390944434412,1894200.0
558,BSESN,2005-10-03,8697.650391,8725.75,8662.990234,8662.990234,16600.0,63.16992199999913,0.0,63.16992199999913,77.16305272263058,8121.810059,8725.75,95.34728420950705,-4.652715790492949,216.48594406453958,198.31560087010683,0.023219248267250414,1910800.0
559,BSESN,2005-10-04,8799.959961,8808.830078,8706.700195,8706.700195,27400.0,102.30957000000126,0.0,102.30957000000126,81.27322927081404,8121.810059,8808.830078,98.7088997766162,-1.2911002233837943,226.03582188113978,203.85964507231344,0.036858155512230484,1938200.0
560,BSESN,2005-10-05,8724.469727,8821.839844,8695.69043,8815.669922,23600.0,-75.49023400000078,75.49023400000078,0.0,70.47440951548751,8121.810059,8821.839844,86.09057513174237,-13.90942486825763,224.9200001148729,208.07171608082533,0.06115934296905334,1914600.0
561,BSESN,2005-10-06,8528.700195,8693.200195,8508.429688,8693.200195,29400.0,-195.76953200000025,195.76953200000025,0.0,50.42581473950798,8121.810059,8821.839844,58.12468908019382,-41.87531091980618,205.86564717417968,207.63050229949621,0.03722797279294765,1885200.0
562,BSESN,2005-10-07,8491.55957,8586.429688,8410.69043,8528.700195,25000.0,-37.140625,37.140625,0.0,47.4697018950211,8121.810059,8821.839844,52.81911126110145,-47.18088873889856,185.6281909138179,203.23004002236058,0.0014918679131241674,1860200.0
563,BSESN,2005-10-10,8483.860352,8564.849609,8465.900391,8516.44043,16200.0,-7.699217999999746,7.699217999999746,0.0,46.813280875027296,8121.810059,8821.839844,51.71926977364249,-48.28073022635751,167.0430304031197,195.99263809851243,-0.004886409426255067,1844000.0
564,BSESN,2005-10-11,8540.55957,8563.849609,8381.959961,8547.950195,21200.0,56.69921799999975,0.0,56.69921799999975,52.405694998331114,8121.810059,8821.839844,59.81881342377442,-40.18118657622558,155.1013974741909,187.81438997364813,-0.007607538077736509,1865200.0
565,BSESN,2005-10-13,8376.900391,8547.799805,8346.320313,8520.480469,24200.0,-163.65917900000022,163.65917900000022,0.0,38.81348750886847,8121.810059,8821.839844,36.439925481170626,-63.56007451882937,130.92244688344545,176.4360013556076,-0.03159123271150921,1841000.0
566,BSESN,2005-10-14,8201.730469,8396.419922,8180.100098000001,8389.450195,25200.0,-175.16992199999913,175.16992199999913,0.0,29.39712047882638,8180.100098000001,8821.839844,3.370583033826817,-96.62941696617318,96.51316193760795,160.4514334720077,-0.05011882319424821,1815800.0
567,BSESN,2005-10-17,8202.620117,8254.799805,8131.77002,8230.469727,21800.0,0.8896480000003066,0.0,0.8896480000003066,29.497353934808146,8131.77002,8821.839844,10.267091029907206,-89.7329089700928,68.52542443374477,142.06623166435512,-0.05691540263704298,1837600.0
568,BSESN,2005-10-18,8122.25,8317.379883,8067.910156,8232.259766,19200.0,-80.37011700000039,80.37011700000039,0.0,25.69491859638012,8067.910156,8821.839844,7.207547980256758,-92.79245201974324,39.405501962812195,121.53408572404653,-0.0770128459678796,1818400.0
569,BSESN,2005-10-19,7971.060059,8084.790039,7922.890137,8066.060059,26400.0,-151.1899409999996,151.1899409999996,0.0,20.077218733152435,7922.890137,8821.839844,5.358466844686347,-94.64153315531365,4.080946306523401,98.0434578405419,-0.0863559266723557,1792000.0
570,BSESN,2005-10-20,7935.120117,8134.830078,7838.02002,8075.819823999998,27200.0,-35.93994199999997,35.93994199999997,0.0,18.941358755733503,7838.02002,8821.839844,9.869703235416859,-90.13029676458314,-26.50849804306563,73.1330666638204,-0.06959795331391638,1764800.0
571,BSESN,2005-10-21,8068.950195,8080.77002,7901.140137,7930.5,25600.0,133.83007799999996,0.0,133.83007799999996,34.79198697374666,7838.02002,8821.839844,23.472811724924174,-76.52718827507583,-39.496592117038745,50.607134907648565,-0.049768169382341076,1790400.0
572,BSESN,2005-10-24,7920.799805,8126.27002,7898.410156,8096.490234000001,21400.0,-148.1503900000007,148.1503900000007,0.0,27.838662440527727,7838.02002,8821.839844,8.414120449762324,-91.58587955023768,-61.04061041297973,28.277585843522903,-0.06636843649450963,1769000.0
573,BSESN,2005-10-25,7991.740234000001,8074.080078,7921.439941,7974.169922,22200.0,70.94042900000113,0.0,70.94042900000113,35.01444124851106,7838.02002,8821.839844,15.624833963500295,-84.3751660364997,-71.5651419734686,8.309040280124597,-0.06426034869281971,1791200.0
574,BSESN,2005-10-26,7974.689941,8047.859863,7951.049805,7996.919922,15800.0,-17.050293000001147,17.050293000001147,0.0,34.07475440628477,7838.02002,8693.200195,15.981418301704641,-84.01858169829536,-80.35543774338385,-9.423855324577097,-0.0480142333352952,1775400.0
575,BSESN,2005-10-27,7798.490234000001,7994.819823999998,7766.990234000001,7989.350098000001,26800.0,-176.19970699999885,176.19970699999885,0.0,25.81410400152795,7766.990234000001,8586.429688,3.8440912072559326,-96.15590879274407,-100.38250720706947,-27.615585701075574,-0.049165262931295084,1748600.0
576,BSESN,2005-10-28,7685.640137,7795.029785,7656.149901999999,7795.029785,21800.0,-112.85009700000046,112.85009700000046,0.0,21.892057409623092,7656.149901999999,8564.849609,3.245322384592897,-96.7546776154071,-123.93155788993136,-46.878780138846736,-0.06302620048544672,1726800.0
577,BSESN,2005-10-31,7892.319823999998,7905.700195,7717.069823999998,7717.069823999998,15600.0,206.6796869999989,0.0,206.6796869999989,40.87523418169557,7656.149901999999,8563.849609,26.018508123193513,-73.98149187680649,-124.48207489912602,-62.399439090902604,-0.028308679983994778,1742400.0
578,BSESN,2005-11-02,8072.75,8086.839844,7891.22998,7953.279785,16600.0,180.4301760000008,0.0,180.4301760000008,52.50306196496307,7656.149901999999,8547.799805,46.722384716056006,-53.277615283944,-109.10150210691063,-71.73985169410422,0.012757392397913625,1759000.0
579,BSESN,2005-11-07,8206.830078,8216.419922,8049.649901999999,8083.589844,27200.0,134.08007800000087,0.0,134.08007800000087,59.356699245018355,7656.149901999999,8396.419922,74.38909602201663,-25.61090397798337,-85.11202714882802,-74.41428678504899,0.03424144272471641,1786200.0
580,BSESN,2005-11-08,8317.799805,8353.099609,8213.75,8218.820313,24000.0,110.9697269999997,0.0,110.9697269999997,64.27899139508969,7656.149901999999,8353.099609,94.93510024533232,-5.0648997546676835,-56.49463091501548,-70.8303556110423,0.03084039484519341,1810200.0
581,BSESN,2005-11-09,8308.780273,8405.459961,8269.089844,8332.009766,19400.0,-9.019532000000254,9.019532000000254,0.0,63.55710326035427,7656.149901999999,8405.459961,87.0975056535308,-12.902494346469199,-34.14928734818295,-63.49414195847042,0.04898248630840141,1790800.0
582,BSESN,2005-11-10,8308.929688,8342.530273,8190.990234000001,8314.389648,1200.0,0.14941499999986266,0.0,0.14941499999986266,63.564924554609185,7656.149901999999,8405.459961,87.1174459970782,-12.882554002921792,-16.24116697703994,-54.04354696218434,0.03968966016319575,1792000.0
583,BSESN,2005-11-11,8471.040039,8483.679688,8332.94043,8332.94043,20200.0,162.11035099999938,0.0,162.11035099999938,71.28104252871992,7656.149901999999,8483.679688,98.47260494862712,-1.5273950513728856,10.906376037128211,-41.05356236232183,0.06224067664977562,1812200.0
584,BSESN,2005-11-14,8494.290039,8569.910156,8416.889648,8503.700195,16200.0,23.25,0.0,23.25,72.25345001630906,7656.149901999999,8569.910156,91.72429347096549,-8.275706529034512,33.906230238688295,-26.0616038421198,0.08922237306478098,1828400.0
585,BSESN,2005-11-16,8595.919922,8606.950195,8503.0,8511.099609,15000.0,101.6298829999996,0.0,101.6298829999996,76.30071183995659,7656.149901999999,8606.950195,98.83989591913175,-1.1601040808682528,59.646890376792726,-8.919904998337293,0.11843903289431346,1843400.0
586,BSESN,2005-11-17,8649.519531,8662.570313,8547.339844,8611.790039,17000.0,53.59960900000078,0.0,53.59960900000078,78.2328655473251,7656.149901999999,8662.570313,98.70324748411723,-1.2967525158827728,83.41008988810609,9.54609397895139,0.09594133586647224,1860400.0
587,BSESN,2005-11-18,8686.650391,8739.570313,8661.599609,8669.839844,22400.0,37.1308599999993,0.0,37.1308599999993,79.56458034346261,7656.149901999999,8739.570313,95.11547673805077,-4.884523261949225,104.03944483414125,28.44476414998937,0.07604600551237173,1882800.0
588,BSESN,2005-11-21,8610.740234,8713.099609,8586.919922,8699.269531,21400.0,-75.91015699999843,75.91015699999843,0.0,69.53008544509636,7656.149901999999,8739.570313,88.10894850309413,-11.891051496905874,112.96089906441011,45.347991132873524,0.04921634201770053,1861400.0
589,BSESN,2005-11-22,8534.969727,8664.459961,8518.179688,8602.820313,19600.0,-75.7705070000011,75.7705070000011,0.0,60.71157116415929,7656.149901999999,8739.570313,81.11531000129918,-18.884689998700818,112.61896778539631,58.8021864633781,0.026109058536063046,1841800.0
590,BSESN,2005-11-23,8638.339844,8649.679688,8537.480469,8542.610352,19600.0,103.3701170000004,0.0,103.3701170000004,67.25004121222027,7717.069823999998,8739.570313,90.09971436796057,-9.900285632039429,119.31371508775919,70.90449218825432,0.03966401326930358,1861400.0
591,BSESN,2005-11-24,8744.040039,8765.709961,8655.139648,8655.139648,19800.0,105.70019499999945,0.0,105.70019499999945,72.62519814998022,7891.22998,8765.709961,97.5219647709693,-2.4780352290306964,131.63111140627188,83.04981603185784,0.052366594415692136,1881200.0
592,BSESN,2005-11-25,8853.209961,8863.929688,8760.700195,8760.700195,19000.0,109.16992200000095,0.0,109.16992200000095,77.10359700128127,8049.649901999999,8863.929688,98.68353271390188,-1.316467286098108,148.4901352181423,96.13787986911476,0.045114876123890424,1900200.0
593,BSESN,2005-11-28,8994.94043,9005.629883,8905.679688,8905.679688,18800.0,141.73046900000008,0.0,141.73046900000008,81.61026351821894,8190.990234000001,9005.629883,98.68783050111534,-1.3121694988846613,171.31271111384376,111.17284611806058,0.05893963929902979,1919000.0
594,BSESN,2005-11-29,8931.160156,9000.650391,8875.820313,9000.650391,19400.0,-63.780274000000645,63.780274000000645,0.0,74.04293085292366,8190.990234000001,9005.629883,90.85856831404976,-9.141431685950238,182.15347993111573,125.36897288067162,0.03899992520195572,1899600.0
595,BSESN,2005-11-30,8788.80957,9033.990234,8768.799805,8962.919922,18200.0,-142.35058600000048,142.35058600000048,0.0,59.770293797327426,8190.990234000001,9033.990234,70.91569822064041,-29.08430177935959,177.21553433859663,135.73828517225664,0.016103789175893723,1881400.0
596,BSESN,2005-12-01,8944.780273,8960.110352,8769.55957,8813.820313,18200.0,155.97070300000087,0.0,155.97070300000087,67.65316004506519,8332.94043,9033.990234,87.274804087956,-12.725195912043997,183.76933065968842,145.344494269743,0.02971569827046827,1899600.0
597,BSESN,2005-12-02,8961.610352,9057.969727,8943.700195,9010.580078,18400.0,16.830078999999387,0.0,16.830078999999387,68.42351713359473,8416.889648,9057.969727,84.96921396305,-15.030786036950008,188.1524043852187,153.90607629283815,0.04074796225004773,1918000.0
598,BSESN,2005-12-05,8823.30957,9010.730469,8803.370117,8965.830078,14400.0,-138.30078200000023,138.30078200000023,0.0,55.818941986994545,8503.0,9057.969727,57.716584241720206,-42.2834157582798,178.40970854755324,158.8068027437812,0.033783346892004795,1903600.0
599,BSESN,2005-12-06,8815.530273,8915.120117,8783.929688,8827.0,14000.0,-7.779296999999134,7.779296999999134,0.0,55.159454734345296,8518.179688,9057.969727,55.08634163588195,-44.91365836411806,168.12281252035245,160.67000469909544,0.020512092855790254,1889600.0
600,BSESN,2005-12-07,8895.80957,8915.879883,8825.929688,8825.929688,13600.0,80.27929699999912,0.0,80.27929699999912,60.68967639610685,8518.179688,9057.969727,69.9586607228963,-30.041339277103702,164.55139559282725,161.4462828778418,0.017356911716218226,1903200.0
601,BSESN,2005-12-08,8906.30957,8931.580078,8826.389648,8918.629883,15400.0,10.5,0.0,10.5,61.40797149956482,8518.179688,9057.969727,71.90386149382049,-28.096138506179507,160.7156541756176,161.30015713739698,0.005997780379536133,1918600.0
602,BSESN,2005-12-09,9067.280273,9080.759766,8907.719727,8907.719727,20200.0,160.97070300000087,0.0,160.97070300000087,70.83481784980461,8518.179688,9080.759766,97.6039867874598,-2.3960132125401947,168.71989399773884,162.78410450946535,0.008042281498466863,1938800.0
603,BSESN,2005-12-12,9133.669922,9175.599609,9092.650391,9092.650391,18600.0,66.38964899999883,0.0,66.38964899999883,73.87203501446649,8537.480469,9175.599609,93.4291757805601,-6.5708242194399,178.36432860484092,165.90014932854046,0.02267451959910849,1957400.0
604,BSESN,2005-12-13,9263.900391,9274.19043,9111.030273,9160.759766,25200.0,130.23046900000008,0.0,130.23046900000008,78.85584638489654,8655.139648,9274.19043,98.33777142373414,-1.6622285762658708,194.27662300522024,171.57544406387643,0.05405633347907424,1982600.0
605,BSESN,2005-12-14,9241.759766,9309.009766,9199.849609,9264.990234,24400.0,-22.140625,22.140625,0.0,76.01163882953519,8760.700195,9309.009766,87.73503080069342,-12.264969199306577,202.76333801400324,177.8130228539018,0.03320142965349726,1958200.0
606,BSESN,2005-12-15,9170.400391,9298.280273,9117.259766,9259.780273,18600.0,-71.359375,71.359375,0.0,67.02178835411365,8768.799805,9309.009766,74.34157364602902,-25.65842635397098,201.40929463895736,182.53227721091292,0.023298272386212737,1939600.0
607,BSESN,2005-12-16,9284.459961,9290.30957,9137.160156,9191.629883,20000.0,114.05957000000126,0.0,114.05957000000126,72.92702106380959,8768.799805,9309.009766,95.45550678951683,-4.544493210483174,207.15194094467734,187.45620995766583,0.052265013183709685,1959600.0
608,BSESN,2005-12-19,9394.269531,9402.679688,9263.320313,9263.320313,101000.0,109.80956999999945,0.0,109.80956999999945,77.41875623304728,8768.799805,9402.679688,98.67322544451214,-1.3267745554878667,218.0501971563408,193.57500739740084,0.06564996546748292,2060600.0
609,BSESN,2005-12-20,9346.240234,9427.570313,9310.629883,9400.25,22000.0,-48.02929699999913,48.02929699999913,0.0,71.4371710621735,8769.55957,9427.570313,87.64000742158106,-12.359992578418936,220.2724175369185,198.9144894253044,0.050634027229969236,2038600.0
610,BSESN,2005-12-21,9339.169922,9423.25,9272.759766,9349.240234,18800.0,-7.07031200000165,7.07031200000165,0.0,70.51180789993955,8783.929688,9427.570313,86.2655669069986,-13.7344330930014,218.93923291729152,202.91943812370184,0.04860153900983244,2019800.0
611,BSESN,2005-12-22,9372.299805,9413.700195,9328.759766,9398.620117,36200.0,33.12988300000143,0.0,33.12988300000143,72.44185193555717,8783.929688,9427.570313,91.4128310343991,-8.587168965600892,218.04252072906638,205.94405464477475,0.033639583515276295,2056000.0
612,BSESN,2005-12-23,9256.910156,9442.980469,9237.94043,9417.290039,15800.0,-115.38964900000065,115.38964900000065,0.0,57.35536899906015,8783.929688,9442.980469,71.76692322287072,-28.233076777129284,205.65028110890125,205.8852999376001,0.013492959024406614,2040200.0
613,BSESN,2005-12-26,9085.889648,9262.480469,9050.509766,9254.089844,15400.0,-171.0205079999996,171.0205079999996,0.0,42.29292537943175,8825.929688,9442.980469,42.12942726994137,-57.87057273005863,179.95500690952395,200.6992413319849,-0.019215528609627386,2024800.0
614,BSESN,2005-12-27,9283.160156,9297.070313,9020.799805,9071.25,14600.0,197.27050799999958,0.0,197.27050799999958,57.239100487493985,8826.389648,9442.980469,74.08000450918159,-25.91999549081841,173.50929121588706,195.26125130876534,0.004479708523944748,2039400.0
615,BSESN,2005-12-28,9257.509766,9350.820313,9207.269531,9292.179688,19600.0,-25.650390000000698,25.650390000000698,0.0,55.09809724557759,8907.719727,9442.980469,65.34946644751302,-34.650533552486976,164.43573024547732,189.09614709610776,0.009498971831752412,2019800.0
616,BSESN,2005-12-29,9323.25,9338.110352,9271.629883,9272.629883,14200.0,65.74023400000078,0.0,65.74023400000078,59.57019558317645,9020.799805,9442.980469,71.63999225696413,-28.360007743035865,160.69713869036423,183.41634541495907,0.0041779531779919665,2034000.0
617,BSESN,2005-12-30,9397.929688,9427.230469,9311.530273,9339.320313,15200.0,74.67968800000017,0.0,74.67968800000017,64.23871216791589,9020.799805,9442.980469,89.32902786850514,-10.670972131494864,161.8940903472958,179.11189440142644,0.0003896159236140839,2049200.0
618,BSESN,2006-01-02,9390.139648,9457.089844,9366.089844,9422.490234,14000.0,-7.790039999999862,7.790039999999862,0.0,63.358140340626576,9020.799805,9457.089844,84.65465859512786,-15.345341404872151,160.36549839363943,175.36261519986905,0.00469701322680538,2035200.0
619,BSESN,2006-01-03,9539.370117,9546.780273,9390.790039,9401.830078,13200.0,149.23046900000008,0.0,149.23046900000008,71.8787143901587,9020.799805,9546.780273,98.59117278096343,-1.408827219036567,169.24478144540626,174.13904844897652,0.021436615531365,2048400.0
620,BSESN,2006-01-04,9648.080078,9664.94043,9523.290039,9523.290039,21400.0,108.70996100000048,0.0,108.70996100000048,76.47653820409705,9020.799805,9664.94043,97.38250448029113,-2.617495519708867,182.94478891393737,175.9001965419687,0.029425037476167315,2069800.0
621,BSESN,2006-01-05,9617.740234,9679.719727,9571.30957,9638.269531,19200.0,-30.339844000000085,30.339844000000085,0.0,72.65135045887271,9020.799805,9679.719727,90.59377461044515,-9.406225389554846,189.17329964382407,178.5548171623398,0.03897953765556683,2050600.0
622,BSESN,2006-01-06,9640.290039,9680.919922,9535.660156,9635.089844,16000.0,22.549804999998738,0.0,22.549804999998738,73.77620764281235,9020.799805,9680.919922,93.84507728916861,-6.154922710831383,193.69621073255075,181.583095876382,0.061017733263141194,2066600.0
623,BSESN,2006-01-09,9583.450195,9689.679688,9539.629883,9643.919922,15600.0,-56.8398440000001,56.8398440000001,0.0,65.89371641349724,9020.799805,9689.679688,84.11830050508475,-15.88169949491526,190.4982052467094,183.3661177504475,0.032347824873613984,2051000.0
624,BSESN,2006-01-10,9445.299805,9600.080078,9418.629883,9584.469727,24600.0,-138.15038999999888,138.15038999999888,0.0,50.70166194107457,9020.799805,9689.679688,63.464309630014725,-36.535690369985275,174.80118174359814,181.65313054907764,0.02028515699650635,2026400.0
625,BSESN,2006-01-12,9380.879883,9435.259766,9303.709961,9334.129883,25400.0,-64.41992200000095,64.41992200000095,0.0,45.10632851619847,9020.799805,9689.679688,53.83329460963909,-46.16670539036091,155.37199654037613,176.39690374733735,0.0061813083420481085,2001000.0
626,BSESN,2006-01-13,9374.19043,9471.889648,9362.25,9425.070313,15600.0,-6.689452999999047,6.689452999999047,0.0,44.517681920272,9020.799805,9689.679688,52.83319680882078,-47.16680319117921,137.8454478194435,168.6866125617586,-0.002526009322065037,1985400.0
627,BSESN,2006-01-16,9311.19043,9397.620117,9287.089844,9382.860352,17200.0,-63.0,63.0,0.0,38.988604192538844,9020.799805,9689.679688,43.414465344295635,-56.58553465570437,117.51729200880436,158.45274845116776,-0.008407672405257083,1968200.0
628,BSESN,2006-01-17,9314.129883,9421.519531,9289.230469,9317.990234,27200.0,2.939452999999048,0.0,2.939452999999048,39.393842767211986,9207.269531,9689.679688,22.151347862271408,-77.84865213772859,100.48593208868806,146.85938517867183,-0.023611646391474284,1995400.0
629,BSESN,2006-01-18,9237.530273,9302.780273,9158.44043,9293.799805,45800.0,-76.59960999999929,76.59960999999929,0.0,32.83603762813023,9158.44043,9689.679688,14.887800893660575,-85.11219910633943,79.88662500496685,133.46483314393083,-0.04255248730119432,1949600.0
630,BSESN,2006-01-19,9449.839844,9473.860352,9271.629883,9271.629883,19200.0,212.30957099999972,0.0,212.30957099999972,56.17014232086742,9158.44043,9689.679688,54.85276353578518,-45.14723646421482,79.77355389373224,122.72657729389111,-0.017457363779326274,1968800.0
631,BSESN,2006-01-20,9520.959961,9556.19043,9466.099609,9493.389648,17800.0,71.12011700000039,0.0,71.12011700000039,61.35902345752787,9158.44043,9689.679688,68.2403503771177,-31.759649622882318,84.44926473371743,115.07111478185638,-0.012378266371369184,1986600.0
632,BSESN,2006-01-23,9464.900391,9503.400391,9432.929688,9467.55957,16200.0,-56.05957000000126,56.05957000000126,0.0,55.39450292413421,9158.44043,9689.679688,57.68774735394252,-42.31225264605748,82.678197674064,108.59253136029793,-0.012370263484214883,1970400.0
633,BSESN,2006-01-24,9549.919922,9574.139648,9503.419922,9503.419922,16800.0,85.01953099999993,0.0,85.01953099999993,61.879024681980646,9158.44043,9689.679688,73.69174738211814,-26.308252617881855,87.13059264813455,104.30014361786525,0.011076420988205937,1987200.0
634,BSESN,2006-01-25,9685.740234,9714.480469,9580.299805,9580.299805,21600.0,135.82031200000165,0.0,135.82031200000165,69.93538879034865,9158.44043,9714.480469,94.83126519959126,-5.168734800408739,100.46066382556273,103.53224765940476,0.03249805506543879,2008800.0
635,BSESN,2006-01-27,9870.790039,9883.950195,9764.259766,9764.259766,18200.0,185.04980499999874,0.0,185.04980499999874,77.43297162032655,9158.44043,9883.950195,98.18608147886198,-1.8139185211380218,124.52140872154632,107.73007987183308,0.05297519958744834,2027000.0
636,BSESN,2006-01-30,9849.030273,9945.19043,9803.679688,9896.459961,29400.0,-21.759765999999214,21.759765999999214,0.0,74.89869833127247,9158.44043,9945.19043,87.77754598029867,-12.222454019701336,140.2175504979259,114.22757399705165,0.05776273689636047,1997600.0
637,BSESN,2006-01-31,9919.889648,9939.549805,9873.370117,9892.230469,18400.0,70.859375,0.0,70.859375,77.64750688187617,9158.44043,9945.19043,96.78413956148711,-3.2158604385129017,156.56977638542594,122.69601447472651,0.06503664567804912,2016000.0
638,BSESN,2006-02-01,9859.259766,9993.919922,9819.320313,9959.240234,19000.0,-60.629882000001096,60.629882000001096,0.0,70.071710689617,9158.44043,9993.919922,83.88229067386848,-16.117709326131507,162.76050663477326,130.70891290673586,0.06730473131083814,1997000.0
639,BSESN,2006-02-02,9843.870117,9956.099609,9816.009766,9890.900391,19400.0,-15.389648999998824,15.389648999998824,0.0,68.1250184479143,9158.44043,9993.919922,82.04027669897623,-17.959723301023768,164.52830897104468,137.47279211959764,0.04169703185500895,1977600.0
640,BSESN,2006-02-03,9742.580078,9837.740234,9713.509766,9834.969727,16000.0,-101.29003899999952,101.29003899999952,0.0,56.25612294170696,9158.44043,9993.919922,69.91669497496191,-30.083305025038086,155.95825573626098,141.16988484293032,0.023277076881722758,1961600.0
641,BSESN,2006-02-06,9980.419922,10002.830078,9739.709961,9746.089844,21400.0,237.8398439999983,0.0,237.8398439999983,70.28329460686516,9158.44043,10002.830078,97.34599351696437,-2.654006483035629,166.43950351258354,146.22380857686096,0.0544664507499939,1983000.0
642,BSESN,2006-02-07,10082.280273,10099.580078,9972.429688,9993.389648,19000.0,101.86035100000116,0.0,101.86035100000116,74.3481087540208,9158.44043,10099.580078,98.16182380194437,-1.8381761980556317,180.88017289275012,153.1550814400388,0.05574500680090644,2002000.0
643,BSESN,2006-02-08,10044.820313,10083.530273,9958.549805,10083.530273,17600.0,-37.45996000000014,37.45996000000014,0.0,70.26945651875756,9271.629883,10099.580078,93.38610397935825,-6.61389602064175,187.14451622031265,159.95296839609358,0.03707306517879916,1984400.0
644,BSESN,2006-02-10,10110.969727,10122.25,10057.070313,10066.360352,18600.0,66.14941399999952,0.0,66.14941399999952,73.25854260189979,9432.929688,10122.25,98.36356584832505,-1.6364341516749488,195.19665280777008,167.0017052784289,0.024332367221979068,2003000.0
645,BSESN,2006-02-13,10173.25,10182.769531,10096.280273,10132.669922,15400.0,62.280273000000314,0.0,62.280273000000314,75.89168772574426,9432.929688,10182.769531,98.73045809863696,-1.2695419013630513,204.2490704554075,174.4511783138246,0.032918949177038304,2018400.0
646,BSESN,2006-02-14,10086.629883,10185.05957,10064.459961,10180.509766,21400.0,-86.62011700000038,86.62011700000038,0.0,65.5358584749933,9503.419922,10185.05957,85.55986476303096,-14.440135236969049,202.10392884651446,179.9817284203626,0.016808678414443445,1997000.0
647,BSESN,2006-02-15,10113.179688,10191.969727,10036.009766,10144.900391,24000.0,26.549805000000557,0.0,26.549805000000557,67.12250389153634,9580.299805,10191.969727,87.11886326821876,-12.881136731781236,200.23801682990234,184.03298610227057,0.025754461088007163,2021000.0
648,BSESN,2006-02-16,10124.299805,10195.419922,10110.459961,10133.419922,15600.0,11.120117000000393,0.0,11.120117000000393,67.83807110214661,9713.509766,10195.419922,85.24203814455436,-14.757961855445641,197.38128008948115,186.7026448997127,0.028487747671081864,2036600.0
649,BSESN,2006-02-17,9981.110352,10184.040039,9970.0,10168.549805,18800.0,-143.18945300000087,143.18945300000087,0.0,51.26156096624466,9713.509766,10195.419922,55.52914431626972,-44.47085568373028,181.4712162490996,185.6563591695901,0.024483275691890904,2017800.0
650,BSESN,2006-02-20,10079.299805,10092.849609,9896.639648,10002.360352,14800.0,98.18945300000088,0.0,98.18945300000088,59.15795496820276,9713.509766,10195.419922,75.90419800158796,-24.095801998412043,174.77079534567747,183.47924640480758,0.009907387041104165,2032600.0
651,BSESN,2006-02-21,10168.110352,10195.509766,10108.160156,10108.160156,15000.0,88.81054699999912,0.0,88.81054699999912,65.0649449841005,9713.509766,10195.509766,94.31547427385902,-5.68452572614098,174.61408989318807,181.7062151024837,0.008512963007966556,2047600.0
652,BSESN,2006-02-22,10224.320313,10237.610352,10157.259766,10179.259766,16000.0,56.209961000000476,0.0,56.209961000000476,68.40235884523386,9713.509766,10237.610352,97.46421977860572,-2.5357802213942784,176.98539630057167,180.7620513421013,0.017869906519650813,2063600.0
653,BSESN,2006-02-23,10244.049805,10304.879883,10228.219727,10268.509766,18800.0,19.72949200000039,0.0,19.72949200000039,69.57933551922302,9713.509766,10304.879883,89.71370445490416,-10.286295545095832,178.4001924624754,180.28967956617615,0.013161950000169398,2082400.0
654,BSESN,2006-02-24,10200.759766,10271.669922,10177.120117,10256.740234,12800.0,-43.29003900000134,43.29003900000134,0.0,63.583148077548515,9739.709961,10304.879883,81.57720130760947,-18.422798692390526,174.02226392308694,179.03619643755832,0.0027041275895116623,2069600.0
655,BSESN,2006-02-27,10282.089844,10296.219727,10109.339844,10214.580078,13000.0,81.33007800000088,0.0,81.33007800000088,69.31541378704442,9896.639648,10304.879883,94.41749317041238,-5.582506829587623,175.0969726979456,178.2483516896358,0.01937812364161684,2082600.0
656,BSESN,2006-02-28,10370.240234,10422.650391,10206.05957,10308.709961,31800.0,88.15039000000071,0.0,88.15039000000071,74.36230404929137,9896.639648,10422.650391,90.03629532334503,-9.963704676654968,180.97551384408325,178.79378412052532,0.025418370278244007,2114400.0
657,BSESN,2006-03-01,10565.469727,10573.290039,10344.259766,10368.75,27600.0,195.22949299999888,0.0,195.22949299999888,81.94926164635368,9896.639648,10573.290039,98.84426106834248,-1.1557389316575213,199.09267214554166,182.8535617255286,0.043575351431426546,2142000.0
658,BSESN,2006-03-02,10626.780273,10706.219727,10593.799805,10597.19043,26800.0,61.31054600000061,0.0,61.31054600000061,83.69742690144884,9896.639648,10706.219727,90.18757303191998,-9.81242696808001,215.90903434587744,189.4646562495984,0.06468918769850318,2168800.0
659,BSESN,2006-03-03,10595.429688,10690.0,10556.030273,10649.280273,17800.0,-31.350585000000137,31.350585000000137,0.0,79.17339997831712,9896.639648,10706.219727,86.31512287989493,-13.684877120105076,224.1228437125701,196.39629374219277,0.05120691843534253,2151000.0
660,BSESN,2006-03-06,10735.360352,10741.589844,10616.990234,10616.990234,21600.0,139.93066399999952,0.0,139.93066399999952,83.70851984553185,9896.639648,10741.589844,99.26273855790663,-0.7372614420933743,239.16661805157673,204.95035860406958,0.055787160088051735,2172600.0
661,BSESN,2006-03-07,10725.669922,10753.129883,10661.620117,10747.870117,24400.0,-9.69043000000056,9.69043000000056,0.0,82.27690432708995,9896.639648,10753.129883,96.79389678038763,-3.2061032196123636,247.45447967841392,213.45118281893846,0.04903500610818545,2148200.0
662,BSESN,2006-03-08,10508.849609,10740.599609,10493.910156,10728.389648,27200.0,-216.82031299999835,216.82031299999835,0.0,57.07604172436415,9896.639648,10753.129883,71.4789189628065,-28.521081037193497,233.8316171845854,217.52726969206788,0.02584913281764356,2121000.0
663,BSESN,2006-03-09,10573.540039,10593.080078,10376.540039,10533.889648,24800.0,64.69042999999874,0.0,64.69042999999874,61.17042144991209,9896.639648,10753.129883,79.0318865690278,-20.968113430972185,225.6541766873179,219.15265109111786,0.0365443635132463,2145800.0
664,BSESN,2006-03-10,10765.160156,10782.339844,10581.639648,10581.639648,18400.0,191.62011700000042,0.0,191.62011700000042,70.71708522430502,10108.160156,10782.339844,97.45176422461424,-2.54823577538577,231.96172777706852,221.71446642830801,0.046981724467413555,2164200.0
665,BSESN,2006-03-13,10803.709961,10884.480469,10782.530273,10818.94043,15800.0,38.54980500000056,0.0,38.54980500000056,72.29807096943512,10109.339844,10884.480469,89.57988971356009,-10.42011028643991,237.33530093539412,224.8386333297252,0.04179939106702846,2180000.0
666,BSESN,2006-03-14,10801.719727,10896.389648,10761.219727,10796.820313,22600.0,-1.9902340000007823,1.9902340000007823,0.0,72.06629111556187,10109.339844,10896.389648,87.9715463343155,-12.02845366568449,238.68192447613183,227.6072915590065,0.022360577059462372,2157400.0
667,BSESN,2006-03-16,10878.740234,10889.25,10830.19043,10859.389648,18400.0,77.0205070000011,0.0,77.0205070000011,75.56432106738589,10109.339844,10896.389648,97.75752259764243,-2.242477402357567,243.16103550689513,230.71804034858422,0.023709905966548206,2175800.0
668,BSESN,2006-03-17,10860.040039,10951.379883,10844.030273,10902.259766,26400.0,-18.700195000001262,18.700195000001262,0.0,73.00323202675622,10109.339844,10951.379883,89.15255335025701,-10.847446649742999,242.40749115200015,233.05593050926745,0.02497400849157505,2149400.0
669,BSESN,2006-03-20,10941.110352,10946.94043,10889.410156,10903.25,14000.0,81.07031300000017,0.0,81.07031300000017,76.91675875897243,10206.05957,10951.379883,98.6221318779487,-1.377868122051292,245.52177634230247,235.54909967587446,0.01916563517699421,2163400.0
670,BSESN,2006-03-21,10905.200195,11017.25,10863.610352,10945.620117,16200.0,-35.91015700000025,35.91015700000025,0.0,71.6110895108237,10344.259766,11017.25,83.35045601865295,-16.64954398134705,242.29914650174214,236.89910904104798,0.01673837385502197,2147200.0
671,BSESN,2006-03-22,10841.349609,10935.089844,10784.419922,10900.019531,19000.0,-63.85058599999866,63.85058599999866,0.0,62.73315713231815,10376.540039,11017.25,72.54601899345231,-27.453981006547686,231.91955618789325,235.90319847041704,0.031639999845010536,2128200.0
672,BSESN,2006-03-23,10840.589844,10924.290039,10792.980469,10861.950195,14400.0,-0.7597650000006979,0.7597650000006979,0.0,62.62655831181992,10376.540039,11017.25,72.42743725659047,-27.57256274340954,221.08383259512993,232.93932529535962,0.025256423488727586,2113800.0
673,BSESN,2006-03-24,10950.299805,10966.05957,10851.799805,10851.799805,21800.0,109.70996100000048,0.0,109.70996100000048,70.87298671888342,10376.540039,11017.25,89.55062367135581,-10.449376328644185,218.82662344872006,230.11678492603173,0.017198039445498914,2135600.0
674,BSESN,2006-03-27,11079.019531,11101.419922,10996.360352,10996.360352,22400.0,128.71972599999935,0.0,128.71972599999935,77.57234992330811,10376.540039,11101.419922,96.9097789129845,-3.0902210870154923,224.832644300408,229.059956800907,0.025482873105056703,2158000.0
675,BSESN,2006-03-28,11086.030273,11146.849609,11051.129883,11114.429688,19000.0,7.010742000000391,0.0,7.010742000000391,77.89191222107084,10376.540039,11146.849609,92.1045592098771,-7.895440790122908,227.5352822861987,228.75502189796532,0.02632085938032036,2177000.0
676,BSESN,2006-03-29,11183.480469,11197.639648,11103.870117,11103.870117,17800.0,97.45019599999979,0.0,97.45019599999979,82.00440087287573,10376.540039,11197.639648,98.27558327335653,-1.7244167266434796,234.83354383875485,229.9707262861232,0.028012456262865415,2194800.0
677,BSESN,2006-03-30,11307.040039,11338.660156,11227.820313,11241.780273,23400.0,123.55956999999945,0.0,123.55956999999945,85.85409237284284,10581.639648,11338.660156,95.82308317068731,-4.176916829312689,247.7319931595448,233.52297966080755,0.041160069244197794,2218200.0
678,BSESN,2006-03-31,11279.959961,11356.950195,11231.160156,11325.959961,17200.0,-27.08007799999905,27.08007799999905,0.0,81.44792421391058,10761.219727,11356.950195,87.07633096919277,-12.923669030807233,252.85422508712327,237.3892287460707,0.030970312710360437,2201000.0
679,BSESN,2006-04-03,11564.360352,11579.099609,11342.959961,11342.959961,16600.0,284.4003909999992,0.0,284.4003909999992,88.56159457924798,10761.219727,11579.099609,98.19787020999239,-1.8021297900076079,276.6730508071687,245.2459931582903,0.0604445718751887,2217600.0
680,BSESN,2006-04-04,11638.009766,11710.69043,11570.110352,11599.799805,18000.0,73.64941399999951,0.0,73.64941399999951,89.73742473888004,10784.419922,11710.69043,92.1534083863975,-7.846591613602495,298.05672163846066,255.8081388543244,0.07348348551905826,2235600.0
681,BSESN,2006-04-05,11746.900391,11755.200195,11653.389648,11671.139648,16200.0,108.890625,0.0,108.890625,91.2686215744229,10784.419922,11755.200195,99.14503783906204,-0.8549621609379592,320.100083724079,268.6665278282753,0.08360343487228405,2251800.0
682,BSESN,2006-04-07,11589.44043,11930.660156,11564.870117,11845.129883,30400.0,-157.45996099999866,157.45996099999866,0.0,73.07661361218945,10784.419922,11930.660156,70.23139514050602,-29.768604859493976,321.16175133276374,279.165572529173,0.058367408781644814,2221400.0
683,BSESN,2006-04-10,11662.549805,11691.919922,11535.280273,11620.379883,22000.0,73.109375,0.0,73.109375,75.67423845787509,10784.419922,11930.660156,76.60958470595797,-23.390415294042032,324.1656661107045,288.16559124547933,0.052669847938008996,2243400.0
684,BSESN,2006-04-12,11355.730469,11702.769531,11302.780273,11693.150391,27000.0,-306.8193360000005,306.8193360000005,0.0,51.57726059276009,10784.419922,11930.660156,49.84212995266405,-50.15787004733594,298.34934842264374,290.20234268091224,0.02432793248425935,2216400.0
685,BSESN,2006-04-13,11237.230469,11380.830078,11008.429688,11366.910156,32800.0,-118.5,118.5,0.0,45.167728825375676,10792.980469,11930.660156,39.048776652720534,-60.95122334727946,265.2699046679227,285.21585507831435,0.0048061960808167825,2183600.0
686,BSESN,2006-04-17,11539.679688,11560.900391,11323.740234,11323.740234,22800.0,302.44921900000014,0.0,302.44921900000014,59.858476702487266,10851.799805,11930.660156,63.75986311503629,-36.24013688496371,260.45694592370637,280.2640732473928,0.020574761228189242,2206400.0
687,BSESN,2006-04-18,11821.570313,11834.769531,11624.969727,11624.969727,24200.0,281.890625,0.0,281.890625,68.83729031285911,10996.360352,11930.660156,88.32389319435202,-11.676106805647978,276.2049404013287,279.45224667817996,0.04801527256059379,2230600.0
688,BSESN,2006-04-19,11895.980469,11986.089844,11799.620117,11880.049805,26200.0,74.41015599999993,0.0,74.41015599999993,70.82492504393696,11008.429688,11986.089844,90.78315972610834,-9.216840273891657,291.3313309646928,281.82806353548256,0.02867604492648379,2256800.0
689,BSESN,2006-04-20,12039.549805,12053.740234,11866.209961,11941.490234,26400.0,143.56933600000048,0.0,143.56933600000048,74.45257869739572,11008.429688,12053.740234,98.64246763277175,-1.3575323672282373,311.31530101901444,287.72551103218893,0.03450246623551445,2283200.0
690,BSESN,2006-04-21,12030.299805,12102.0,11860.349609,12053.900391,32800.0,-9.25,9.25,0.0,73.77067111723989,11008.429688,12102.0,93.44347645384877,-6.556523546151229,322.68661315822465,294.7177314573961,0.024125463276859938,2250400.0
691,BSESN,2006-04-24,11915.240234,12071.070313,11882.480469,12063.730469,16600.0,-115.05957099999979,115.05957099999979,0.0,65.19986981692284,11008.429688,12102.0,82.92201571763232,-17.077984282367684,318.73987924839275,299.52216101559543,0.028111780371781192,2233800.0
692,BSESN,2006-04-25,11646.780273,11953.0,11621.610352,11943.080078,18800.0,-268.4599610000005,268.4599610000005,0.0,49.66540344708359,11008.429688,12102.0,58.37307194564736,-41.626928054352646,290.59973608543623,297.7376760295636,-0.0013521513102768834,2215000.0
693,BSESN,2006-04-26,11938.530273,11965.089844,11635.400391,11677.049805,18600.0,291.75,0.0,291.75,61.24424397652178,11008.429688,12102.0,85.0517405962645,-14.948259403735506,288.51444174311473,295.8930291722738,0.05132208849012265,2233600.0
694,BSESN,2006-04-27,11835.019531,12086.910156,11803.490234,11968.799805,31200.0,-103.5107420000004,103.5107420000004,0.0,55.973150735882925,11008.429688,12102.0,75.5863462943021,-24.413653705697904,275.33548309037906,291.7815199558949,0.05319718801257234,2202400.0
695,BSESN,2006-04-28,11851.929688,11877.320313,11344.610352,11698.679688,22800.0,16.910157000000254,0.0,16.910157000000254,56.676018948350595,11008.429688,12102.0,77.13267183134724,-22.867328168652758,263.2213202246676,286.06948000964945,0.027058809988002253,2225200.0
696,BSESN,2006-05-02,12218.780273,12288.509766,12103.780273,12103.780273,19800.0,366.85058500000014,0.0,366.85058500000014,69.04586818444992,11008.429688,12288.509766,94.55272414605932,-5.447275853940675,279.99492794840444,284.8545695974005,0.03360043966098103,2245000.0
697,BSESN,2006-05-03,12310.719727,12337.009766,12134.19043,12231.120117,19200.0,91.93945399999942,0.0,91.93945399999942,71.40667937187452,11008.429688,12337.009766,98.02119274288866,-1.978807257111343,297.28001947043776,287.339659572008,0.03486381463728683,2264200.0
698,BSESN,2006-05-04,12347.629883,12482.910156,12264.139648,12358.30957,20200.0,36.91015599999992,0.0,36.91015599999992,72.38238902540931,11008.429688,12482.910156,90.82522448171213,-9.174775518287865,310.37906351225683,291.94754036005776,0.025589003159574464,2284400.0
699,BSESN,2006-05-05,12359.700195,12443.540039,12304.589844,12373.469727,20000.0,12.07031199999983,0.0,12.07031199999983,72.73346928702392,11323.740234,12482.910156,89.37084557996316,-10.629154420036837,318.06763785256953,297.1715598585601,0.027380896182079617,2304400.0
700,BSESN,2006-05-08,12462.469727,12511.070313,12393.219727,12393.219727,17600.0,102.76953200000023,0.0,102.76953200000023,75.76062965631375,11344.610352,12511.070313,95.83349728023795,-4.166502719762059,328.6648865368352,303.4702251942151,0.045926853529858924,2322000.0
701,BSESN,2006-05-09,12513.860352,12546.469727,12356.040039,12488.379883,22400.0,51.390625,0.0,51.390625,77.21987739881008,11344.610352,12546.469727,97.28675619807849,-2.7132438019215015,337.32164249702146,310.2405086547764,0.07444804990526843,2344400.0
702,BSESN,2006-05-10,12612.379883,12624.370117,12530.980469,12546.929688,19000.0,98.51953099999993,0.0,98.51953099999993,79.89692738428084,11344.610352,12624.370117,99.06308712557464,-0.9369128744253633,348.1189877593097,317.8162044756831,0.0564432634998604,2363400.0
703,BSESN,2006-05-11,12435.410156,12671.110352,12397.019531,12631.540039,19000.0,-176.9697269999997,176.9697269999997,0.0,64.24799962894805,11344.610352,12671.110352,82.2314213343385,-17.7685786656615,338.49403516697566,321.9517706139416,0.050730007113834574,2344400.0
704,BSESN,2006-05-12,12285.110352,12421.759766,12224.44043,12400.709961,21000.0,-150.29980400000022,150.29980400000022,0.0,53.902114541198344,11344.610352,12671.110352,70.9008669430833,-29.0991330569167,315.1059080571231,320.58259810257795,0.03654937848969797,2323400.0
705,BSESN,2006-05-15,11822.200195,12272.639648,11770.759766,12272.639648,30200.0,-462.91015700000025,462.91015700000025,0.0,34.28318220513526,11344.610352,12671.110352,36.00375748209572,-63.99624251790428,256.26362035501734,307.71880255306587,-0.03245660116143745,2293200.0
706,BSESN,2006-05-16,11873.730469,11954.509766,11378.959961,11861.179688,38200.0,51.530274000000645,0.0,51.530274000000645,37.21824028505187,11344.610352,12671.110352,39.888437014700365,-60.11156298529963,211.35240688635895,288.4455234197245,-0.035496645824987016,2331400.0
707,BSESN,2006-05-17,12217.80957,12238.80957,11962.870117,11962.870117,18800.0,344.0791009999993,0.0,344.0791009999993,53.29083593624982,11344.610352,12671.110352,65.82730629476063,-34.17269370523937,201.2048897825789,270.9973966922954,-0.01051378395936009,2350200.0
708,BSESN,2006-05-18,11391.429688,12163.980469,11330.450195,12163.980469,30600.0,-826.3798819999993,826.3798819999993,0.0,31.174255688715675,11330.450195,12671.110352,4.548467609901584,-95.45153239009842,125.03958078352116,241.80583351054057,-0.07834093802628839,2319600.0
709,BSESN,2006-05-19,10938.610352,11697.110352,10799.009766,11549.669922,35000.0,-452.81933600000053,452.81933600000053,0.0,24.69449783978206,10799.009766,12671.110352,7.456895587980999,-92.54310441201899,27.818612960518294,199.00838940053612,-0.12227587375386373,2284600.0
710,BSESN,2006-05-22,10481.769531,11142.900391,9826.910156,11071.629883,31400.0,-456.84082099999983,456.84082099999983,0.0,19.883426845159207,9826.910156,12671.110352,23.024376973216413,-76.9756230267836,-85.11182462115903,142.1843465961971,-0.16238720617297164,2253200.0
711,BSESN,2006-05-23,10822.780273,10859.200195,10185.480469,10590.669922,30400.0,341.0107420000004,0.0,341.0107420000004,31.39531142633946,9826.910156,12671.110352,35.01406540933944,-64.98593459066056,-145.41701624644884,84.6640740276679,-0.14189230157998722,2283600.0
712,BSESN,2006-05-24,10573.150391,11000.959961,10504.589844,10830.980469,25600.0,-249.62988200000112,249.62988200000112,0.0,27.99735723944565,9826.910156,12671.110352,26.237261218443408,-73.76273878155659,-210.92099438880905,25.547060344372493,-0.14975459125499557,2258000.0
713,BSESN,2006-05-25,10666.320313,10720.669922,10274.929688,10520.900391,21200.0,93.16992200000095,0.0,93.16992200000095,31.203946378896035,9826.910156,12671.110352,29.513047575923885,-70.48695242407612,-252.40575847882064,-30.043503420266152,-0.13176845731275522,2279200.0
714,BSESN,2006-05-26,10809.349609,11050.769531,10735.139648,10735.139648,24800.0,143.02929600000058,0.0,143.02929600000058,36.23409249981803,9826.910156,12671.110352,34.541853079880774,-65.45814692011923,-270.62190321624985,-78.15918337946292,-0.08567361145079977,2304000.0
715,BSESN,2006-05-29,10853.139648,10992.379883,10781.610352,10855.030273,15400.0,43.790038999999524,0.0,43.790038999999524,37.83966045098314,9826.910156,12671.110352,36.08147884397377,-63.91852115602623,-278.31657870892377,-118.1906624453551,-0.08595367931456455,2319400.0
716,BSESN,2006-05-30,10786.629883,10988.230469,10722.919922,10886.610352,16200.0,-66.50976500000071,66.50976500000071,0.0,36.240499033409876,9826.910156,12671.110352,33.74304412009118,-66.25695587990882,-286.4790939956747,-151.84834875541904,-0.11713881107740987,2303200.0
717,BSESN,2006-05-31,10398.610352,10679.490234,10111.959961,10679.490234,35800.0,-388.01953099999986,388.01953099999986,0.0,28.214004941228694,9826.910156,12421.759766,22.032112913087087,-77.96788708691291,-320.56263301525723,-185.5912056073867,-0.0871549369299851,2267400.0
718,BSESN,2006-06-01,10071.419922,10597.230469,10017.820313,10472.459961,24200.0,-327.19043000000056,327.19043000000056,0.0,23.21204662559191,9826.910156,12272.639648,9.997416590828728,-90.00258340917127,-369.71378611589716,-222.41572170908884,-0.07927793404227479,2243200.0
719,BSESN,2006-06-02,10451.330078,10477.349609,10011.450195,10104.570313,28400.0,379.9101560000017,0.0,379.9101560000017,37.95022364263747,9826.910156,12238.80957,25.889136104744754,-74.11086389525525,-373.7030385096641,-252.67318506920392,-0.002904037615974464,2271600.0
720,BSESN,2006-06-05,10213.480469,10552.379883,10186.330078,10537.080078,19200.0,-237.8496090000008,237.8496090000008,0.0,33.32913627024229,9826.910156,12238.80957,16.027629956545123,-83.97237004345487,-391.5435550516795,-280.4472590656991,-0.05629790022809977,2252400.0
721,BSESN,2006-06-06,9957.320313,10192.730469,9884.889648,10087.959961,26200.0,-256.1601559999999,256.1601559999999,0.0,28.948712407642617,9826.910156,12163.980469,5.580069896681805,-94.4199301033182,-421.49356131050445,-308.6565195146602,-0.05824470997066322,2226200.0
722,BSESN,2006-06-07,9756.759766,10051.80957,9609.209961,9919.280273,27000.0,-200.56054700000092,200.56054700000092,0.0,25.876321642613462,9609.209961,11697.110352,7.0668986717958235,-92.93310132820419,-456.1544524556175,-338.1561061028517,-0.08527407018627009,2199200.0
723,BSESN,2006-06-08,9295.80957,9664.900391,9200.799805,9664.900391,36800.0,-460.95019599999983,460.95019599999983,0.0,20.19297738428422,9200.799805,11142.900391,4.892113502508306,-95.10788649749169,-514.8830357692459,-373.50149203613057,-0.14002137906056888,2162400.0
724,BSESN,2006-06-09,9810.459961,9849.200195,9262.200195,9270.780273,29400.0,514.650391000001,0.0,514.650391000001,37.79406341825727,9200.799805,11050.769531,32.95514231566404,-67.04485768433595,-513.973113604492,-401.59581634980293,-0.0960717101979005,2191800.0
725,BSESN,2006-06-12,9476.150391,9859.379883,9428.030273,9858.469727,20400.0,-334.30957000000126,334.30957000000126,0.0,32.43279932834396,9200.799805,11050.769531,14.884059027028574,-85.11594097297143,-534.0715378502864,-428.09096064989967,-0.12149109649765111,2171400.0
726,BSESN,2006-06-13,9062.650391,9360.05957,8993.580078,9360.05957,28000.0,-413.5,413.5,0.0,26.972259760778684,8993.580078,11050.769531,3.3575086095873727,-96.64249139041263,-576.717636187017,-457.81629575732313,-0.12847485536786662,2143400.0
727,BSESN,2006-06-14,8929.44043,9387.05957,8799.009766,9156.969727,27400.0,-133.20996099999866,133.20996099999866,0.0,25.383660114898348,8799.009766,11050.769531,5.792388070314477,-94.20761192968553,-614.183976374632,-489.0898318807849,-0.11338813204535936,2116000.0
728,BSESN,2006-06-15,9545.05957,9582.969727,9092.160156,9133.360352,26200.0,615.6191399999989,0.0,615.6191399999989,43.217190436693045,8799.009766,10992.379883,34.01385831865056,-65.98614168134944,-587.4294798677856,-508.75776147818505,-0.0867134136264337,2142200.0
729,BSESN,2006-06-16,9884.509766,10118.280273,9703.05957,9703.05957,33400.0,339.45019599999983,0.0,339.45019599999983,50.711937575364075,8799.009766,10988.230469,49.58385413185998,-50.41614586814001,-532.6949785946927,-513.5452049014866,-0.03220946121143464,2175600.0
730,BSESN,2006-06-19,9997.839844,10049.94043,9755.209961,9903.110352,20800.0,113.33007800000088,0.0,113.33007800000088,53.09678056677607,8799.009766,10679.490234,63.75126455182091,-36.24873544817909,-474.7006482571451,-505.77629357261833,0.004069320833949508,2196400.0
731,BSESN,2006-06-20,9822.519531,9958.330078,9745.169922,9958.330078,22400.0,-175.32031300000014,175.32031300000014,0.0,48.87550002210602,8799.009766,10597.230469,56.91791687708092,-43.08208312291908,-437.83946685585397,-492.1889282292655,0.006739918433695369,2174000.0
732,BSESN,2006-06-21,10040.139648,10054.049805,9757.540039,9797.870117,24800.0,217.62011700000042,0.0,217.62011700000042,54.10171417816195,8799.009766,10552.379883,70.7853903728873,-29.214609627112697,-386.6099909903878,-471.07314078149,0.08007157121657782,2198800.0
733,BSESN,2006-06-22,10275.879883,10362.740234,10093.379883,10093.379883,22400.0,235.7402349999993,0.0,235.7402349999993,59.30185731518543,8799.009766,10552.379883,84.23036885828253,-15.769631141717463,-323.26163655458913,-441.5108399361099,0.04744119275245051,2221200.0
734,BSESN,2006-06-23,10401.299805,10453.610352,10025.19043,10201.30957,22600.0,125.41992200000095,0.0,125.41992200000095,61.94836338022583,8799.009766,10453.610352,96.83847887867246,-3.1615211213275316,-259.9408336142369,-405.1968386717353,0.09762924561419628,2243800.0
735,BSESN,2006-06-26,10042.05957,10451.469727,9991.120117,10427.849609,21800.0,-359.2402350000011,359.2402350000011,0.0,50.9899175433838,8799.009766,10453.610352,75.12688043977278,-24.873119560227217,-236.0255699018362,-371.3625849177555,0.10807094356995606,2222000.0
736,BSESN,2006-06-27,10151.009766,10224.259766,9902.330078,10058.290039,31400.0,108.95019599999979,0.0,108.95019599999979,53.84692095376065,8799.009766,10453.610352,81.71156298623478,-18.28843701376523,-205.9076061168853,-338.2715891575815,0.13680245090117005,2253400.0
737,BSESN,2006-06-28,10129.700195,10204.660156,9909.759766,10067.549805,26000.0,-21.309570999999774,21.309570999999774,0.0,53.14771594874847,8799.009766,10453.610352,80.42366479616368,-19.576335203836326,-181.66429421566318,-306.95013016919785,0.06125059992684778,2227400.0
738,BSESN,2006-06-29,10162.160156,10326.049805,10109.55957,10193.94043,20200.0,32.45996100000048,0.0,32.45996100000048,54.19314678397445,8799.009766,10453.610352,82.38546520132807,-17.614534798671933,-158.01059946438545,-277.16222402823536,0.02808944465359753,2247600.0
739,BSESN,2006-06-30,10609.25,10626.839844,10316.120117,10316.120117,30600.0,447.08984400000014,0.0,447.08984400000014,66.18464009894323,8799.009766,10626.839844,99.03766525063168,-0.9623347493683204,-102.01252514398766,-242.1322842513858,0.0611542258667932,2278200.0
740,BSESN,2006-07-03,10695.259766,10729.919922,10589.459961,10646.55957,22600.0,86.00976599999922,0.0,86.00976599999922,68.041705805183,8799.009766,10729.919922,98.20498349484056,-1.7950165051594413,-50.11567617907167,-203.728962636923,0.08885095440590574,2300800.0
741,BSESN,2006-07-04,10662.219727,10800.110352,10644.719727,10755.450195,17400.0,-33.040038999999524,33.040038999999524,0.0,66.42480187850455,9092.160156,10800.110352,91.9265429798282,-8.0734570201718,-11.520305586285758,-165.28723122679557,0.06195930542897554,2283400.0
742,BSESN,2006-07-05,10919.639648,10940.450195,10611.349609,10641.330078,25600.0,257.4199210000006,0.0,257.4199210000006,72.33485609183306,9703.05957,10940.450195,98.31819099162811,-1.6818090083718822,39.38444063411771,-124.35289685461291,0.06264765376101855,2309000.0
743,BSESN,2006-07-06,10767.969727,10839.530273,10703.0,10836.490234,22000.0,-151.66992100000058,151.66992100000058,0.0,64.60384237025445,9745.169922,10940.450195,85.56987244781546,-14.43012755218455,66.71922599045683,-86.13847228559895,0.03525231739053791,2287000.0
744,BSESN,2006-07-07,10509.530273,10887.669922,10440.019531,10813.75,28000.0,-258.4394539999994,258.4394539999994,0.0,53.385698343768546,9745.169922,10940.450195,63.948210998375686,-36.05178900162431,66.75878256319265,-55.559021315840624,0.04655127762800171,2259000.0
745,BSESN,2006-07-10,10684.299805,10704.780273,10461.730469,10484.25,16600.0,174.76953200000025,0.0,174.76953200000025,58.94796909631377,9757.540039,10940.450195,78.34574428998317,-21.654255710016823,79.97071938157023,-28.453073176358444,0.05253566406626997,2275600.0
746,BSESN,2006-07-11,10614.349609,10699.620117,10566.709961,10699.620117,18400.0,-69.95019599999978,69.95019599999978,0.0,55.86920405825678,9902.330078,10940.450195,68.58739363009579,-31.412606369904218,83.83053208677666,-5.996352123731418,0.04784439861697232,2257200.0
747,BSESN,2006-07-12,10930.089844,10939.679688,10549.849609,10604.639648,25600.0,315.7402349999993,0.0,315.7402349999993,65.30645112258532,9902.330078,10940.450195,99.00200845448029,-0.9979915455197146,111.08652338473803,17.420222977962478,0.07556756400326892,2282800.0
748,BSESN,2006-07-13,10858.5,10922.610352,10797.490234,10922.610352,22200.0,-71.58984400000007,71.58984400000007,0.0,61.846363265067794,9902.330078,10940.450195,92.10590434979505,-7.894095650204952,125.46411848844036,39.02900208005806,0.023493649409713324,2260600.0
749,BSESN,2006-07-14,10678.219727,10782.980469,10563.759766,10782.980469,20800.0,-180.2802730000003,180.2802730000003,0.0,53.595422997706294,9902.330078,10940.450195,74.73987222617322,-25.260127773826785,120.91749323364274,55.40670031077501,-0.001593232831442748,2239800.0
750,BSESN,2006-07-17,10293.219727,10647.259766,10262.570313,10647.259766,17800.0,-385.0,385.0,0.0,40.33558851158089,9909.759766,10940.450195,37.20418374041197,-62.79581625958804,85.26509460684974,61.37837916998996,-0.034608178170027704,2222000.0
751,BSESN,2006-07-18,10226.780273,10406.429688,10149.849609,10336.620117,20200.0,-66.43945399999939,66.43945399999939,0.0,38.44181716603396,10109.55957,10940.450195,14.107837960020413,-85.8921620399796,51.060608245607,59.314824985113376,-0.06345075454270155,2201800.0
752,BSESN,2006-07-19,10007.339844,10406.209961,9972.730469,10320.589844,24400.0,-219.44042900000028,219.44042900000028,0.0,32.60744180348357,9972.730469,10940.450195,3.5763841606345457,-96.42361583936545,6.175114814484914,48.68688295098768,-0.07063818921154363,2177400.0
753,BSESN,2006-07-20,10352.94043,10409.580078,10225.179688,10247.870117,23600.0,345.60058600000053,0.0,345.60058600000053,47.17628666137272,9972.730469,10940.450195,39.28926431742498,-60.71073568257502,-1.492676481288072,38.650971064532534,-0.014899794656122234,2201000.0
754,BSESN,2006-07-21,10085.910156,10336.379883,10035.240234,10336.379883,23000.0,-267.0302740000006,267.0302740000006,0.0,39.55323116256904,9972.730469,10940.450195,11.69550273278194,-88.30449726721807,-28.784755035170747,25.163825844591877,-0.056006444963287993,2178000.0
755,BSESN,2006-07-24,10215.370117,10252.75,9875.349609,9881.030273,20600.0,129.45996100000048,0.0,129.45996100000048,44.56416637616201,9875.349609,10940.450195,31.92379315806705,-68.07620684193296,-39.512115930259824,12.228637489621535,-0.03758868952853245,2198600.0
756,BSESN,2006-07-25,10415.610352,10443.049805,10323.769531,10351.75,18400.0,200.2402349999993,0.0,200.2402349999993,51.708764352422925,9875.349609,10939.679688,50.76063842032967,-49.23936157967032,-31.492882888745953,3.484333413948036,-0.04707001491688745,2217000.0
757,BSESN,2006-07-26,10617.269531,10648.769531,10362.610352,10465.339844,19600.0,201.65917900000028,0.0,201.65917900000028,57.99893051301509,9875.349609,10939.679688,69.70769093522908,-30.29230906477092,-8.764342632419357,1.0345982046745568,-0.022215818851590963,2236600.0
758,BSESN,2006-07-27,10741.589844,10762.669922,10589.679688,10671.769531,20800.0,124.32031300000016,0.0,124.32031300000016,61.56051587234843,9875.349609,10939.679688,81.38830726402874,-18.611692735971264,19.060086726613008,4.639695909062248,0.005934520792802989,2257400.0
759,BSESN,2006-07-28,10680.230469,10787.650391,10603.830078,10787.650391,21000.0,-61.359375,61.359375,0.0,58.72462198005212,9875.349609,10939.679688,75.62323717809724,-24.376762821902755,35.74787939563612,10.861332606377026,0.03759860881866128,2236400.0
760,BSESN,2006-07-31,10743.879883,10853.910156,10710.290039,10759.19043,17800.0,63.649413999999524,0.0,63.649413999999524,60.8815269445844,9875.349609,10939.679688,81.60346974465233,-18.396530255347663,53.492423721560044,19.387550829413634,0.05056328543258215,2254200.0
761,BSESN,2006-08-01,10751.660156,10777.469727,10646.650391,10737.5,15800.0,7.7802730000003075,0.0,7.7802730000003075,61.1677344463232,9875.349609,10922.610352,83.67644379466633,-16.323556205333666,67.40589277780782,28.991219219092475,0.07437743931982732,2270000.0
762,BSESN,2006-08-02,10876.19043,10891.379883,10730.129883,10747.129883,18600.0,124.53027400000065,0.0,124.53027400000065,65.79023736154213,9875.349609,10891.379883,98.50501964471985,-1.4949803552801484,87.4726394768295,40.68750327063989,0.05054119682595326,2288600.0
763,BSESN,2006-08-03,10923.160156,11081.900391,10875.870117,10955.269531,20600.0,46.96972599999936,0.0,46.96972599999936,67.4751993132748,9875.349609,11081.900391,86.84346839203329,-13.15653160796671,105.94448310168264,53.73889923684844,0.08301184395360983,2309200.0
764,BSESN,2006-08-04,10866.509766,11039.339844,10810.040039,10951.80957,18800.0,-56.650390000000705,56.650390000000705,0.0,63.14682938484688,9875.349609,11081.900391,82.14823377405094,-17.851766225949063,114.69026129093436,65.92917164766564,0.0637411705637958,2290400.0
765,BSESN,2006-08-07,10812.639648,10869.660156,10780.009766,10863.280273,13600.0,-53.870117999998904,53.870117999998904,0.0,58.99456384381911,9875.349609,11081.900391,77.683430567782,-22.316569432218003,115.93802383475304,75.93094208508312,0.03811867788657852,2276800.0
766,BSESN,2006-08-08,11014.969727,11028.019531,10839.530273,10839.530273,15200.0,202.3300789999994,0.0,202.3300789999994,68.08832593979297,9875.349609,11081.900391,94.45272714596776,-5.547272854032232,131.7346757327923,87.09168881462496,0.03745786003066098,2292000.0
767,BSESN,2006-08-09,11145.179688,11187.650391,10943.830078,10990.730469,18400.0,130.20996100000048,0.0,130.20996100000048,72.6004162390059,9875.349609,11187.650391,96.76364568378357,-3.23635431621644,152.9968394850148,100.27271894870294,0.037572635881776506,2310400.0
768,BSESN,2006-08-10,11149.169922,11213.030273,11051.75,11175.0,16600.0,3.990233999998964,0.0,3.990233999998964,72.73672016308949,9875.349609,11213.030273,95.2260391647553,-4.773960835244696,168.22998542780806,113.86417224452397,0.04390724098708576,2327000.0
769,BSESN,2006-08-11,11192.459961,11241.110352,11069.25,11181.339844,18600.0,43.29003900000134,0.0,43.29003900000134,74.33496660538432,10323.769531,11241.110352,94.69658496751893,-5.303415032481066,181.70097199349766,127.43153219431872,0.041752149399006955,2345600.0
770,BSESN,2006-08-14,11312.990234,11330.299805,11221.860352,11221.860352,13200.0,120.5302730000003,0.0,120.5302730000003,78.4024532666347,10362.610352,11330.299805,98.2112473225437,-1.788752677456304,199.79944795244592,141.90511534594415,0.052208688691369076,2358800.0
771,BSESN,2006-08-16,11448.30957,11507.919922,11384.049805,11384.049805,15200.0,135.31933599999866,0.0,135.31933599999866,82.08123486490486,10589.679688,11507.919922,93.5081964617987,-6.491803538201285,222.49695366441483,158.0234830096383,0.05260289838452192,2374000.0
772,BSESN,2006-08-17,11477.480469,11551.589844,11379.44043,11498.469727,19800.0,29.170899000000645,0.0,29.170899000000645,82.80955861646912,10603.830078,11551.589844,92.18057384807786,-7.819426151922137,240.0713451975589,174.43305544722244,0.050747247598994294,2393800.0
773,BSESN,2006-08-18,11465.719727,11508.169922,11409.110352,11507.139648,14600.0,-11.760742000000393,11.760742000000393,0.0,81.27283897414898,10646.650391,11551.589844,90.51095443840703,-9.489045561592983,250.16642073837102,189.57972850545218,0.05514281714215685,2379200.0
774,BSESN,2006-08-21,11511.679688,11531.599609,11375.900391,11488.030273,11000.0,45.959961000000476,0.0,45.959961000000476,82.71887471361251,10646.650391,11551.589844,95.58974295267024,-4.410257047329759,258.89109025053403,203.44200085446857,0.06465026697983967,2390200.0
775,BSESN,2006-08-22,11502.620117,11619.860352,11460.929688,11547.419922,12200.0,-9.059570999999776,9.059570999999776,0.0,81.29120892525873,10730.129883,11619.860352,86.82294929926702,-13.177050700732975,262.0536308968094,215.16432686293678,0.044271605105247636,2378000.0
776,BSESN,2006-08-23,11406.650391,11579.919922,11374.860352,11579.919922,13200.0,-95.96972600000116,95.96972600000116,0.0,67.12965585555837,10780.009766,11619.860352,74.61334616488553,-25.38665383511447,253.88933410517893,222.90932831138525,0.023460429559652995,2364800.0
777,BSESN,2006-08-24,11531.950195,11566.889648,11297.230469,11367.740234,15600.0,125.29980400000021,0.0,125.29980400000021,73.96286284334522,10780.009766,11619.860352,89.5326432504269,-10.467356749573096,254.5949054951543,229.24644374813906,0.03433262526967873,2380400.0
778,BSESN,2006-08-25,11572.200195,11635.25,11542.099609,11589.349609,17000.0,40.25,0.0,40.25,75.82555162110901,10780.009766,11635.25,92.62782520121704,-7.37217479878297,255.4571633591513,234.48858767034153,0.03392821911565469,2397400.0
779,BSESN,2006-08-28,11619.519531,11633.349609,11552.44043,11583.730469,9200.0,47.319336000000476,0.0,47.319336000000476,77.96400773684383,10839.530273,11635.25,98.02311436222567,-1.9768856377743278,256.99629061602536,238.9901282594783,0.02709533824918875,2406600.0
780,BSESN,2006-08-29,11706.849609,11739.769531,11651.959961,11651.959961,16000.0,87.33007800000088,0.0,87.33007800000088,81.45699497084112,10943.830078,11739.769531,95.86401680731875,-4.135983192681262,262.23992884159816,243.64008837590225,0.02258325016625151,2422600.0
781,BSESN,2006-08-30,11723.919922,11756.080078,11643.379883,11735.049805,12800.0,17.07031299999835,0.0,17.07031299999835,82.09704603672611,11051.75,11756.080078,95.43393687071793,-4.566063129282077,264.72143756144214,247.85635821301025,0.021471563699508645,2435400.0
782,BSESN,2006-08-31,11699.049805,11794.429688,11675.080078,11754.070313,16600.0,-24.87011699999857,24.87011699999857,0.0,77.59458292936952,11069.25,11794.429688,86.84741387847592,-13.152586121524074,261.66493007344434,250.61807258509708,0.020350233875902735,2418800.0
783,BSESN,2006-09-01,11778.019531,11795.019531,11666.009766,11699.570313,11600.0,78.96972599999934,0.0,78.96972599999934,81.34333957350637,11221.860352,11795.019531,97.03398277077928,-2.9660172292207143,262.5878732315814,253.012032714394,0.023136488350838702,2430400.0
784,BSESN,2006-09-04,11914.209961,11939.959961,11824.490234,11824.490234,10000.0,136.19043000000056,0.0,136.19043000000056,86.00339264046168,11297.230469,11939.959961,95.99364891132147,-4.00635108867853,271.18271629585615,256.6461694306864,0.03578226871908097,2440400.0
785,BSESN,2006-09-05,11904.599609,11945.530273,11847.929688,11927.419922,12000.0,-9.610351999999693,9.610351999999693,0.0,84.28916181203766,11297.230469,11945.530273,93.68646053146122,-6.313539468538773,274.05952860780235,260.1288412661096,0.043654289465458795,2428400.0
786,BSESN,2006-09-06,11933.209961,11983.480469,11904.919922,11908.530273,12400.0,28.61035199999969,0.0,28.61035199999969,85.29591613152067,11297.230469,11983.480469,92.67460721311481,-7.325392786885189,275.4725631586716,263.197585644622,0.034795482048992854,2440800.0
787,BSESN,2006-09-07,11853.849609,11921.299805,11815.429688,11893.330078,11800.0,-79.36035199999971,79.36035199999971,0.0,70.77948562847655,11297.230469,11983.480469,81.11025719489992,-18.88974280510008,267.1096127109613,263.97999105788983,0.024338449841344145,2429000.0
788,BSESN,2006-09-08,11918.650391,11940.580078,11825.219727,11859.44043,16400.0,64.80078199999842,0.0,64.80078199999842,74.81739704710978,11297.230469,11983.480469,90.55299409836053,-9.44700590163947,262.6827525173303,263.7205433497779,0.02574382350336779,2445400.0
789,BSESN,2006-09-11,11550.69043,11971.599609,11505.599609,11959.55957,18600.0,-367.9599609999986,367.9599609999986,0.0,39.26612263840732,11297.230469,11983.480469,36.9340562477232,-63.0659437522768,226.86794775574162,256.3500242309707,-0.013339129160756302,2426800.0
790,BSESN,2006-09-12,11660.790039,11671.639648,11445.19043,11564.950195,19400.0,110.09960899999895,0.0,110.09960899999895,47.825530816856855,11297.230469,11983.480469,52.97771511839701,-47.02228488160299,205.00540060913045,246.08109950660264,-0.005384707795686672,2446200.0
791,BSESN,2006-09-13,11893.790039,11938.410156,11723.780273,11723.780273,15400.0,233.0,0.0,233.0,61.18365369584962,11445.19043,11983.480469,83.33789899463463,-16.662101005365372,204.12727505997464,237.69033461727705,0.01664581630524986,2461600.0
792,BSESN,2006-09-14,11973.019531,12002.94043,11892.240234,11936.799805,14400.0,79.22949200000039,0.0,79.22949200000039,64.72696330564011,11445.19043,12002.94043,94.63542823845798,-5.364571761542026,207.43334956066428,231.6389376059545,0.016556263936118976,2476000.0
793,BSESN,2006-09-15,12009.589844,12041.700195,11847.610352,11977.69043,12800.0,36.57031300000017,0.0,36.57031300000017,66.36231175070836,11445.19043,12041.700195,94.61696138369177,-5.3830386163082204,210.57695598074133,227.4265412809119,0.008005556668231995,2488800.0
794,BSESN,2006-09-18,12071.299805,12114.950195,12006.19043,12006.19043,12400.0,61.709961000000476,0.0,61.709961000000476,69.14736918559446,11445.19043,12114.950195,93.4826795694425,-6.517320430557508,215.56289002518133,225.0538110297658,0.014003007364814968,2501200.0
795,BSESN,2006-09-19,11970.469727,12152.599609,11915.209961,12103.44043,17200.0,-100.83007800000088,100.83007800000088,0.0,59.81111529732908,11445.19043,12152.599609,74.25395550316982,-25.74604449683018,208.9692664300801,221.83690210982866,0.003122359040172107,2484000.0
796,BSESN,2006-09-20,12109.139648,12128.990234,11833.610352,11946.320313,13800.0,138.66992100000058,0.0,138.66992100000058,66.90251624874168,11445.19043,12152.599609,93.85646068921018,-6.143539310789811,212.4838938763114,219.9663004631252,0.021536466837420498,2497800.0
797,BSESN,2006-09-21,12274.269531,12285.900391,12167.910156,12167.910156,15000.0,165.1298829999996,0.0,165.1298829999996,73.36105680149686,11445.19043,12285.900391,98.61654309577054,-1.3834569042294624,225.98880469172218,221.1708013088446,0.029837198704018908,2512800.0
798,BSESN,2006-09-22,12236.780273,12303.419922,12170.200195,12244.410156,13400.0,-37.48925799999961,37.48925799999961,0.0,69.79340174014877,11445.19043,12303.419922,92.23521801322589,-7.764781986774108,231.00360820018432,223.13736268711253,0.05939816733535297,2499400.0
799,BSESN,2006-09-25,12173.910156,12273.450195,12145.089844,12257.269531,15200.0,-62.87011700000039,62.87011700000039,0.0,63.79053308380112,11445.19043,12303.419922,84.90965794030305,-15.090342059696946,227.28478556778282,223.9668472632466,0.0440038895549828,2484200.0
800,BSESN,2006-09-26,12321.19043,12331.450195,12160.580078,12206.790039,14200.0,147.28027400000062,0.0,147.28027400000062,70.62073602374036,11445.19043,12331.450195,98.84235238863643,-1.1576476113635703,233.52989185216393,225.87945618103006,0.03593475163077087,2498400.0
801,BSESN,2006-09-27,12366.910156,12442.820313,12339.980469,12359.009766,12600.0,45.71972599999936,0.0,45.71972599999936,72.48010343994116,11445.19043,12442.820313,92.39094996114903,-7.609050038850959,239.40862971198112,228.58529088722028,0.032898186124240114,2511000.0
802,BSESN,2006-09-28,12380.740234,12431.790039,12340.169922,12388.660156,13400.0,13.830078000000867,0.0,13.830078000000867,73.07487601322839,11445.19043,12442.820313,93.77724343888771,-6.222756561112295,242.38942907551973,231.34611852488018,0.03090450172080006,2524400.0
803,BSESN,2006-09-29,12454.419922,12485.169922,12381.290039,12414.660156,12600.0,73.67968799999834,0.0,73.67968799999834,76.23248897411052,11445.19043,12485.169922,97.04321092516312,-2.956789074836876,247.84012244495352,234.64491930889488,0.031738099723221946,2537000.0
804,BSESN,2006-10-03,12366.389648,12489.280273,12343.799805,12473.790039,11600.0,-88.03027399999884,88.03027399999884,0.0,65.6231055424208,11723.780273,12489.280273,83.94635858915741,-16.053641410842587,242.26386180339978,236.1687078077959,0.033074718873143505,2525400.0
805,BSESN,2006-10-04,12204.009766,12419.650391,12178.830078,12401.089844,14400.0,-162.3798820000011,162.3798820000011,0.0,50.626951375728574,11833.610352,12489.280273,56.491750214053084,-43.508249785946916,222.18077399815593,233.37112104586794,0.007834587820255923,2511000.0
806,BSESN,2006-10-05,12389.410156,12415.969727,12299.209961,12299.209961,12200.0,185.4003900000007,0.0,185.4003900000007,62.051601293036775,11833.610352,12489.280273,84.76823264247312,-15.231767357526882,218.7039611137243,230.43768905943924,0.009380649879750402,2523200.0
807,BSESN,2006-10-06,12372.80957,12434.219727,12357.959961,12391.259766,12000.0,-16.600586000000476,16.600586000000476,0.0,60.6028081317747,11833.610352,12489.280273,82.23638155882391,-17.7636184411761,212.1633463112339,226.78282050979817,0.011116428828925162,2511200.0
808,BSESN,2006-10-09,12365.830078,12429.740234,12261.490234,12335.820313,10600.0,-6.979491999998572,6.979491999998572,0.0,59.92406884159055,11833.610352,12489.280273,81.17189899275563,-18.828101007244364,204.0643484994689,222.23912610773232,0.015764854474912715,2500600.0
809,BSESN,2006-10-10,12363.769531,12481.929688,12341.339844,12416.429688,11400.0,-2.060547000000952,2.060547000000952,0.0,59.69631569390818,11833.610352,12489.280273,80.85763308943979,-19.14236691056021,195.2290860828507,216.837118102756,0.003455761944586744,2489200.0
810,BSESN,2006-10-11,12353.490234,12514.179688,12301.509766,12446.719727,13800.0,-10.279296999999133,10.279296999999133,0.0,58.41828670305219,12145.089844,12514.179688,56.46332278923411,-43.53667721076589,185.26203814865949,210.52210211193668,-0.0010851475292305013,2475400.0
811,BSESN,2006-10-12,12537.980469,12558.709961,12315.019531,12387.889648,13600.0,184.4902349999993,0.0,184.4902349999993,71.19091998811913,12145.089844,12558.709961,94.98827761319927,-5.01172238680073,190.05901890507812,206.42948547056503,0.012700390447429433,2489000.0
812,BSESN,2006-10-13,12736.419922,12756.230469,12632.620117,12632.620117,16600.0,198.43945299999905,0.0,198.43945299999905,79.14235984192038,12145.089844,12756.230469,96.7584306803363,-3.2415693196636943,207.48135029081823,206.63985843461566,0.022642563986610353,2505600.0
813,BSESN,2006-10-16,12928.179688,12953.759766,12785.030273,12785.030273,18800.0,191.75976600000104,0.0,191.75976600000104,84.05070639065455,12160.580078,12953.759766,96.77499583171385,-3.2250041682861523,234.0639405412894,212.12467485595042,0.045428783662081695,2524400.0
814,BSESN,2006-10-17,12883.830078,12994.450195,12819.349609,12981.530273,16000.0,-44.349609999999295,44.349609999999295,0.0,79.08431840970796,12178.830078,12994.450195,86.4372990937399,-13.562700906260108,248.6855003040073,219.43683994556184,0.05570466797674656,2508400.0
815,BSESN,2006-10-18,12858.480469,12920.589844,12830.839844,12886.330078,16400.0,-25.349609000000786,25.349609000000786,0.0,76.11801153922642,12178.830078,12994.450195,83.32928244828963,-16.67071755171036,255.2849244679146,226.6064568500324,0.03786058473274756,2492000.0
816,BSESN,2006-10-19,12723.589844,12925.599609,12654.980469,12881.799805,15400.0,-134.890625,134.890625,0.0,61.869734184544654,12178.830078,12994.450195,66.79086925954282,-33.209130740457184,246.78567787875,230.64230105577593,0.028350898962393067,2476600.0
817,BSESN,2006-10-20,12709.400391,12849.019531,12679.849609,12756.410156,15800.0,-14.189453000000867,14.189453000000867,0.0,60.49528636558484,12178.830078,12994.450195,65.05115579438304,-34.94884420561695,236.18242942423421,231.75032672946762,0.027783845551237363,2460800.0
818,BSESN,2006-10-23,12623.280273,12766.299805,12612.360352,12757.30957,7800.0,-86.12011799999891,86.12011799999891,0.0,52.35085683880033,12178.830078,12994.450195,54.49230416664677,-45.50769583335323,218.31352245360904,229.0629658742959,0.02098961334966032,2453000.0
819,BSESN,2006-10-26,12698.410156,12718.30957,12636.160156,12636.160156,13200.0,75.12988299999961,0.0,75.12988299999961,58.037505917563685,12261.490234,12994.450195,59.610339615808826,-40.389660384191174,207.81903019510173,224.81417873845712,0.02792084791152294,2466200.0
820,BSESN,2006-10-27,12906.80957,12921.230469,12741.849609,12741.849609,15200.0,208.39941399999955,0.0,208.39941399999955,69.63581445640727,12261.490234,12994.450195,88.0429178040736,-11.95708219592641,213.85299629233668,222.62194224923303,0.029416946525951726,2481400.0
821,BSESN,2006-10-30,13024.259766,13039.299805,12844.849609,12925.429688,13800.0,117.45019599999979,0.0,117.45019599999979,74.26191217544702,12261.490234,13039.299805,98.06635974141268,-1.9336402585873231,225.5126378295754,223.2000813653015,0.02259974512168883,2495200.0
822,BSESN,2006-10-31,12961.900391,13075.849609,12907.94043,13048.759766,17200.0,-62.359375,62.359375,0.0,67.9223163781912,12301.509766,13075.849609,85.28434006979009,-14.715659930209913,227.10320299032355,223.9807056903059,0.002608310204049724,2478000.0
823,BSESN,2006-11-01,13033.040039,13050.730469,12937.299805,12992.620117,12800.0,71.13964800000029,0.0,71.13964800000029,71.16277695728623,12301.509766,13075.849609,94.4714752331295,-5.528524766870503,231.4362592616726,225.47181640457927,0.011581180448412276,2490800.0
824,BSESN,2006-11-02,13091.120117,13137.740234,13014.650391,13062.519531,12000.0,58.08007800000087,0.0,58.08007800000087,73.66855090081475,12315.019531,13137.740234,94.33342119263524,-5.666578807364757,236.82682228610065,227.74281758088352,0.018092312583968484,2502800.0
825,BSESN,2006-11-03,13130.790039,13146.860352,13017.839844,13119.339844,12600.0,39.66992199999913,0.0,39.66992199999913,75.3561855920046,12612.360352,13146.860352,96.99339326473336,-3.006606735266636,241.51586889172177,230.49742784305116,0.032003561887215426,2515400.0
826,BSESN,2006-11-06,13186.889648,13206.870117,13113.389648,13155.110352,14600.0,56.09960900000078,0.0,56.09960900000078,77.6894324842768,12612.360352,13206.870117,96.63916891255772,-3.360831087442283,246.91248824493778,233.7804399234285,0.037569770587928764,2530000.0
827,BSESN,2006-11-07,13156.660156,13300.69043,13135.209961,13208.790039,17200.0,-30.22949200000039,30.22949200000039,0.0,73.3703426677661,12612.360352,13300.69043,79.07540602925673,-20.92459397074327,245.91532184367134,236.20741630747708,0.0422536671502769,2512800.0
828,BSESN,2006-11-08,13072.509766,13202.679688,12950.570313,13176.080078,16400.0,-84.15039000000071,84.15039000000071,0.0,62.253808598226264,12612.360352,13300.69043,66.85010995553196,-33.14989004446803,235.61876068206584,236.08968518239485,0.029460350185903872,2496400.0
829,BSESN,2006-11-09,13137.490234,13192.889648,13069.849609,13107.780273,16800.0,64.98046800000158,0.0,64.98046800000158,66.74334984907094,12612.360352,13300.69043,76.29041629646764,-23.70958370353236,230.05016735394747,234.88178161670538,0.017872787442078986,2513200.0
830,BSESN,2006-11-10,13282.910156,13303.849609,13104.980469,13187.509766,16400.0,145.41992199999913,0.0,145.41992199999913,74.55744272222029,12612.360352,13303.849609,96.97183249225796,-3.0281675077420376,234.66610462275457,234.83864621791525,0.019859124022941543,2529600.0
831,BSESN,2006-11-13,13399.0,13410.080078,13287.280273,13295.240234,12800.0,116.08984400000007,0.0,116.08984400000007,79.08424769134649,12612.360352,13410.080078,98.6110312132358,-1.3889687867641938,244.8690503846683,236.8447270512659,0.033721876871041,2542400.0
832,BSESN,2006-11-14,13425.5,13486.740234,13380.769531,13439.709961000002,22000.0,26.5,0.0,26.5,80.02054590297638,12636.160156,13486.740234,92.80018006723164,-7.199819932768367,252.18624093448852,239.91302982791044,0.03011269510609993,2564400.0
833,BSESN,2006-11-15,13469.370117,13506.080078,13390.790039,13476.280272999997,14400.0,43.87011699999857,0.0,43.87011699999857,81.59439011732137,12741.849609,13506.080078,95.19648031724832,-4.80351968275168,258.54477573067743,243.63937900846386,0.02889363145547863,2578800.0
834,BSESN,2006-11-16,13505.889647999997,13588.009766,13459.280272999997,13500.700195,68200.0,36.51953099999992,0.0,36.51953099999992,82.8890523865652,12844.849609,13588.009766,88.94987611667634,-11.050123883323677,263.4933934914443,247.61018190505996,0.028566415873371387,2647000.0
835,BSESN,2006-11-17,13429.480469,13678.040038999998,13383.429688,13678.040038999998,20800.0,-76.4091789999984,76.4091789999984,0.0,70.85658378390491,12907.94043,13678.040038999998,67.72371169974214,-32.27628830025786,258.2724228311745,249.74263009028292,0.018396363924740422,2626200.0
836,BSESN,2006-11-20,13430.709961000002,13463.05957,13200.360352,13390.950195,15600.0,1.2294920000022105,0.0,1.2294920000022105,70.93491902426955,12937.299805,13678.040038999998,66.61041662818651,-33.389583371813494,251.33672241265958,250.06144855475827,0.020829739595806362,2641800.0
837,BSESN,2006-11-21,13616.769531,13630.410156,13434.580078,13434.580078,14200.0,186.0595699999976,0.0,186.0595699999976,80.21900374262131,12950.570313,13678.040038999998,91.57758655650255,-8.42241344349744,257.8808918008581,251.62533720397823,0.04163391534925864,2656000.0
838,BSESN,2006-11-22,13706.530272999997,13740.389647999997,13625.089844,13625.089844,15200.0,89.76074199999857,0.0,89.76074199999857,83.20523721693783,12950.570313,13740.389647999997,95.7130227762783,-4.286977223721695,267.2296775289251,254.7462052689676,0.04331421214131992,2671200.0
839,BSESN,2006-11-23,13680.830078,13790.820313,13643.469727000003,13667.129883,12200.0,-25.70019499999762,25.70019499999762,0.0,79.25259953873578,12950.570313,13790.820313,86.90982029157996,-13.09017970842003,269.458714295597,257.6887070742935,0.029957284761145342,2659000.0
840,BSESN,2006-11-24,13703.330078,13767.849609,13665.519531,13669.80957,17800.0,22.5,0.0,22.5,80.2026306653582,12950.570313,13790.820313,89.58759476346334,-10.412405236536662,269.9292278387675,260.13681122718833,0.022712894842898734,2676800.0
841,BSESN,2006-11-27,13773.589844,13799.019531,13716.459961000002,13716.459961000002,12000.0,70.25976599999922,0.0,70.25976599999922,83.00634094185054,12950.570313,13799.019531,97.00280388495804,-2.997196115041954,272.8265149071922,262.6747519631891,0.025927514357007242,2688800.0
842,BSESN,2006-11-28,13601.950195,13691.120117,13577.379883,13690.669922,16000.0,-171.63964900000062,171.63964900000062,0.0,59.32437917164651,13069.849609,13799.019531,72.97346886450417,-27.026531135495834,258.29528331798065,261.7988582341474,0.00984307928643724,2672800.0
843,BSESN,2006-11-29,13616.730469,13711.759766,13586.040038999998,13649.200195,13600.0,14.780274000000643,0.0,14.780274000000643,60.44565730277036,13104.980469,13799.019531,73.735042884373,-26.264957115627,245.1459324681109,258.4682730809401,0.008206850780571706,2686400.0
844,BSESN,2006-11-30,13696.30957,13745.160156,13630.610352000003,13630.900391,10800.0,79.57910099999934,0.0,79.57910099999934,66.22909783752101,13200.360352,13799.019531,82.84333313462811,-17.156666865371896,238.3982390618803,254.45426627712814,0.019868907186390006,2697200.0
845,BSESN,2006-12-01,13844.780272999997,13857.80957,13725.780272999997,13729.669922,12200.0,148.47070299999902,0.0,148.47070299999902,74.31404892163215,13200.360352,13857.80957,98.01820480680794,-1.9817951931920583,242.23861239817597,252.01113550133772,0.030830113464021647,2709400.0
846,BSESN,2006-12-04,13874.330078,13912.540038999998,13828.900391,13846.709961000002,10000.0,29.54980500000238,0.0,29.54980500000238,75.65264130405032,13200.360352,13912.540038999998,94.6347864594463,-5.3652135405536985,244.844147320935,250.57773786525723,0.018914952361765103,2719400.0
847,BSESN,2006-12-05,13937.650391,14028.469727000003,13905.650391,14028.469727000003,12400.0,63.32031299999835,0.0,63.32031299999835,78.43174101090779,13200.360352,14028.469727000003,89.0329298590535,-10.967070140946504,249.14646720263045,250.29148373273193,0.016862044105741214,2731800.0
848,BSESN,2006-12-06,13949.0,14035.299805,13847.669922,13951.089844,11000.0,11.349609000000784,0.0,11.349609000000784,78.92915722177808,13200.360352,14035.299805,89.66394453035859,-10.336055469641398,250.583336577718,250.34985430172918,0.01960187506686739,2742800.0
849,BSESN,2006-12-07,13972.030272999997,14002.719727000003,13915.740234,13962.94043,9600.0,23.030272999998488,0.0,23.030272999998488,80.00863424488828,13200.360352,14035.299805,92.42226106663523,-7.577738933364768,250.69061115275508,250.4180056719344,0.01960838668196274,2752400.0
850,BSESN,2006-12-08,13799.490234,14009.55957,13756.860352000003,14007.669922,14800.0,-172.54003899999768,172.54003899999768,0.0,55.45127180377031,13434.580078,14035.299805,60.74549238167437,-39.254507618325626,234.15390736792142,247.16518601113185,0.0018804385997659434,2737600.0
851,BSESN,2006-12-11,13399.429688,13801.980469,13261.730469,13783.0,27200.0,-400.0605460000006,400.0605460000006,0.0,30.448299366205006,13261.730469,14035.299805,17.800501208077876,-82.19949879192212,186.6157180280352,235.05529241451254,-0.014889078705378922,2710400.0
852,BSESN,2006-12-12,12995.019531,13492.209961000002,12801.650391,13413.610352,21200.0,-404.41015700000025,404.41015700000025,0.0,19.95398594252218,12801.650391,14035.299805,15.674561816798342,-84.32543818320167,114.9833837357819,211.0409106787664,-0.04565787208723815,2689200.0
853,BSESN,2006-12-13,13181.339844,13223.0,12830.379883,13039.019531,20800.0,186.32031300000014,0.0,186.32031300000014,32.34910236996022,12801.650391,14035.299805,30.77774355429641,-69.2222564457036,72.41399142434966,183.31552682788308,-0.03759915934785629,2710000.0
854,BSESN,2006-12-14,13487.160156,13524.769531,13239.790039,13256.80957,14600.0,305.82031199999983,0.0,305.82031199999983,47.68996931218956,12801.650391,14035.299805,55.56763187503123,-44.432368124968775,62.632595084347486,159.17894047917596,-0.02583068202948846,2724600.0
855,BSESN,2006-12-15,13614.519531,13669.650391,13545.599609,13545.599609,18800.0,127.359375,0.0,127.359375,52.8298826357703,12801.650391,14035.299805,65.89142188819616,-34.10857811180383,64.41506837825364,140.2261660589915,-0.018725988609134547,2743400.0
856,BSESN,2006-12-18,13731.089844,13744.169922,13416.400391,13695.599609,14200.0,116.57031300000016,0.0,116.57031300000016,57.26457777531954,12801.650391,14035.299805,75.34064722540369,-24.659352774596314,74.37657449310063,127.05624774581334,-0.014820327760078023,2757600.0
857,BSESN,2006-12-19,13382.009766,13748.620117,13237.389648,13737.360352000003,18600.0,-349.08007800000087,349.08007800000087,0.0,43.22346809665673,12801.650391,14035.299805,47.04410899999822,-52.95589100000178,53.4867331814512,112.34234483294091,-0.04064737500896132,2739000.0
858,BSESN,2006-12-20,13340.209961,13568.089844,13232.55957,13452.69043,15400.0,-41.79980499999874,41.79980499999874,0.0,41.80714298046649,12801.650391,14035.299805,43.655803981924535,-56.344196018075465,33.1760555933306,96.50908698501885,-0.04522036523360151,2723600.0
859,BSESN,2006-12-21,13384.860352,13441.360352000003,13182.349609,13313.910156,12000.0,44.65039099999922,0.0,44.65039099999922,44.06614698439873,12801.650391,14035.299805,47.27517837575853,-52.72482162424147,20.446911402146725,81.29665186844443,-0.03004675353720032,2735600.0
860,BSESN,2006-12-22,13471.740234,13493.879883,13362.110352,13398.129883,10800.0,86.87988200000109,0.0,86.87988200000109,48.550220285818554,12801.650391,14035.299805,54.31768826666025,-45.68231173333976,17.171510826121448,68.47162365997984,0.005396539082910268,2746400.0
861,BSESN,2006-12-26,13708.339844,13726.620117,13490.769531,13501.44043,8200.0,236.5996099999993,0.0,236.5996099999993,58.90288237305279,12801.650391,14035.299805,73.49652524538061,-26.503474754619393,33.2836700235257,61.434032932689014,0.054891823078707436,2754600.0
862,BSESN,2006-12-27,13859.69043,13911.589844,13734.009766,13734.009766,11400.0,151.35058600000048,0.0,151.35058600000048,64.21734193331959,12801.650391,14009.55957,87.59268141963521,-12.407318580364796,57.60140651125221,60.66750764840166,0.05146294640971405,2766000.0
863,BSESN,2006-12-28,13846.339844,13960.389647999997,13819.769531,13893.290038999998,11600.0,-13.350586000000474,13.350586000000474,0.0,63.38311264173373,12801.650391,14009.55957,86.48741736236121,-13.512582637638795,74.93233386190695,63.52047289110273,0.02663123176751281,2754400.0
864,BSESN,2006-12-29,13786.910156,13929.099609,13770.05957,13873.030272999997,8800.0,-59.42968800000017,59.42968800000017,0.0,59.41845669497304,12801.650391,13960.389647999997,85.02859975166983,-14.971400248330166,82.91593620373715,67.39956555362963,0.012662262858962547,2745600.0
865,BSESN,2007-01-02,13942.240234,13980.540038999998,13797.44043,13827.769531,9600.0,155.33007800000087,0.0,155.33007800000087,65.85882149108022,12801.650391,13980.540038999998,96.7511967668074,-3.248803233192609,100.61698772279124,74.04304998746196,0.015377540486508856,2755200.0
866,BSESN,2007-01-03,14014.919922,14035.669922,13897.419922,13969.450195,11600.0,72.67968799999834,0.0,72.67968799999834,68.55322949704929,12830.379883,14035.669922,98.27842267598795,-1.721577324012051,119.1365104602537,83.06174208202032,0.04729559812518214,2766800.0
867,BSESN,2007-01-04,13871.709961000002,14060.349609,13850.379883,14029.040038999998,14600.0,-143.20996099999687,143.20996099999687,0.0,58.12407735730822,13182.349609,14060.349609,78.51484646924847,-21.485153530751536,120.8642705826478,90.62224778214582,0.03984195162998461,2752200.0
868,BSESN,2007-01-05,13860.519531,13971.820313,13763.389647999997,13768.790038999998,13200.0,-11.190430000002381,11.190430000002381,0.0,57.33760745650929,13182.349609,14060.349609,77.24031002277894,-22.759689977221058,119.9478743186246,96.48737308944159,0.035537104347071136,2739000.0
869,BSESN,2007-01-08,13652.150391,13855.889647999997,13599.870117,13855.889647999997,11600.0,-208.3691400000007,208.3691400000007,0.0,44.42329399209992,13182.349609,14060.349609,53.508061731207114,-46.491938268792886,101.2409330369137,97.43808507893603,0.013391748494725242,2727400.0
870,BSESN,2007-01-09,13566.330078,13748.419922,13493.379883,13650.959961000002,36600.0,-85.82031299999834,85.82031299999834,0.0,40.12808059724641,13182.349609,14060.349609,43.73353861047837,-56.26646138952162,78.58468987845663,93.66740603884016,-0.010359370107253074,2690800.0
871,BSESN,2007-01-10,13362.160156,13569.570313,13336.519531,13569.570313,12600.0,-204.16992200000092,204.16992200000092,0.0,31.71142861457868,13182.349609,14060.349609,20.47956116173111,-79.52043883826889,43.651460693017725,83.66421696967568,-0.0358976469577611,2678200.0
872,BSESN,2007-01-11,13630.709961000002,13667.799805,13303.219727,13331.379883,15600.0,268.5498050000024,0.0,268.5498050000024,48.20053852575411,13182.349609,14060.349609,51.06609931662888,-48.93390068337113,37.207445511343394,74.37286267800923,-0.015573060132092365,2693800.0
873,BSESN,2007-01-12,14056.530272999997,14070.879883,13729.070313,13729.070313,14400.0,425.8203119999962,0.0,425.8203119999962,64.07237382265859,13303.219727,14070.879883,98.13073403799234,-1.869265962007665,65.70327109252321,72.63894436091202,0.019556239501760997,2708200.0
874,BSESN,2007-01-15,14129.639647999997,14202.120117,14103.120117,14110.44043,15400.0,73.109375,0.0,73.109375,66.12841597747564,13303.219727,14202.120117,91.93676298215827,-8.063237017841729,93.11239203398873,76.73363389552736,0.013441126451328556,2723600.0
875,BSESN,2007-01-16,14114.730469,14211.150391,14070.650391,14146.0,9000.0,-14.909178999998405,14.909178999998405,0.0,65.24977575742074,13303.219727,14211.150391,89.38025492219754,-10.61974507780246,112.33632844073327,83.85417280456855,0.00712173509056746,2714600.0
876,BSESN,2007-01-17,14131.339844,14185.120117,14089.629883,14116.25,9000.0,16.609375,0.0,16.609375,65.83331923308279,13303.219727,14211.150391,91.20962093642878,-8.790379063571221,127.4425953868631,92.57185732102747,0.01871650169517247,2723600.0
877,BSESN,2007-01-18,14217.75,14325.919922,14140.349609,14165.769531,13800.0,86.41015599999993,0.0,86.41015599999993,68.96204900526254,13303.219727,14325.919922,89.4231053705823,-10.576894629417685,144.718770306059,103.00123991803379,0.02577323802336773,2737400.0
878,BSESN,2007-01-19,14182.709961000002,14300.110352000003,14067.519531,14271.240234,14400.0,-35.040038999997705,35.040038999997705,0.0,66.12868201194979,13303.219727,14325.919922,85.99687751110706,-14.003122488892936,153.8098014443931,113.16295222330568,0.03886271062101443,2723000.0
879,BSESN,2007-01-22,14209.240234,14259.070313,14111.75,14217.799805,11200.0,26.530272999998488,0.0,26.530272999998488,67.30232130292389,13303.219727,14325.919922,88.59101733133058,-11.408982668669426,161.2959609921545,122.78955397707546,0.04739013073569409,2734200.0
880,BSESN,2007-01-23,14041.240234,14212.120117,14025.740234,14212.120117,14600.0,-168.0,168.0,0.0,53.7055152850224,13303.219727,14325.919922,72.16391574072219,-27.836084259277815,151.92134569775408,128.61591232121117,0.05082112997239263,2719600.0
881,BSESN,2007-01-24,14110.459961000002,14156.459961000002,14043.540038999998,14069.610352000003,18000.0,69.21972700000151,0.0,69.21972700000151,57.76224601154329,13303.219727,14325.919922,78.93224602347935,-21.06775397652065,148.36706583236628,132.56614302344218,0.035196259136365926,2737600.0
882,BSESN,2007-01-25,14282.719727000003,14307.19043,14115.400391,14151.620117,15600.0,172.25976599999925,0.0,172.25976599999925,66.25358919535643,13303.219727,14325.919922,95.7758690952439,-4.224130904756093,157.6331006519922,137.57953454915219,0.016091414424971973,2753200.0
883,BSESN,2007-01-29,14211.959961000002,14316.540038999998,14185.919922,14306.969727000003,12800.0,-70.75976599999922,70.75976599999922,0.0,60.48979904136399,13303.219727,14325.919922,88.85695323447192,-11.143046765528084,157.45177223258725,141.5539820858392,0.00582607306702676,2740400.0
884,BSESN,2007-01-31,14090.919922,14269.30957,14045.610352000003,14219.379883,25000.0,-121.04003900000315,121.04003900000315,0.0,51.625339806209226,13303.219727,14325.919922,77.0216138464704,-22.97838615352959,145.85976796972136,142.41513926261564,-0.0016869289181465907,2715400.0
885,BSESN,2007-02-01,14267.179688,14278.080078,14109.910156,14124.360352000003,14200.0,176.25976600000104,0.0,176.25976600000104,61.18322124037592,13303.219727,14325.919922,94.25635838467802,-5.743641615321976,149.17610188377512,143.76733178684754,0.009612665571670842,2729600.0
886,BSESN,2007-02-02,14403.769531,14462.769531,14293.110352000003,14293.110352000003,18400.0,136.58984299999977,0.0,136.58984299999977,67.01126149905883,13729.070313,14462.769531,91.95855760064337,-8.041442399356628,160.97041249012545,147.2079479275031,0.013083612456260552,2748000.0
887,BSESN,2007-02-05,14515.900391,14526.509766,14372.360352000003,14432.089844,11600.0,112.13085999999929,0.0,112.13085999999929,71.11872792782624,14025.740234,14526.509766,97.88138568302513,-2.118614316974866,177.32146048666618,153.23065043933573,0.02349271972114031,2759600.0
888,BSESN,2007-02-06,14478.19043,14564.799805,14452.780272999997,14541.240234,18600.0,-37.70996099999866,37.70996099999866,0.0,67.84095327119473,14025.740234,14564.799805,83.93324603450924,-16.066753965490772,185.10315122485008,159.60515059643862,0.018927837911871803,2741000.0
889,BSESN,2007-02-07,14643.129883,14663.259766,14478.450195,14493.55957,11400.0,164.93945300000087,0.0,164.93945300000087,73.90960416126987,14025.740234,14663.259766,96.84246803594408,-3.1575319640559116,202.24804305420002,168.13372908799093,0.04286584653274139,2752400.0
890,BSESN,2007-02-08,14652.089844,14697.69043,14523.160156,14690.580078,11600.0,8.959960999998657,0.0,8.959960999998657,74.21459890536562,14025.740234,14697.69043,93.21369555787726,-6.786304442122745,214.0905843329856,177.32510013698987,0.038384991311198435,2764000.0
891,BSESN,2007-02-09,14538.900391,14723.879883,14493.669922,14684.349609,12200.0,-113.18945300000088,113.18945300000088,0.0,63.40981847809141,14025.740234,14723.879883,73.50394118641431,-26.496058813585687,211.89979182681418,184.24003847495476,0.017936406293523666,2751800.0
892,BSESN,2007-02-12,14190.700195,14529.280272999997,14146.219727000003,14529.280272999997,21200.0,-348.20019599999983,348.20019599999983,0.0,41.80581455034667,14025.740234,14723.879883,23.628504875247238,-76.37149512475277,179.99189269717135,183.3904093193981,-0.0014959066911490737,2730600.0
893,BSESN,2007-02-13,14090.980469,14363.740234,13957.700195,14168.330078,24400.0,-99.71972599999935,99.71972599999935,0.0,37.575414052916656,13957.700195,14723.879883,17.39543296271783,-82.60456703728217,144.98678682982063,175.70968482148263,4.296880568244177e-06,2706200.0
894,BSESN,2007-02-14,14009.900391,14036.610352000003,13805.360352000003,13990.410156,22400.0,-81.08007800000088,81.08007800000088,0.0,34.31748765249337,13805.360352000003,14723.879883,22.26844744142917,-77.73155255857083,109.44093655962024,162.45593516911015,-0.018032947129445365,2683800.0
895,BSESN,2007-02-15,14355.549805,14372.959961000002,14107.089844,14107.089844,16200.0,345.6494140000013,0.0,345.6494140000013,53.95509744471827,13805.360352000003,14723.879883,59.89959216229224,-40.100407837707756,107.91760613642145,151.54826936257243,-0.0033477157417869385,2700000.0
896,BSESN,2007-02-19,14402.900391,14479.179688,14372.070313,14406.879883,12600.0,47.35058599999866,0.0,47.35058599999866,56.03289933804114,13805.360352000003,14723.879883,65.05469060080317,-34.94530939919683,109.2715380938971,143.09292310883737,-0.007784567057931957,2712600.0
897,BSESN,2007-02-20,14253.379883,14466.759766,14230.469727000003,14449.230469,13200.0,-149.52050799999782,149.52050799999782,0.0,48.12100340036776,13805.360352000003,14723.879883,48.77626614125836,-51.22373385874164,97.15948940993803,133.9062363690575,-0.015527530742666218,2699400.0
898,BSESN,2007-02-21,14188.490234,14312.879883,14157.719727000003,14199.070313,14600.0,-64.88964900000065,64.88964900000065,0.0,44.9432204652939,13805.360352000003,14723.879883,41.711675045481314,-58.288324954518686,81.3863796728183,123.40226502980966,-0.031047983090542353,2684800.0
899,BSESN,2007-02-22,14021.30957,14287.030272999997,13978.049805,14200.110352000003,16200.0,-167.18066400000134,167.18066400000134,0.0,37.56812563129509,13805.360352000003,14723.879883,23.510574431105592,-76.4894255688944,54.76470078848797,109.67475218154532,-0.04305053277149429,2668600.0
900,BSESN,2007-02-23,13632.530272999997,14071.269531,13568.080078,14071.269531,18200.0,-388.7792970000009,388.7792970000009,0.0,26.083179891729984,13568.080078,14723.879883,5.576242072475162,-94.42375792752485,2.2694278188446333,88.19368730900517,-0.06234103636620769,2650400.0
901,BSESN,2007-02-26,13649.519531,13723.400391,13383.879883,13684.950195,17400.0,16.989258000001428,0.0,16.989258000001428,27.205272071397857,13383.879883,14723.879883,19.82385432835823,-80.17614567164176,-37.52994128066166,63.0489615910718,-0.03813629042707001,2667800.0
902,BSESN,2007-02-27,13478.830078,13703.410156,13408.55957,13703.410156,15400.0,-170.68945299999902,170.68945299999902,0.0,23.134111223689374,13383.879883,14723.879883,7.085835447761288,-92.9141645522387,-81.9003441901823,34.05910043482098,-0.04344271091331953,2652400.0
903,BSESN,2007-02-28,12938.089844,13298.519531,12800.910156,13045.120117,35800.0,-540.7402340000008,540.7402340000008,0.0,14.95408206019188,12800.910156,14723.879883,7.133741424729158,-92.86625857527085,-158.8661161997461,-4.525942892092452,-0.07650379496548976,2616600.0
904,BSESN,2007-03-01,13159.549805,13193.129883,12861.349609,13013.740234,24200.0,221.45996100000045,0.0,221.45996100000045,27.130084823281777,12800.910156,14723.879883,18.65030135235201,-81.349698647648,-199.69017297989194,-43.558788909652364,-0.08331272687190538,2640800.0
905,BSESN,2007-03-02,12886.129883,13254.030273,12836.75,13139.099609,19600.0,-273.4199220000009,273.4199220000009,0.0,22.53413745348071,12800.910156,14529.280272999997,4.9306410798121805,-95.06935892018782,-251.2104371924852,-85.08911856621894,-0.105310074139497,2621200.0
906,BSESN,2007-03-05,12415.040039,12716.849609,12344.44043,12716.849609,27600.0,-471.08984400000014,471.08984400000014,0.0,16.857036515389822,12344.44043,14479.179688,3.3071771522177613,-96.69282284778224,-326.2923361716694,-133.32976208730906,-0.12897571376685102,2593600.0
907,BSESN,2007-03-06,12697.089844,12760.219727,12427.129883,12573.009766,21600.0,282.04980500000056,0.0,282.04980500000056,29.182330249354393,12344.44043,14479.179688,16.51955444574485,-83.48044555425516,-358.89905507363255,-178.44362068457377,-0.10511339581614854,2615200.0
908,BSESN,2007-03-07,12579.75,12902.179688,12390.459961,12792.900391,19800.0,-117.33984400000007,117.33984400000007,0.0,27.2436562769403,12344.44043,14479.179688,11.022871721601115,-88.9771282783989,-389.71605538629774,-220.6981076249186,-0.10281204924569676,2595400.0
909,BSESN,2007-03-08,13049.349609,13099.830078,12596.860352,12649.769531,20800.0,469.59960900000084,0.0,469.59960900000084,44.32358945416299,12344.44043,14479.179688,33.020856123684986,-66.97914387631502,-371.9582827721588,-250.95014265436666,-0.04277860766280628,2616200.0
910,BSESN,2007-03-09,12884.990234,13145.719727,12788.160156,13107.370117,25200.0,-164.359375,164.359375,0.0,40.48538394280049,12344.44043,14466.759766,25.469767665538555,-74.53023233446145,-366.9179463049895,-274.1437033844913,-0.05601144386537893,2591000.0
911,BSESN,2007-03-12,12902.629883,13056.860352,12844.990234,12916.669922,17200.0,17.639648999998826,0.0,17.639648999998826,41.116817905583424,12344.44043,14312.879883,28.356953125954202,-71.64304687404581,-357.3804121577177,-290.7910451391366,-0.04274853170977122,2608200.0
912,BSESN,2007-03-13,12982.980469,13026.849609,12817.620117,12924.5,15000.0,80.35058600000049,0.0,80.35058600000049,44.22692881885389,12344.44043,14287.030272999997,32.870553776492734,-67.12944622350726,-339.4255405134718,-300.51794421400365,0.003469648575737727,2623200.0
913,BSESN,2007-03-14,12529.620117,12694.360352,12504.099609,12694.360352,19200.0,-453.3603519999997,453.3603519999997,0.0,32.910265669657946,12344.44043,14071.269531,10.723683478160234,-89.27631652183977,-357.65573422224406,-311.94550221565174,-0.04786863512311468,2604000.0
914,BSESN,2007-03-15,12543.849609,12789.80957,12510.75,12655.94043,16200.0,14.229492000000393,0.0,14.229492000000393,33.52625827346536,12344.44043,13723.400391,14.460838939470877,-85.53916106052912,-366.72768452715536,-322.9019386779525,-0.026561914019782695,2620200.0
915,BSESN,2007-03-16,12430.400391,12638.780273,12316.099609,12570.519531,14800.0,-113.44921800000157,113.44921800000157,0.0,30.915006293117784,12316.099609,13703.410156,8.239019176144021,-91.76098082385597,-378.7061850962182,-334.06278796160564,0.0012372374113773787,2605400.0
916,BSESN,2007-03-19,12644.990234,12655.0,12426.660156,12484.639648,12000.0,214.5898430000016,0.0,214.5898430000016,40.95241084912257,12316.099609,13298.519531,33.47760134286042,-66.52239865713958,-366.6570321392592,-340.58163679713635,-0.004103271744951731,2617400.0
917,BSESN,2007-03-20,12705.94043,12798.799805,12674.769531,12746.94043,15600.0,60.95019599999978,0.0,60.95019599999978,43.63622023183631,12316.099609,13254.030273,41.56392748025135,-58.43607251974865,-348.17626097196444,-342.100561632102,0.010031235119934756,2633000.0
918,BSESN,2007-03-21,12945.879883,12964.94043,12664.330078,12735.910156,16000.0,239.93945299999905,0.0,239.93945299999905,53.28146359082453,12316.099609,13254.030273,67.1457175004995,-32.854282499500506,-310.5887344793882,-335.7981962015593,-0.007929109810088875,2649000.0
919,BSESN,2007-03-22,13308.030273,13326.240234,13071.80957,13071.80957,19000.0,362.1503900000007,0.0,362.1503900000007,64.00790008382404,12316.099609,13326.240234,98.19728456124606,-1.8027154387539335,-248.71085515353298,-318.380727991954,0.032832003076239236,2668000.0
920,BSESN,2007-03-23,13285.929688,13386.950195,13196.900391,13343.570313,16400.0,-22.100585000000137,22.100585000000137,0.0,62.989549173081826,12316.099609,13386.950195,90.56633032463043,-9.433669675369575,-199.15973305887383,-294.53652900533797,0.029707106882529644,2651600.0
921,BSESN,2007-03-26,13124.320313,13345.730469,13090.799805,13345.730469,12200.0,-161.609375,161.609375,0.0,55.534697979925504,12316.099609,13386.950195,75.47464740333069,-24.525352596669318,-170.95991822050928,-269.82120684837224,0.01088654830356428,2639400.0
922,BSESN,2007-03-28,12884.339844,13035.55957,12861.179688,13034.269531,13200.0,-239.98046900000008,239.98046900000008,0.0,46.17190311390748,12316.099609,13386.950195,53.06438100973314,-46.93561899026687,-166.0615261366529,-249.06927070602836,0.0283104933499716,2626200.0
923,BSESN,2007-03-29,12979.660156,13004.400391,12832.69043,12862.530273,15600.0,95.32031199999984,0.0,95.32031199999984,50.03276178231333,12316.099609,13386.950195,61.96574533134728,-38.03425466865272,-152.72741598392895,-229.80089976160852,0.03474296652020703,2641800.0
924,BSESN,2007-03-30,13072.099609,13111.870117,12984.129883,13018.209961,13600.0,92.43945300000088,0.0,92.43945300000088,53.74513882953149,12316.099609,13386.950195,70.59808435310516,-29.40191564689484,-133.16589279322943,-210.47389836793272,0.05162337477597356,2655400.0
925,BSESN,2007-04-02,12455.370117,12811.929688,12425.519531,12811.929688,15800.0,-616.7294920000004,616.7294920000004,0.0,34.190281084547394,12316.099609,13386.950195,13.005596655666377,-86.99440334433362,-165.52014728720678,-201.48314815178756,-0.014995671288867252,2639600.0
926,BSESN,2007-04-03,12624.580078,12657.75,12481.860352,12503.75,12200.0,169.20996100000048,0.0,169.20996100000048,40.98760306077031,12316.099609,13386.950195,28.80705049172943,-71.19294950827057,-175.48442218377204,-196.28340295818447,-0.006403331768178311,2651800.0
927,BSESN,2007-04-04,12786.769531,12835.360352,12691.240234,12691.240234,18800.0,162.18945299999902,0.0,162.18945299999902,47.03766124738618,12316.099609,13386.950195,43.95290324844625,-56.04709675155375,-168.35317780719197,-190.697357927986,-0.012290423937034722,2670600.0
928,BSESN,2007-04-05,12856.080078,12899.30957,12711.5,12791.599609,15800.0,69.31054700000095,0.0,69.31054700000095,49.58619504455012,12316.099609,13386.950195,50.42537923213134,-49.57462076786866,-155.31841931491545,-183.6215702053719,-0.033960712872508125,2686400.0
929,BSESN,2007-04-09,13177.740234,13194.0,12904.849609,12904.849609,13800.0,321.66015599999986,0.0,321.66015599999986,59.91501706973497,12425.519531,13386.950195,78.23972452370224,-21.760275476297764,-117.67649159231041,-170.43255448275963,-0.008143160210889677,2700200.0
930,BSESN,2007-04-10,13189.540039,13236.200195,13075.480469,13236.200195,15400.0,11.799804999998742,0.0,11.799804999998742,60.25965133842997,12425.519531,13386.950195,79.46704183755887,-20.532958162441137,-85.90261515331622,-153.52656661687095,0.004969379323620959,2715600.0
931,BSESN,2007-04-11,13183.240234,13294.900391,13161.209961,13221.759766,16000.0,-6.2998049999987416,6.2998049999987416,0.0,59.94217640052334,12425.519531,13386.950195,78.81178865749192,-21.188211342508083,-60.53215378198911,-134.9276840498946,0.023198735334444942,2699600.0
932,BSESN,2007-04-12,13113.80957,13160.150391,13030.870117,13127.860352,12200.0,-69.43066400000134,69.43066400000134,0.0,56.17839592098538,12425.519531,13386.950195,71.5901899921095,-28.409810007890506,-45.50381503486096,-117.04291024688787,0.010335356425952957,2687400.0
933,BSESN,2007-04-13,13384.080078,13421.049805,13119.879883,13163.019531,18400.0,270.2705080000014,0.0,270.2705080000014,65.81843798927451,12425.519531,13421.049805,96.28642865360018,-3.7135713463998252,-11.650873041695377,-95.96450280584938,0.023866133087389052,2705800.0
934,BSESN,2007-04-16,13695.580078,13708.400391,13479.490234,13479.490234,14200.0,311.5,0.0,311.5,73.55491067378955,12425.519531,13708.400391,99.00066222829153,-0.9993377717084622,39.85386354032016,-68.80082953661547,0.09957230891977042,2720000.0
935,BSESN,2007-04-17,13607.040038999998,13755.759766,13581.040038999998,13733.179688,14200.0,-88.54003900000315,88.54003900000315,0.0,68.47220491029974,12425.519531,13755.759766,88.82008504275909,-11.179914957240907,72.68937924941565,-40.50278777940923,0.07782119919474106,2705800.0
936,BSESN,2007-04-18,13672.19043,13762.919922,13602.900391,13602.900391,14200.0,65.15039100000286,0.0,65.15039100000286,70.21940214330354,12425.519531,13762.919922,93.21598134630733,-6.784018653692664,102.7840238391691,-11.84542545569356,0.06924508155507159,2720000.0
937,BSESN,2007-04-19,13619.700195,13658.110352000003,13423.639647999997,13538.709961000002,15800.0,-52.490235000001114,52.490235000001114,0.0,66.77908713992522,12425.519531,13762.919922,89.29118549958613,-10.708814500413869,121.00386596687531,14.724432828820222,0.05939758560673125,2704200.0
938,BSESN,2007-04-20,13897.410156,13915.620117,13684.950195,13684.950195,21200.0,277.7099610000005,0.0,277.7099610000005,74.42755142327401,12425.519531,13915.620117,98.77793746468599,-1.2220625353140067,156.0532107795607,42.99018841896832,0.05461254427699003,2725400.0
939,BSESN,2007-04-23,13928.330078,14046.519531,13879.389647999997,13972.80957,42800.0,30.91992200000095,0.0,30.91992200000095,75.16218521987844,12481.860352,14046.519531,92.44631325554643,-7.553686744453568,184.20168598289092,71.23248793175286,0.056013328502395154,2768200.0
940,BSESN,2007-04-24,14136.719727000003,14197.320313,13850.070313,13893.719727000003,22000.0,208.38964900000062,0.0,208.38964900000062,79.69772479558014,12691.240234,14197.320313,95.976270661502,-4.023729338498001,220.77984583754915,101.14195951291212,0.07232512463369578,2790200.0
941,BSESN,2007-04-25,14217.769531,14238.290038999998,14052.169922,14141.700195,18000.0,81.0498039999984,0.0,81.0498039999984,81.23544584472239,12711.5,14238.290038999998,98.6559705345315,-1.3440294654684881,253.38745007880607,131.59105762609093,0.0841830099108265,2808200.0
942,BSESN,2007-04-26,14228.879883,14383.719727000003,14127.179688,14273.169922,16800.0,11.110352000001512,0.0,11.110352000001512,81.45758388091397,12904.849609,14383.719727000003,89.52985511605263,-10.470144883947372,276.93340797632663,160.65952769613807,0.06311975123255831,2825000.0
943,BSESN,2007-04-27,13908.580078,14219.25,13884.530272999997,14219.25,19800.0,-320.29980500000056,320.29980500000056,0.0,58.443349230433405,13030.870117,14383.719727000003,64.87860546450528,-35.1213945354947,266.67417791910157,181.86245774073078,0.015552462822816304,2805200.0
944,BSESN,2007-04-30,13872.370117,13901.120117,13693.589844,13823.400391,15400.0,-36.209961000002295,36.209961000002295,0.0,56.366036883050256,13030.870117,14383.719727000003,62.202035893701314,-37.79796410629869,252.708753744133,196.03171694141125,0.019499470659270823,2789800.0
945,BSESN,2007-05-03,14078.209961000002,14107.05957,13987.769531,13987.769531,14200.0,205.8398440000037,0.0,205.8398440000037,64.61555203580627,13030.870117,14383.719727000003,77.41731499630617,-22.582685003693822,255.30758271537707,207.88689009620447,0.0296967434061699,2804000.0
946,BSESN,2007-05-04,13934.269531,14189.209961000002,13912.919922,14129.889647999997,13200.0,-143.94043000000238,143.94043000000238,0.0,56.06324550674667,13119.879883,14383.719727000003,64.43772538635028,-35.562274613649706,242.95178669324378,214.89986941561236,0.02309664173925685,2790800.0
947,BSESN,2007-05-07,13879.25,14067.070313,13861.379883,14044.709961000002,11600.0,-55.01953099999992,55.01953099999992,0.0,52.97105113520334,13423.639647999997,14383.719727000003,47.45545314038332,-52.54454685961668,226.11361597854193,217.14261872819827,-0.001306729512632221,2779200.0
948,BSESN,2007-05-08,13765.459961000002,13956.400391,13741.240234,13886.0,12800.0,-113.7900389999977,113.7900389999977,0.0,46.80990413919711,13423.639647999997,14383.719727000003,35.60331273158343,-64.39668726841657,201.2672555726822,213.96754609709504,-0.011693441790071701,2766400.0
949,BSESN,2007-05-09,13781.509766,13806.370117,13612.040038999998,13707.860352000003,12400.0,16.049804999996926,0.0,16.049804999996926,47.79805462424071,13423.639647999997,14383.719727000003,37.275027971911506,-62.7249720280885,180.78741627381714,207.33152013243946,-0.02512675980422685,2778800.0
950,BSESN,2007-05-10,13771.230469,13976.790038999998,13745.230469,13823.360352000003,13600.0,-10.279296999999133,10.279296999999133,0.0,47.150729751425246,13423.639647999997,14383.719727000003,36.20435717841835,-63.79564282158165,161.8617017772831,198.23755646140822,-0.031407110730440446,2765200.0
951,BSESN,2007-05-11,13796.160156,13864.179688,13562.950195,13691.860352000003,16000.0,24.929686999999827,0.0,24.929686999999827,49.08046538937684,13562.950195,14383.719727000003,28.41357432356534,-71.58642567643466,147.17797796629748,188.0256407623861,-0.03041136973241254,2781200.0
952,BSESN,2007-05-14,13965.860352000003,14026.019531,13924.019531,13954.410156,11200.0,169.7001960000016,0.0,169.7001960000016,60.42919264074994,13562.950195,14383.719727000003,49.0893169509126,-50.9106830490874,147.53373160764568,179.92725893143805,0.0041183408858971315,2792400.0
953,BSESN,2007-05-15,13929.330078,14023.860352000003,13885.459961000002,13948.910156,11200.0,-36.530274000000645,36.530274000000645,0.0,57.259419602694734,13562.950195,14383.719727000003,44.638582295718024,-55.361417704281976,143.21706395220644,172.58521993559174,0.0041060006703683705,2781200.0
954,BSESN,2007-05-16,14127.30957,14159.360352000003,13936.879883,13949.80957,19800.0,197.97949199999854,0.0,197.97949199999854,67.81624376401615,13562.950195,14383.719727000003,68.75978615151584,-31.240213848484167,153.99619191501006,168.86741433147543,0.0034876315338394637,2801000.0
955,BSESN,2007-05-17,14299.709961000002,14352.980469,14217.360352000003,14217.360352000003,17600.0,172.40039100000286,0.0,172.40039100000286,74.21535874188838,13562.950195,14383.719727000003,89.76451211641702,-10.23548788358297,174.4391730264415,169.98176607046867,0.026226019899141084,2818600.0
956,BSESN,2007-05-18,14303.410156,14337.05957,14201.009766,14261.469727000003,12400.0,3.700194999997621,0.0,3.700194999997621,74.34170003965096,13562.950195,14352.980469,93.72551728315159,-6.274482716848409,188.76301511629026,173.738015879633,0.03056074038582768,2831000.0
957,BSESN,2007-05-21,14418.599609,14451.299805,14384.610352000003,14414.830078,30800.0,115.18945300000088,0.0,115.18945300000088,78.18177473593309,13562.950195,14451.299805,96.3189947255113,-3.6810052744886934,207.02315528222425,180.39504376015125,0.04744771695609584,2861800.0
958,BSESN,2007-05-22,14453.719727000003,14483.589844,14348.259766,14458.480469,17000.0,35.12011800000073,0.0,35.12011800000073,79.27305964400047,13562.950195,14483.589844,96.75550395505542,-3.244496044944588,221.77189952297522,188.67041491271607,0.048776220632836376,2878800.0
959,BSESN,2007-05-23,14363.259766,14500.639647999997,14325.889647999997,14490.030272999997,18000.0,-90.4599610000023,90.4599610000023,0.0,69.01406767778454,13562.950195,14500.639647999997,85.34910661941744,-14.650893380582563,223.5836891529325,195.65306976075937,0.042990297659508236,2860800.0
960,BSESN,2007-05-24,14218.110352000003,14389.660156,14174.049805,14344.700195,13600.0,-145.1494139999977,145.1494139999977,0.0,55.674489168400996,13562.950195,14500.639647999997,69.86963060146586,-30.13036939853414,210.87634955073008,198.69772571875353,0.030584611314220966,2847200.0
961,BSESN,2007-05-25,14338.450195,14364.950195,14046.05957,14073.610352000003,14000.0,120.33984299999793,0.0,120.33984299999793,62.5914782379467,13562.950195,14500.639647999997,82.70328705510163,-17.296712944898367,208.1170669729254,200.58159396958794,0.026678617257306136,2861200.0
962,BSESN,2007-05-28,14397.889647999997,14527.469727000003,14368.400391,14467.849609,12000.0,59.43945299999905,0.0,59.43945299999905,65.64671507551456,13562.950195,14527.469727000003,86.56532348999583,-13.434676510004168,208.32514021284805,202.13030321824,0.03363834207217464,2873200.0
963,BSESN,2007-05-29,14508.209961000002,14530.150391,14372.070313,14418.980469,11000.0,110.3203130000038,0.0,110.3203130000038,70.76080474172288,13562.950195,14530.150391,97.73155236209269,-2.2684476379073155,214.9145656946912,204.68715571353025,0.026961990824414528,2884200.0
964,BSESN,2007-05-30,14411.379883,14576.370117,14379.209961000002,14501.459961000002,15000.0,-96.83007800000088,96.83007800000088,0.0,61.4901886742976,13562.950195,14576.370117,83.71946017457503,-16.280539825424967,209.90371544035588,205.73046765889538,0.007809243845124048,2869200.0
965,BSESN,2007-05-31,14544.459961000002,14573.80957,14448.570313,14451.30957,12400.0,133.08007800000087,0.0,133.08007800000087,68.11473996778618,13885.459961000002,14576.370117,95.38143190936128,-4.618568090638718,214.20184507652448,207.42474314242125,0.01685261083692602,2881600.0
966,BSESN,2007-06-01,14570.75,14682.099609,14539.889647999997,14610.280272999997,13800.0,26.2900389999977,0.0,26.2900389999977,69.31782762740586,13885.459961000002,14682.099609,86.02258759282829,-13.977412407171705,217.22548998148523,209.3848925102341,0.010552369517565996,2895400.0
967,BSESN,2007-06-04,14495.769531,14683.360352000003,14465.679688,14618.780272999997,15200.0,-74.98046900000007,74.98046900000007,0.0,61.66141039246485,13936.879883,14683.360352000003,74.869962605813,-25.130037394187,211.13759042860147,209.73543209390763,0.0029092721316192893,2880200.0
968,BSESN,2007-06-05,14535.009766,14571.30957,14432.669922,14514.200195,10800.0,39.2402349999993,0.0,39.2402349999993,64.05862383338872,14046.05957,14683.360352000003,76.72204550974438,-23.277954490255624,207.09201732672955,209.20674914047203,0.011957591994998129,2891000.0
969,BSESN,2007-06-06,14255.929688,14590.820313,14234.070313,14551.530272999997,22800.0,-279.08007799999905,279.08007799999905,0.0,42.335561808892706,14046.05957,14683.360352000003,32.931093751584235,-67.06890624841577,179.2995875366396,203.22531681970557,0.002659941093696494,2868200.0
970,BSESN,2007-06-07,14186.179688,14362.580078,14139.089844,14195.839844,17000.0,-69.75,69.75,0.0,38.56425657091578,14046.05957,14683.360352000003,21.986497107420757,-78.01350289257924,149.91748912518233,192.56375128080094,-0.010619732602139775,2851200.0
971,BSESN,2007-06-08,14063.80957,14229.219727000003,14010.610352000003,14063.94043,18600.0,-122.37011800000073,122.37011800000073,0.0,32.67246549226854,14010.610352000003,14683.360352000003,7.907724712002394,-92.09227528799761,115.4271463227542,177.13643028919162,-0.023203405927368248,2832600.0
972,BSESN,2007-06-11,14083.410156,14268.910156,14057.629883,14170.80957,12000.0,19.600586000000483,0.0,19.600586000000483,34.521324710741055,14010.610352000003,14683.360352000003,10.821226904495962,-89.17877309550404,88.65296840834344,159.439737913022,-0.02927995983942333,2844600.0
973,BSESN,2007-06-12,14130.950195,14153.44043,13946.990234,14122.330078,13600.0,47.540038999999524,0.0,47.540038999999524,39.1943032433993,13946.990234,14683.360352000003,24.981997028836254,-75.01800297116374,70.45812593513074,141.64341551744374,-0.019458906105917162,2858200.0
974,BSESN,2007-06-13,14003.030272999997,14152.790038999998,13968.379883,14139.919922,13000.0,-127.91992200000095,127.91992200000095,0.0,32.08506077405238,13946.990234,14683.360352000003,7.610308679037909,-92.38969132096209,45.195527644893446,122.35383794293368,-0.03722583646638056,2845200.0
975,BSESN,2007-06-14,14203.719727000003,14219.240234,14087.910156,14087.910156,11800.0,200.68945400000302,0.0,200.68945400000302,48.87263835229454,13946.990234,14683.360352000003,34.86419216701589,-65.13580783298411,40.89726004262775,106.0625223628725,-0.025189525110237754,2857000.0
976,BSESN,2007-06-15,14162.709961000002,14326.549805,14112.530272999997,14277.610352000003,13000.0,-41.00976599999922,41.00976599999922,0.0,46.18111719645813,13946.990234,14683.360352000003,29.295013706680688,-70.70498629331931,33.792171499057076,91.60845219010942,-0.022976329010179986,2844000.0
977,BSESN,2007-06-18,14080.139647999997,14283.709961000002,14057.259766,14241.759766,9400.0,-82.57031300000382,82.57031300000382,0.0,40.94277533403838,13946.990234,14683.360352000003,18.081860024634437,-81.91813997536556,21.25360511877807,77.53748277584316,-0.031294792733062016,2834600.0
978,BSESN,2007-06-19,14295.5,14315.179688,14058.790038999998,14088.580078,9400.0,215.36035200000148,0.0,215.36035200000148,55.97229700917824,13946.990234,14683.360352000003,47.32807014854967,-52.67192985145033,28.367478853675493,67.70348199140963,0.0027757089762661113,2844000.0
979,BSESN,2007-06-20,14411.950195,14449.379883,14347.580078,14359.959961000002,11200.0,116.45019499999945,0.0,116.45019499999945,62.00510794072243,13946.990234,14683.360352000003,63.142154961806455,-36.857845038193545,42.907224784390564,62.74423055000582,0.015914820759741044,2855200.0
980,BSESN,2007-06-21,14499.240234,14526.44043,14406.669922,14415.55957,13800.0,87.29003900000133,0.0,87.29003900000133,66.03088974377292,13946.990234,14683.360352000003,74.99625344655799,-25.00374655344202,60.77310035079972,62.3500045101646,0.03096107507946022,2869000.0
981,BSESN,2007-06-22,14467.360352000003,14560.320313,14441.759766,14508.629883,18600.0,-31.87988199999927,31.87988199999927,0.0,63.2086030131087,13946.990234,14590.820313,80.82413900391924,-19.17586099608076,71.53488577347707,64.1869807628271,0.02726258709694873,2850400.0
982,BSESN,2007-06-25,14487.719727000003,14521.620117,14424.709961000002,14469.429688,16200.0,20.359375,0.0,20.359375,64.33198779017351,13946.990234,14590.820313,83.98636699917262,-16.013633000827372,80.77538135222858,67.5046608807074,0.025247384434646136,2866600.0
983,BSESN,2007-06-26,14501.080078,14560.480469,14478.75,14478.75,12400.0,13.360350999999357,0.0,13.360350999999357,65.13798960014266,13946.990234,14560.480469,90.31763056505712,-9.682369434942887,88.1603516848445,71.63579904153482,0.03556728760062189,2879000.0
984,BSESN,2007-06-27,14431.05957,14520.19043,14407.120117,14520.19043,10400.0,-70.02050800000143,70.02050800000143,0.0,57.306945537231435,13946.990234,14560.480469,78.90416316080389,-21.09583683919611,87.35593917979895,74.77982706918765,0.016005655375460837,2868600.0
985,BSESN,2007-06-28,14504.570313,14537.040038999998,14435.240234,14498.049805,16000.0,73.51074300000073,0.0,73.51074300000073,62.73408048513356,13946.990234,14560.480469,90.88654508086832,-9.113454919131676,91.59429703847127,78.14272106304438,0.024138060649507187,2884600.0
986,BSESN,2007-06-29,14650.509766,14663.25,14574.450195,14589.519531,10800.0,145.93945299999902,0.0,145.93945299999902,71.13841573877875,13946.990234,14663.25,98.22128303099454,-1.7787169690054596,105.51303181619369,83.61678321367424,0.040508839561191445,2895400.0
987,BSESN,2007-07-02,14664.259766,14745.969727000003,14638.879883,14685.160156,9200.0,13.75,0.0,13.75,71.8290853769995,13968.379883,14745.969727000003,89.49189452119391,-10.508105478806089,116.3124618350248,90.15591893794436,0.025795513693120053,2904600.0
988,BSESN,2007-07-03,14806.509766,14828.389647999997,14720.0,14720.0,9200.0,142.25,0.0,142.25,78.08834385181012,14057.259766,14828.389647999997,97.16262039499107,-2.8373796050089424,134.7956339371285,99.08386193778121,0.027377250522062413,2913800.0
989,BSESN,2007-07-04,14880.240234,14906.929688,14790.75,14868.139647999997,14800.0,73.73046800000157,0.0,73.73046800000157,80.65847494409608,14057.259766,14906.929688,96.85884443959412,-3.1411555604058865,153.62225187539116,109.99153992530323,0.026277238934670155,2928600.0
990,BSESN,2007-07-05,14861.889647999997,14963.259766,14731.219727000003,14932.530272999997,18800.0,-18.350586000002295,18.350586000002295,0.0,78.03006621699319,14057.259766,14963.259766,88.81124525386286,-11.188754746137148,165.15790577146254,121.0248130945351,0.027270302695228787,2909800.0
991,BSESN,2007-07-06,14964.120117,15007.219727000003,14826.55957,14843.429688,20000.0,102.23046900000007,0.0,102.23046900000007,81.83506893148869,14058.790038999998,15007.219727000003,95.45568738038041,-4.544312619619588,180.4688069974818,132.91361187512445,0.03288304846981238,2929800.0
992,BSESN,2007-07-09,15045.730469,15085.219727000003,15005.469727000003,15018.709961000002,14200.0,81.61035200000151,0.0,81.61035200000151,84.33421276297442,14347.580078,15085.219727000003,94.64653804150336,-5.353461958496637,196.91813026006093,145.71451555211175,0.037559298208848846,2944000.0
993,BSESN,2007-07-10,15009.879883,15114.950195,14966.400391,15100.129883,12600.0,-35.85058599999866,35.85058599999866,0.0,78.83647986523266,14406.669922,15114.950195,85.16543295001529,-14.834567049984715,204.701819628066,157.51197636730262,0.04010934264336896,2931400.0
994,BSESN,2007-07-11,14910.620117,15015.349609,14829.549805,14948.150391,14600.0,-99.25976600000286,99.25976600000286,0.0,65.24797242703067,14407.120117,15114.950195,71.13289130389295,-28.867108696107053,200.54920951321765,166.11942299648564,0.027994611025193183,2916800.0
995,BSESN,2007-07-12,15092.040038999998,15112.219727000003,14963.530272999997,14963.530272999997,19800.0,181.41992199999916,0.0,181.41992199999916,74.51262717111085,14407.120117,15114.950195,96.76332544885133,-3.2366745511486674,209.48252346297704,174.79204308978393,0.030137536512529817,2936600.0
996,BSESN,2007-07-13,15272.719727000003,15330.730469,15216.830078,15216.830078,24000.0,180.6796880000038,0.0,180.6796880000038,80.48966580259653,14407.120117,15330.730469,93.71913254605913,-6.2808674539408775,228.50748786847907,185.53513204552297,0.04149271567125101,2960600.0
997,BSESN,2007-07-16,15311.219727000003,15341.379883,15239.410156,15295.030272999997,20000.0,38.5,0.0,38.5,81.55326917540366,14407.120117,15341.379883,96.77175908696937,-3.228240913030638,243.8802378970795,197.2041532158343,0.034087031243444255,2980600.0
998,BSESN,2007-07-17,15289.820313,15440.200195,15272.459961000002,15357.599609,15800.0,-21.399414000001343,21.399414000001343,0.0,78.79827450582654,14435.240234,15440.200195,85.03623150813274,-14.963768491867258,251.4380775388945,208.05093808044637,0.027525098557491523,2964800.0
999,BSESN,2007-07-18,15301.169922,15325.780272999997,15160.269531,15296.05957,13000.0,11.349608999998965,0.0,11.349608999998965,79.22770297992867,14574.450195,15440.200195,83.9410600057753,-16.058939994224698,255.39945259115484,217.5206409825881,0.02955749803048202,2977800.0
1000,BSESN,2007-07-19,15550.129883,15593.30957,15357.379883,15357.379883,18600.0,248.95996100000232,0.0,248.95996100000232,86.26756017094489,14638.879883,15593.30957,95.47586505447836,-4.524134945521642,275.4526128105499,229.1070353481805,0.039160990517194794,2996400.0
1001,BSESN,2007-07-20,15565.549805,15683.030272999997,15524.679688,15625.629883,18000.0,15.419921999999133,0.0,15.419921999999133,86.59229899832268,14720.0,15683.030272999997,87.80095794558719,-12.199042054412812,289.2547963578181,241.136587550108,0.034549292044744995,3014400.0
1002,BSESN,2007-07-23,15732.200195,15773.370117,15477.910156,15560.570313,13400.0,166.65038999999888,0.0,166.65038999999888,89.6456754457987,14731.219727000003,15773.370117,96.04952198885603,-3.9504780111439644,310.0661701756726,254.92250407522096,0.048122990832064616,3027800.0
1003,BSESN,2007-07-24,15794.919922,15868.849609,15742.320313,15802.19043,22200.0,62.719726999999686,0.0,62.719726999999686,90.57750734640214,14731.219727000003,15868.849609,93.50142887684785,-6.498571123152145,327.84114303951173,269.50623186807917,0.059306708779454764,3050000.0
1004,BSESN,2007-07-25,15699.330078,15771.259766,15572.980469,15711.870117,25200.0,-95.58984399999828,95.58984399999828,0.0,78.2013566706643,14826.55957,15868.849609,83.7358580954452,-16.264141904554812,330.405921767142,281.68616984789173,0.040239095405967484,3024800.0
1005,BSESN,2007-07-26,15776.30957,15812.269531,15654.400391,15768.280272999997,17000.0,76.97949199999856,0.0,76.97949199999856,80.6571754219078,14829.549805,15868.849609,91.09592452112102,-8.904075478878983,334.7908683170808,292.3071095417296,0.03297316077304302,3041800.0
1006,BSESN,2007-07-27,15234.570313,15495.509766,15159.679688,15487.759766,30200.0,-541.7392569999993,541.7392569999993,0.0,42.1228497137404,14829.549805,15868.849609,38.97051711557905,-61.02948288442095,291.1954199751017,292.084771628404,-0.0050060945742185226,3011600.0
1007,BSESN,2007-07-30,15260.910156,15451.80957,15135.25,15278.030272999997,20400.0,26.339842999999746,0.0,26.339842999999746,43.6336106675765,14829.549805,15868.849609,41.504900639815695,-58.49509936018431,255.82215966186777,284.83224923509675,-0.001890810775285523,3032000.0
1008,BSESN,2007-07-31,15550.990234,15568.849609,15224.820313,15358.69043,18200.0,290.08007800000087,0.0,290.08007800000087,57.673255156288654,14963.530272999997,15868.849609,64.88980602088913,-35.110193979110875,248.33300569951462,277.5324005279803,0.01632687652470355,3050200.0
1009,BSESN,2007-08-01,14935.769531,15344.019531,14910.519531,15344.019531,22800.0,-615.2207030000009,615.2207030000009,0.0,35.832303190950185,14910.519531,15868.849609,2.6347915587389066,-97.3652084412611,190.55799417118033,260.1375192566203,-0.03950837431085652,3027400.0
1010,BSESN,2007-08-02,14985.700195,15134.530272999997,14896.469727000003,15022.870117,14400.0,49.930663999999524,0.0,49.930663999999524,38.029976173917994,14896.469727000003,15868.849609,9.176502892724013,-90.82349710727598,147.10414358719936,237.5308441227361,-0.03725211234194503,3041800.0
1011,BSESN,2007-08-03,15138.400391,15235.509766,15061.129883,15061.129883,11400.0,152.70019599999978,0.0,152.70019599999978,44.71185775932753,14896.469727000003,15868.849609,24.88026217720499,-75.119737822795,123.56391567568062,214.73745843332503,-0.037744231362420666,3053200.0
1012,BSESN,2007-08-06,14903.030272999997,14928.799805,14705.580078,14892.599609,15600.0,-235.37011800000076,235.37011800000076,0.0,37.5172413175294,14705.580078,15868.849609,16.97372704589439,-83.02627295410561,84.9366175492687,188.77729025651377,-0.05646686741081419,3037600.0
1013,BSESN,2007-08-07,14932.769531,15142.040038999998,14901.830078,15038.030272999997,14000.0,29.73925800000143,0.0,29.73925800000143,38.949433630500856,14705.580078,15868.849609,19.530250466089022,-80.46974953391098,56.07748868613271,162.23732994243755,-0.04882759603062348,3051600.0
1014,BSESN,2007-08-08,15307.980469,15340.240234,15088.070313,15088.070313,17200.0,375.21093800000017,0.0,375.21093800000017,54.22408864854566,14705.580078,15868.849609,51.78510869120316,-48.21489130879684,62.759357267026644,142.34173540735537,-0.02968559275044702,3068800.0
1015,BSESN,2007-08-09,15100.150391,15542.400391,15062.099609,15452.44043,16400.0,-207.83007800000087,207.83007800000087,0.0,46.74872534846909,14705.580078,15868.849609,33.919079154493765,-66.08092084550623,50.700195576648184,124.01342744121393,-0.008823348426525546,3052400.0
1016,BSESN,2007-08-10,14868.25,14901.30957,14570.889647999997,14674.919922,16400.0,-231.9003909999992,231.9003909999992,0.0,39.701916358937325,14570.889647999997,15868.849609,22.90982471993236,-77.09017528006764,22.175177926617835,103.64577753829471,-0.02572979933609143,3036000.0
1017,BSESN,2007-08-13,15017.209961000002,15044.740234,14869.150391,14965.650391,9400.0,148.9599610000023,0.0,148.9599610000023,45.76154502482907,14570.889647999997,15812.269531,35.95356418386591,-64.04643581613409,11.456654685975082,85.20795296783079,-0.03432451985166607,3045400.0
1018,BSESN,2007-08-14,15000.910156,15069.639647999997,14964.660156,15066.709961000002,9600.0,-16.299805000002383,16.299805000002383,0.0,45.18818401572018,14570.889647999997,15812.269531,34.64052494235579,-65.35947505764422,1.628121780220681,68.49198673030877,0.004361383915626016,3035800.0
1019,BSESN,2007-08-16,14358.209961000002,14584.919922,14345.030272999997,14584.919922,21800.0,-642.7001949999976,642.7001949999976,0.0,28.781643963869882,14345.030272999997,15568.849609,1.076930851826775,-98.92306914817323,-57.36038105796615,43.32151317265377,-0.0418726002679114,3014000.0
1020,BSESN,2007-08-17,14141.519531,14318.55957,13779.879883,14309.370117,32400.0,-216.6904300000024,216.6904300000024,0.0,25.219526408848452,13779.879883,15568.849609,20.214967461109516,-79.78503253889049,-120.20861124676958,10.615488288769095,-0.06585113580379731,2981600.0
1021,BSESN,2007-08-20,14427.549805,14680.089844,14406.910156,14512.280272999997,12400.0,286.0302740000006,0.0,286.0302740000006,37.07998878094487,13779.879883,15568.849609,36.20351493863125,-63.79648506136875,-145.26154909557954,-20.55991918810064,-0.03190495216677036,2994000.0
1022,BSESN,2007-08-21,13989.110352000003,14534.509766,13941.929688,14512.19043,15800.0,-438.43945299999916,438.43945299999916,0.0,28.95704888246125,13779.879883,15542.400391,11.87109415466749,-88.12890584533251,-198.20974395609846,-56.089884141700225,-0.06319384873924339,2978200.0
1023,BSESN,2007-08-22,14248.660156,14281.480469,13870.700195,14055.400391,19400.0,259.5498039999984,0.0,259.5498039999984,38.20389690195371,13779.879883,15542.400391,26.59715282019291,-73.40284717980708,-216.72974423762935,-88.21785616088606,-0.06920052681966882,2997600.0
1024,BSESN,2007-08-23,14163.980469,14554.929688,14128.719727000003,14458.330078,17800.0,-84.67968699999983,84.67968699999983,0.0,36.41941504195446,13779.879883,15542.400391,21.79268747549805,-78.20731252450194,-235.5249360794278,-117.6792721445944,-0.061997390605988634,2979800.0
1025,BSESN,2007-08-24,14424.870117,14455.490234,14163.610352000003,14237.259766,10400.0,260.8896479999985,0.0,260.8896479999985,45.47337554394521,13779.879883,15542.400391,36.594764774220764,-63.405235225779236,-226.7547590656868,-139.4943695288129,-0.029820582987237887,2990200.0
1026,BSESN,2007-08-27,14842.379883,14858.929688,14581.349609,14581.349609,11600.0,417.5097660000029,0.0,417.5097660000029,56.825954264975,13779.879883,15542.400391,60.28298650582285,-39.71701349417715,-183.99381558123423,-148.3942587392972,-0.011641981330356321,3001800.0
1027,BSESN,2007-08-28,14919.19043,14952.040038999998,14751.679688,14841.610352000003,14200.0,76.81054699999912,0.0,76.81054699999912,58.653332898517796,13779.879883,15542.400391,64.6409810171696,-35.3590189828304,-142.26751918081027,-147.1689108275998,-0.00544765118583912,3016000.0
1028,BSESN,2007-08-29,14993.040038999998,15029.530272999997,14592.110352000003,14651.490234,17400.0,73.84960899999714,0.0,73.84960899999714,60.507690856880586,13779.879883,15542.400391,68.83098100098806,-31.169018999011932,-102.06355724679452,-138.14784011143874,0.044213734144042505,3033400.0
1029,BSESN,2007-08-30,15121.740234,15200.80957,15053.980469,15168.69043,18400.0,128.70019500000308,0.0,128.70019500000308,63.77465595838188,13779.879883,15200.80957,94.43538010899489,-5.564619891005111,-59.13492698798473,-122.34525748674794,0.06931509028087346,3051800.0
1030,BSESN,2007-08-31,15318.599609,15350.910156,15131.360352000003,15131.360352000003,14400.0,196.859375,0.0,196.859375,68.38978845088681,13779.879883,15350.910156,97.9433529986472,-2.056647001352795,-9.123600694183551,-99.70092612823507,0.06176029998463073,3066200.0
1031,BSESN,2007-09-03,15422.049805,15427.160156,15323.049805,15401.990234,15000.0,103.45019599999979,0.0,103.45019599999979,70.65655055218262,13779.879883,15427.160156,99.68977040010972,-0.31022959989027643,38.415472301747286,-72.0776464422386,0.10243249334258997,3081200.0
1032,BSESN,2007-09-04,15465.400391,15521.480469,15389.620117,15482.129883,13400.0,43.35058599999866,0.0,43.35058599999866,71.63987807639377,13779.879883,15521.480469,96.77996904394698,-3.220030956053023,78.68156800737233,-41.92580355231641,0.08539330868156325,3094600.0
1033,BSESN,2007-09-05,15446.150391,15580.860352000003,15407.0,15535.349609,16200.0,-19.25,19.25,0.0,70.43058383026025,13779.879883,15580.860352000003,92.52018756900779,-7.4798124309922125,107.79681030656684,-11.981280780539752,0.09052327661748905,3078400.0
1034,BSESN,2007-09-06,15616.30957,15637.740234,15350.179688,15383.179688,11200.0,170.15917900000022,0.0,170.15917900000022,74.77371546763108,13870.700195,15637.740234,98.78719986378299,-1.2128001362170224,142.95339550044628,19.005654475657465,0.0825961997117648,3089600.0
1035,BSESN,2007-09-07,15590.419922,15716.05957,15565.219727000003,15655.370117,14000.0,-25.88964800000031,25.88964800000031,0.0,72.89409037177404,13870.700195,15716.05957,93.19158914506828,-6.808410854931729,166.8033590398063,48.56519538848725,0.05039892826464998,3075600.0
1036,BSESN,2007-09-10,15596.830078,15626.280272999997,15363.530272999997,15413.580078,11200.0,6.4101560000017335,0.0,6.4101560000017335,73.08736235260378,13870.700195,15716.05957,93.53895541349507,-6.461044586504923,184.09968640494844,75.6720935917795,0.04542067152902485,3086800.0
1037,BSESN,2007-09-11,15542.769531,15698.980469,15506.099609,15668.400391,12000.0,-54.06054700000095,54.06054700000095,0.0,68.3452382323609,14128.719727000003,15716.05957,89.08299065482477,-10.917009345175238,191.24041564652725,98.78575800272907,0.03666564556421137,3074800.0
1038,BSESN,2007-09-12,15505.360352000003,15661.44043,15486.80957,15608.5,13200.0,-37.409178999998396,37.409178999998396,0.0,64.97896719610452,14163.610352000003,15716.05957,86.42794781581084,-13.572052184189168,191.6714181161824,117.36289002541976,0.02536878111009111,3061600.0
1039,BSESN,2007-09-13,15614.44043,15650.139647999997,15547.660156,15547.660156,13400.0,109.08007799999905,0.0,109.08007799999905,69.95740839818053,14581.349609,15716.05957,91.04448330475184,-8.95551669524817,198.52635313239443,133.5955826468147,0.019312523895864908,3075000.0
1040,BSESN,2007-09-14,15603.799805,15824.650391,15568.360352000003,15713.660156,13400.0,-10.640625,10.640625,0.0,68.85568183501584,14592.110352000003,15824.650391,82.08167045192441,-17.91832954807559,200.78579534586424,147.03362518662462,0.011785074117778738,3061600.0
1041,BSESN,2007-09-17,15504.429688,15726.05957,15467.459961000002,15664.740234,9400.0,-99.3701170000004,99.3701170000004,0.0,58.86620554053397,14592.110352000003,15824.650391,74.01944822337734,-25.980551776622658,192.34089549207783,156.09507924771526,0.002523652541366772,3052200.0
1042,BSESN,2007-09-18,15669.120117,15691.879883,15468.799805,15547.070313,12200.0,164.6904289999984,0.0,164.6904289999984,67.79973138981347,15053.980469,15824.650391,79.81882131894086,-20.181178681059126,196.67029996569545,164.2101233913113,0.014435294254930842,3064400.0
1043,BSESN,2007-09-19,16322.75,16335.299805,15940.790038999998,15940.790038999998,22800.0,653.6298830000014,0.0,653.6298830000014,83.8560388115782,15131.360352000003,16335.299805,98.95760497185064,-1.042395028149359,249.96244171607032,181.3605870562631,0.04523734796837786,3087200.0
1044,BSESN,2007-09-20,16347.950195,16415.880859,16261.360352000003,16341.549805,21600.0,25.200194999999443,0.0,25.200194999999443,84.20637729686455,15323.049805,16415.880859,93.78397385841478,-6.216026141585224,290.8772413584902,203.26391791670855,0.04858947204693509,3108800.0
1045,BSESN,2007-09-21,16564.230469,16616.839844,16308.089844,16352.320313,92400.0,216.28027399999885,0.0,216.28027399999885,87.00007550624028,15350.179688,16616.839844,95.84660694103336,-4.153393058966645,336.8712829773849,229.98539092884383,0.062025449156143386,3201200.0
1046,BSESN,2007-09-24,16845.830078,16869.640625,16599.660156,16697.890625,21200.0,281.5996090000008,0.0,281.5996090000008,89.7294070327412,15350.179688,16869.640625,98.43296089947451,-1.5670391005254882,391.53129826310214,262.2945723956955,0.08383708864762163,3222400.0
1047,BSESN,2007-09-25,16899.539063,16928.019531,16676.980469,16890.75,18800.0,53.708985000001114,0.0,53.708985000001114,90.18299076063133,15350.179688,16928.019531,98.19497092012516,-1.8050290798748412,434.1786788628724,296.6713936891309,0.08991591806637156,3241200.0
1048,BSESN,2007-09-26,16921.390625,17073.869141,16887.070313,16969.449219,16400.0,21.851561999999827,0.0,21.851561999999827,90.38238507973527,15363.530272999997,17073.869141,91.08489441169625,-8.915105588303744,464.38710816624916,330.2145365845546,0.0837013789164649,3257600.0
1049,BSESN,2007-09-27,17150.560547,17188.400391,17018.560547,17059.609375,19000.0,229.16992200000092,0.0,229.16992200000092,92.27988016474613,15363.530272999997,17188.400391,97.92643631857649,-2.0735636814235026,501.04388150460727,364.38040556856515,0.09912718448902202,3276600.0
1050,BSESN,2007-09-28,17291.099609,17361.470703,17152.310547,17152.310547,22600.0,140.53906199999986,0.0,140.53906199999986,93.22561711006381,15467.459961000002,17361.470703,96.2845462045432,-3.715453795456794,535.264767196999,398.55727789425197,0.1152360942616828,3299200.0
1051,BSESN,2007-10-01,17328.619141,17425.339844,17144.580078,17356.990234,22200.0,37.519531999998435,0.0,37.519531999998435,93.4719585553509,15467.459961000002,17425.339844,95.05992661552878,-4.940073384471219,558.9691301389375,430.6396483431892,0.10590888394553488,3321400.0
1052,BSESN,2007-10-03,17847.039063,17953.070313,17288.410156,17467.410156,32800.0,518.419922000001,0.0,518.419922000001,95.86767143456707,15467.459961000002,17953.070313,95.7341966364646,-4.2658033635354,612.5263412628065,467.01698692711267,0.09338432941753072,3354200.0
1053,BSESN,2007-10-04,17777.140625,17890.490234,17494.699219,17799.630859,20800.0,-69.89843800000017,69.89843800000017,0.0,90.68988186846335,15467.459961000002,17953.070313,92.92207292834769,-7.077927071652312,641.9308182713885,501.99975319596786,0.0874232189939701,3333400.0
1054,BSESN,2007-10-05,17773.359375,17979.179688,17708.800781,17831.679688,20000.0,-3.78125,3.78125,0.0,90.38517289903452,15467.459961000002,17979.179688,91.80560192335503,-8.194398076644973,657.3514248362735,533.0700875240291,0.07299638267306707,3313400.0
1055,BSESN,2007-10-08,17491.390625,17982.589844,17322.140625,17901.939453,20400.0,-281.96875,281.96875,0.0,70.11523964336524,15468.799805,17982.589844,80.45981520416078,-19.540184795839217,639.4486786995149,554.3458057591263,0.038321682221114095,3293000.0
1056,BSESN,2007-10-09,18280.240234,18327.419922,17287.189453,17402.240234,25600.0,788.8496090000008,0.0,788.8496090000008,82.6647432238426,15940.790038999998,18327.419922,98.02316696291864,-1.9768330370813558,681.0633201513483,579.6893086375707,0.08170052247300164,3318600.0
1057,BSESN,2007-10-10,18658.25,18703.669922,18436.990234,18473.429688,26000.0,378.00976599999916,0.0,378.00976599999916,85.93128314778816,16261.360352000003,18703.669922,98.14028808804935,-1.8597119119506622,736.0606038170154,610.9635676734597,0.1026428272646771,3344600.0
1058,BSESN,2007-10-11,18814.070313,18832.650391,18536.970703,18696.619141,35400.0,155.82031300000014,0.0,155.82031300000014,87.08847212416451,16308.089844,18832.650391,99.26402723745016,-0.7359727625498321,783.1915991355054,645.4091739658688,0.09699448373371,3380000.0
1059,BSESN,2007-10-12,18419.039063,18844.619141,18336.0,18794.630859,30000.0,-395.03125,395.03125,0.0,70.19837506070623,16599.660156,18844.619141,81.04285731527521,-18.957142684724797,779.6798678421801,672.2633127411311,0.06523237269496196,3350000.0
1060,BSESN,2007-10-15,19058.669922,19095.75,18525.609375,18525.609375,22800.0,639.6308590000008,0.0,639.6308590000008,78.12469305110817,16676.980469,19095.75,98.46698589821128,-1.5330141017887255,819.0679546654428,701.6242411259935,0.09983777512350378,3372800.0
1061,BSESN,2007-10-16,19051.859375,19174.449219,18777.75,19102.929688,27400.0,-6.810547000000953,6.810547000000953,0.0,77.87024240007426,16887.070313,19174.449219,94.64059742448292,-5.359402575517079,840.0501676048661,729.3094264217681,0.06750813441641434,3345400.0
1062,BSESN,2007-10-17,18715.820313,18841.289063,17307.900391,18037.900391,36800.0,-336.03906199999983,336.03906199999983,0.0,65.68966287526368,17018.560547,19174.449219,78.7266888148481,-21.273311185151897,820.1094671829887,747.4694345740123,0.0528026248878255,3308600.0
1063,BSESN,2007-10-18,17998.390625,19198.660156,17771.160156,18827.460938,41600.0,-717.4296880000003,717.4296880000003,0.0,47.41802821591803,17144.580078,19198.660156,41.566565789943844,-58.433434210056156,737.9095761609169,745.5574628913934,0.012661154554525433,3267000.0
1064,BSESN,2007-10-19,17559.980469,18031.769531,17226.179688,18031.769531,35400.0,-438.4101560000017,438.4101560000017,0.0,39.64308864546408,17144.580078,19198.660156,20.22318386946542,-79.77681613053458,630.1258362642948,722.4711375659737,0.0039213488207143765,3231600.0
1065,BSESN,2007-10-22,17613.990234,17704.830078,17171.449219,17259.650391,78400.0,54.009765000002524,0.0,54.009765000002524,41.01780794137126,17171.449219,19198.660156,21.830042790460823,-78.16995720953918,542.8074362739026,686.5383973075595,-0.03644645756683329,3310000.0
1066,BSESN,2007-10-23,18492.839844,18542.410156,17910.300781,17910.300781,21600.0,878.8496099999976,0.0,878.8496099999976,58.685496712211325,17171.449219,19198.660156,65.18269021158096,-34.81730978841904,538.3174058965415,656.894199025356,-0.008865255637586666,3331600.0
1067,BSESN,2007-10-24,18512.910156,18832.490234,18317.169922,18727.900391,25200.0,20.07031200000347,0.0,20.07031200000347,59.00904147284372,17171.449219,19198.660156,66.17273577781616,-33.82726422218384,530.2659550664575,631.5685502335764,-0.016007177181213472,3356800.0
1068,BSESN,2007-10-25,18770.890625,18900.099609,18459.509766,18519.230469,23200.0,257.98046899999827,0.0,257.98046899999827,63.27462706827269,17171.449219,19198.660156,78.89861764296504,-21.101382357034957,538.4945600050924,612.9537521878797,0.01910260143303555,3380000.0
1069,BSESN,2007-10-26,19243.169922,19276.449219,18629.529297,18823.660156,23200.0,472.2792970000009,0.0,472.2792970000009,69.89258551090613,17171.449219,19276.449219,98.41903577197162,-1.580964228028376,576.479484318781,605.6588986140599,0.009680633578056153,3403200.0
1070,BSESN,2007-10-29,19977.669922,20024.869141,19621.390625,19621.390625,20600.0,734.5,0.0,734.5,77.24942137312712,17171.449219,20024.869141,98.34587196100756,-1.6541280389924413,658.2627784754441,616.1796745863368,0.048594235805396346,3423800.0
1071,BSESN,2007-10-30,19783.509766,20238.160156,19694.849609,20103.439453,20600.0,-194.1601560000017,194.1601560000017,0.0,71.89132739723131,17171.449219,20238.160156,85.17465782266514,-14.825342177334857,699.3478793619979,632.813315541469,0.057047430203119864,3403200.0
1072,BSESN,2007-10-31,19837.990234,19984.130859,19735.210938,19827.400391,31000.0,54.48046800000157,0.0,54.48046800000157,72.50868837660433,17171.449219,20238.160156,86.9511691769859,-13.048830823014098,727.9133048046024,651.8333133940957,0.10220911676651645,3434200.0
1073,BSESN,2007-11-01,19724.349609,20204.210938,19634.470703,20130.230469,26000.0,-113.640625,113.640625,0.0,68.86821104191293,17171.449219,20238.160156,83.24555011687428,-16.754449883125726,732.9329665638543,668.0532440280475,0.12325578287634964,3408200.0
1074,BSESN,2007-11-02,19976.230469,20025.630859,19255.769531,19364.609375,19200.0,251.88085999999748,0.0,251.88085999999748,72.41077170484998,17171.449219,20238.160156,91.45893785293521,-8.541062147064798,748.6062976109715,684.1638547446324,0.13411158991335204,3427400.0
1075,BSESN,2007-11-05,19590.779297,20009.349609,19502.449219,20009.349609,19000.0,-385.4511719999973,385.4511719999973,0.0,60.29580033612101,17171.449219,20238.160156,78.89005934047053,-21.109940659529467,721.6066053930626,691.6524048743186,0.05937105724496017,3408400.0
1076,BSESN,2007-11-06,19400.669922,19919.339844,19337.849609,19689.789063,18000.0,-190.109375,190.109375,0.0,55.05389320382439,17171.449219,20238.160156,72.69093008096577,-27.309069919034236,677.0641430526157,688.7347525099781,0.04795355017224434,3390400.0
1077,BSESN,2007-11-07,19289.830078,19678.5,19249.470703,19552.529297,13600.0,-110.8398440000019,110.8398440000019,0.0,52.0119859168565,17171.449219,20238.160156,69.07663951765528,-30.923360482344727,625.608446904942,676.1094913889709,0.027645968609973703,3376800.0
1078,BSESN,2007-11-08,19058.929688,19209.910156,18917.400391,19110.400391,16400.0,-230.9003899999989,230.9003899999989,0.0,45.91408283028661,17171.449219,20238.160156,61.547387666293105,-38.452612333706895,559.745309730497,652.8366550572762,-0.009574318303418705,3360400.0
1079,BSESN,2007-11-12,18737.269531,18815.109375,18333.210938,18640.519531,22800.0,-321.66015699999843,321.66015699999843,0.0,38.63356348836801,17910.300781,20238.160156,35.52485854090735,-64.47514145909264,476.10477309831913,617.4902786654848,-0.062089342543097725,3337600.0
1080,BSESN,2007-11-13,19035.480469,19210.480469,18636.210938,18681.099609,23200.0,298.2109379999965,0.0,298.2109379999965,47.53325186796511,18317.169922,20238.160156,37.392722476484856,-62.60727752351515,428.9376494452081,579.7797528214295,-0.03781074773120219,3360800.0
1081,BSESN,2007-11-14,19929.060547,19987.710938,19336.960938,19336.960938,20800.0,893.5800780000028,0.0,893.5800780000028,65.05525051356878,18333.210938,20238.160156,83.77386619657383,-16.226133803426173,458.37791321048644,555.4993848992409,0.004590702582558892,3381600.0
1082,BSESN,2007-11-15,19784.890625,19967.080078,19723.199219,19947.720703,19200.0,-144.16992200000098,144.16992200000098,0.0,61.24743009847202,18333.210938,20238.160156,76.20568954190351,-23.794310458096493,464.71923248858,537.3433544171087,0.003069354234746191,3362400.0
1083,BSESN,2007-11-16,19698.359375,19838.029297,19472.509766,19603.089844,19000.0,-86.53125,86.53125,0.0,58.86142642768231,18333.210938,20238.160156,71.66324561834061,-28.33675438165939,457.48877913109027,521.372439359905,-0.013910086511627506,3343400.0
1084,BSESN,2007-11-19,19633.359375,19971.439453,19583.970703,19895.490234,12600.0,-65.0,65.0,0.0,56.93886455577322,18333.210938,20238.160156,68.2510811687159,-31.7489188312841,441.4251614962377,505.38298378717155,0.002173475457738494,3330800.0
1085,BSESN,2007-11-20,19280.800781,19714.220703,19196.419922,19510.939453,14400.0,-352.55859399999827,352.55859399999827,0.0,47.275072026304095,18333.210938,20204.210938,50.646170122929,-49.35382987707101,395.68488762851484,483.44336455544027,-0.006178608340945524,3316400.0
1086,BSESN,2007-11-21,18602.619141,19218.880859,18515.300781,19197.570313,16600.0,-678.1816400000025,678.1816400000025,0.0,34.33928898120996,18333.210938,20204.210938,14.399155692143188,-85.60084430785682,301.23930134892,447.00255191413623,-0.03562555679449775,3299800.0
1087,BSESN,2007-11-22,18526.320313,18744.550781,18182.830078,18724.109375,19800.0,-76.29882799999905,76.29882799999905,0.0,33.16137703629471,18182.830078,20025.630859,18.639575071897085,-81.36042492810292,217.72402893785693,401.14684731888036,-0.027945397969296515,3280000.0
1088,BSESN,2007-11-23,18852.869141,18910.460938,18548.060547,18737.220703,14000.0,326.54882799999905,0.0,326.54882799999905,42.84339951829468,18182.830078,20009.349609,36.68392544552536,-63.31607455447463,175.86012909513738,356.0895036741318,0.006169501367781605,3294000.0
1089,BSESN,2007-11-26,19247.539063,19360.230469,19137.660156,19171.25,11400.0,394.6699220000009,0.0,394.6699220000009,52.44913865627593,18182.830078,19987.710938,58.99054107094916,-41.00945892905084,172.54031383266556,319.37966570583853,0.011140175544575692,3305400.0
1090,BSESN,2007-11-27,19127.730469,19211.580078,19019.330078,19128.859375,8800.0,-119.8085940000019,119.8085940000019,0.0,49.53329987435944,18182.830078,19987.710938,52.35250768851295,-47.64749231148705,158.41566686824808,287.18686593832047,-0.04020912456511305,3296600.0
1091,BSESN,2007-11-28,18938.869141,19316.759766,18884.199219,19316.759766,11000.0,-188.86132799999905,188.86132799999905,0.0,44.98455527271975,18182.830078,19987.710938,41.88858554353553,-58.11141445646447,130.4781803534679,255.84512882134996,-0.04276098867743938,3285600.0
1092,BSESN,2007-11-29,19003.259766,19297.009766,18930.310547,19290.669922,13400.0,64.390625,0.0,64.390625,46.90275484209209,18182.830078,19987.710938,45.45616866921618,-54.54383133078381,112.23947946179396,227.12399894943877,-0.03528718284438348,3299000.0
1093,BSESN,2007-11-30,19363.189453,19424.990234,19006.890625,19136.119141,13800.0,359.92968699999983,0.0,359.92968699999983,56.651086802775104,18182.830078,19987.710938,65.39818783384955,-34.601812166150445,125.38315630778015,206.7758304211071,-0.013760758759604808,3312800.0
1094,BSESN,2007-12-03,19603.410156,19619.439453,19446.679688,19547.089844,12800.0,240.22070300000266,0.0,240.22070300000266,62.020731912412614,18182.830078,19987.710938,78.70769253988331,-21.292307460116685,153.4149460269109,196.10365354226786,0.01673215644227355,3325600.0
1095,BSESN,2007-12-04,19529.5,19707.859375,19482.339844,19707.589844,14400.0,-73.91015600000173,73.91015600000173,0.0,59.40823600487349,18182.830078,19971.439453,75.29144936970941,-24.70855063029059,167.7328891056968,190.42950065495367,0.04982528814757936,3311200.0
1096,BSESN,2007-12-05,19738.070313,19790.919922,19560.679688,19628.849609,14600.0,208.57031300000014,0.0,208.57031300000014,64.30413969273064,18182.830078,19971.439453,86.95248144945013,-13.047518550549858,193.67725250809963,191.07905102558288,0.06540694425701532,3325800.0
1097,BSESN,2007-12-06,19795.869141,20064.310547,19716.570313,20018.169922,14800.0,57.79882799999905,0.0,57.79882799999905,65.62968007124388,18182.830078,20064.310547,85.73243727889043,-14.267562721109567,216.4076174927941,196.14476431902514,0.05001891186680041,3340600.0
1098,BSESN,2007-12-07,19966.0,20094.560547,19706.429688,20063.5,14800.0,170.13085900000078,0.0,170.13085900000078,69.47901439092405,18182.830078,20094.560547,93.27517403291432,-6.724825967085677,245.32181678857523,205.98017481293516,0.037327418048009875,3355400.0
1099,BSESN,2007-12-10,19930.679688,20095.689453,19834.009766,20074.919922,10200.0,-35.32031199999983,35.32031199999983,0.0,67.66371916470891,18182.830078,20095.689453,91.37365939406817,-8.626340605931833,262.3621267691633,217.25656520418082,0.041978279665814355,3345200.0
1100,BSESN,2007-12-11,20290.890625,20333.060547,20019.339844,20049.349609,11600.0,360.21093699999983,0.0,360.21093699999983,75.26766490450748,18182.830078,20333.060547,98.03881850769174,-1.9611814923082516,301.45769079646925,234.09679032263853,0.0713887124903918,3356800.0
1101,BSESN,2007-12-12,20375.869141,20419.109375,20045.419922,20197.439453,14800.0,84.97851599999922,0.0,84.97851599999922,76.75554670515055,18548.060547,20419.109375,97.68898420218028,-2.3110157978197243,335.43161613072516,254.36375548425585,0.07223020639100186,3371600.0
1102,BSESN,2007-12-13,20104.390625,20498.109375,20065.630859,20498.109375,17000.0,-271.4785159999992,271.4785159999992,0.0,62.82390050494867,18884.199219,20498.109375,75.60466742610922,-24.395332573890784,336.5703755449649,270.8050794963977,0.03827887827049925,3354600.0
1103,BSESN,2007-12-14,20030.830078,20171.570313,19936.490234,20108.089844,14800.0,-73.56054700000095,73.56054700000095,0.0,59.45022314431852,18884.199219,20498.109375,71.04675899939002,-28.953241000609975,327.7589283105917,282.1958492592365,0.02180334536688644,3339800.0
1104,BSESN,2007-12-17,19261.349609,20032.669922,19177.189453,20032.669922,15400.0,-769.4804689999983,769.4804689999983,0.0,36.07076109787978,18884.199219,20498.109375,23.368735155292132,-76.63126484470787,255.73717094678796,276.9041135967468,-0.013730530274712605,3324400.0
1105,BSESN,2007-12-18,19079.640625,19375.070313,19009.349609,19339.140625,15200.0,-181.7089840000008,181.7089840000008,0.0,32.579719152474894,18930.310547,20498.109375,9.52482393359712,-90.47517606640288,181.90018088743818,257.9033270548851,-0.03335836166144068,3309200.0
1106,BSESN,2007-12-19,19091.960938,19397.759766,18886.400391,19255.390625,12600.0,12.32031300000017,0.0,12.32031300000017,33.08636864062312,18886.400391,20498.109375,12.754197503437187,-87.2458024965628,122.96056770832001,230.91477518557207,-0.03555833785252238,3321800.0
1107,BSESN,2007-12-20,19162.570313,19291.140625,19097.699219,19210.220703,11400.0,70.609375,0.0,70.609375,36.25416599122472,18886.400391,20498.109375,17.135222595495616,-82.86477740450438,81.01420475934356,200.93466110032637,-0.04023989216668333,3333200.0
1108,BSESN,2007-12-24,19854.119141,19879.0,19308.199219,19308.199219,12200.0,691.5488279999989,0.0,691.5488279999989,58.47168268592716,18886.400391,20498.109375,60.043020148605166,-39.95697985139484,102.39329465676201,181.2263878116135,-0.0038413414995625006,3345400.0
1109,BSESN,2007-12-26,20192.519531,20211.470703,19896.609375,19940.960938,12000.0,338.4003900000025,0.0,338.4003900000025,65.30020231716065,18886.400391,20498.109375,81.03939066955041,-18.96060933044958,144.9713216173368,173.97537457275817,-0.004848042198739022,3357400.0
1110,BSESN,2007-12-27,20216.720703,20323.759766,20159.730469,20301.050781,13200.0,24.201171999997314,0.0,24.201171999997314,65.76472771550752,18886.400391,20498.109375,82.54097515162819,-17.45902484837181,178.60865763924448,174.90203118605544,-0.007810633102259379,3370600.0
1111,BSESN,2007-12-28,20206.949219,20259.449219,20022.880859,20158.119141,10600.0,-9.771484000000783,9.771484000000783,0.0,65.35711527477824,18886.400391,20498.109375,81.93469423509761,-18.06530576490238,202.1477779340239,180.35118053564915,0.005101303288072012,3360000.0
1112,BSESN,2007-12-31,20286.990234,20484.279297,20239.630859,20323.279297,10400.0,80.04101500000252,0.0,80.04101500000252,67.27421391990487,18886.400391,20498.109375,86.90091430302537,-13.09908569697463,224.67146850191057,189.21523812890146,0.012788294594008986,3370400.0
1113,BSESN,2008-01-02,20465.300781,20529.480469,20077.400391,20393.099609,20600.0,178.31054700000095,0.0,178.31054700000095,71.34963857335626,18886.400391,20529.480469,96.09394034658872,-3.9060596534112784,253.98207918043045,202.1686063392073,0.06250606507019874,3391000.0
1114,BSESN,2008-01-03,20345.199219,20519.699219,20293.869141,20383.029297,20600.0,-120.1015620000035,120.1015620000035,0.0,65.05351717393225,18886.400391,20529.480469,88.78440238747754,-11.215597612522457,264.47109879259733,214.62910482988534,0.06633031611411688,3370400.0
1115,BSESN,2008-01-04,20686.890625,20762.800781,20367.939453,20367.939453,18600.0,341.69140600000173,0.0,341.69140600000173,72.90292699118943,18886.400391,20762.800781,95.9544798431852,-4.045520156814806,296.9325100922433,231.08978588235695,0.08353933323975671,3389000.0
1116,BSESN,2008-01-07,20812.650391,20861.830078,20438.189453,20637.210938,17600.0,125.75976599999922,0.0,125.75976599999922,75.26255699298194,18886.400391,20861.830078,97.51043090403856,-2.489569095961442,329.01351155958037,250.67453101780166,0.08610953807593202,3406600.0
1117,BSESN,2008-01-08,20873.330078,21077.529297,20696.599609,20970.070313,22800.0,60.67968699999983,0.0,60.67968699999983,76.40639707805788,18886.400391,21077.529297,90.68063871364026,-9.319361286359742,355.23930242361894,271.58748529896513,0.05133498644597467,3429400.0
1118,BSESN,2008-01-09,20869.779297,21113.130859,20701.490234,20903.0,22200.0,-3.5507809999980964,3.5507809999980964,0.0,76.16859540021096,18886.400391,21113.130859,89.07135077652336,-10.928649223476636,371.45501014418187,291.5609902680085,0.03354013177802084,3407200.0
1119,BSESN,2008-01-10,20582.080078,21206.769531,20530.070313,20930.279297,21200.0,-287.69921900000185,287.69921900000185,0.0,59.00106740098021,18886.400391,21206.769531,73.07801408701712,-26.921985912982883,356.97615387802216,304.64402299001125,0.018072138422814632,3386000.0
1120,BSESN,2008-01-11,20827.449219,20894.789063,20505.810547,20702.939453,18200.0,245.3691409999992,0.0,245.3691409999992,66.4438188218233,19097.699219,21206.769531,82.01480956600736,-17.985190433992646,361.1378229928159,315.9427829905722,0.03070725784853079,3404200.0
1121,BSESN,2008-01-14,20728.050781,20959.220703,20661.900391,20918.230469,16800.0,-99.3984379999965,99.3984379999965,0.0,61.24682645941232,19308.199219,21206.769531,74.78530307915196,-25.214696920848045,352.35363909138687,323.2249542107352,0.021741053843502334,3387400.0
1122,BSESN,2008-01-15,20251.089844,20872.929688,20203.630859,20836.470703,19400.0,-476.9609370000034,476.9609370000034,0.0,42.738476907062655,19896.609375,21206.769531,27.05626998169816,-72.94373001830185,303.40785172598044,319.2615337137843,-0.010467030965842339,3368000.0
1123,BSESN,2008-01-16,19868.109375,20079.890625,19513.25,20079.890625,24600.0,-382.9804689999983,382.9804689999983,0.0,33.38997672990966,19513.25,21206.769531,20.95395822157776,-79.04604177842224,231.0512247619008,301.6194719234076,-0.02344975042340469,3343400.0
1124,BSESN,2008-01-17,19700.820313,20026.119141,19643.759766,19972.75,20200.0,-167.28906199999986,167.28906199999986,0.0,30.074402650125037,19513.25,21206.769531,11.075769104903225,-88.92423089509678,158.38350097224247,272.9722777331746,-0.04766643425901518,3323200.0
1125,BSESN,2008-01-18,19013.699219,19715.779297,18930.419922,19579.609375,28000.0,-687.1210940000019,687.1210940000019,0.0,20.450364823743456,18930.419922,21206.769531,3.6584581151654407,-96.34154188483456,44.83208023707266,227.34423823395423,-0.0864354677661775,3295200.0
1126,BSESN,2008-01-21,17605.349609,18919.570313,16951.5,18919.570313,35800.0,-1408.3496099999975,1408.3496099999975,0.0,11.640640809362608,16951.5,21206.769531,15.365644978224072,-84.63435502177593,-156.99059242139265,150.47727210288483,-0.15656248700078634,3259400.0
1127,BSESN,2008-01-22,16729.939453,17068.570313,15332.419922,16884.089844,30600.0,-875.4101560000017,875.4101560000017,0.0,8.893006828753428,15332.419922,21206.769531,23.790200175673597,-76.20979982432641,-383.15799122307726,43.75021943769238,-0.1983652910308974,3228800.0
1128,BSESN,2008-01-23,17594.070313,17997.109375,16951.029297,17520.019531,22000.0,864.1308600000011,0.0,864.1308600000011,28.19676409453325,15332.419922,21206.769531,38.50043905345642,-61.49956094654358,-487.05468246402233,-62.4107609426506,-0.14517530558992697,3250800.0
1129,BSESN,2008-01-24,17221.740234,18185.099609,17070.050781,17920.980469,22800.0,-372.3300789999994,372.3300789999994,0.0,25.509621779324334,15332.419922,21206.769531,32.1622041205277,-67.8377958794723,-592.6062880862519,-168.4498663713709,-0.1731229276848104,3228000.0
1130,BSESN,2008-01-25,18361.660156,18406.25,17504.0,17504.0,15200.0,1139.9199220000012,0.0,1139.9199220000012,44.27106581974822,15332.419922,21206.769531,51.56724464201022,-48.43275535798977,-577.6162840343131,-250.28314990395938,-0.11416368331020832,3243200.0
1131,BSESN,2008-01-28,18152.779297,18213.210938,17443.289063,18011.890625,12400.0,-208.8808590000008,208.8808590000008,0.0,42.03272684805677,15332.419922,21206.769531,48.011432119718776,-51.988567880281224,-575.9523176570437,-315.41698345457627,-0.10361469743919416,3230800.0
1132,BSESN,2008-01-29,18091.939453,18491.060547,17927.919922,18346.490234,14800.0,-60.8398440000019,60.8398440000019,0.0,41.33044202609312,15332.419922,21206.769531,46.975745651436576,-53.024254348563424,-572.9384020092439,-366.92126716550985,-0.08939803423042114,3216000.0
1133,BSESN,2008-01-30,17758.640625,18129.179688,17683.509766,18120.220703,13400.0,-333.29882799999905,333.29882799999905,0.0,37.38236109533674,15332.419922,20959.220703,43.119008428245984,-56.880991571754016,-590.6358002224042,-411.66417377688884,-0.0985836963711817,3202600.0
1134,BSESN,2008-01-31,17648.710938,18008.710938,17417.630859,17810.130859,16800.0,-109.92968699999984,109.92968699999984,0.0,36.071055370296826,15332.419922,20959.220703,41.165328330468235,-58.83467166953176,-606.5397106033961,-450.6392811421903,-0.0717897272528637,3185800.0
1135,BSESN,2008-02-01,18242.580078,18312.400391,17534.960938,17820.669922,14800.0,593.8691399999989,0.0,593.8691399999989,47.54142453189904,15332.419922,20872.929688,52.52513358713931,-47.47486641286069,-564.7137293850465,-473.45417079076157,0.036195274910885145,3200600.0
1136,BSESN,2008-02-04,18660.320313,18895.339844,18447.25,18496.029297,17400.0,417.7402350000011,0.0,417.7402350000011,54.20974385881227,15332.419922,20079.890625,70.09838710320105,-29.901612896798945,-492.1845945343739,-477.2002555394841,0.11538480849994026,3218000.0
1137,BSESN,2008-02-05,18663.160156,18729.830078,18509.539063,18592.580078,19000.0,2.839843000001565,0.0,2.839843000001565,54.25535554032508,15332.419922,20026.119141,70.96194448330291,-29.038055516697085,-429.52429235183445,-467.6650629019542,0.060764213395809064,3237000.0
1138,BSESN,2008-02-06,18139.490234,18274.150391,17936.009766,18247.029297,16400.0,-523.669922000001,523.669922000001,0.0,44.76733785482475,15332.419922,19715.779297,64.0392464284314,-35.960753571568596,-417.3108380680569,-457.59421793517475,0.05329020107899041,3220600.0
1139,BSESN,2008-02-07,17526.929688,18198.679688,17492.279297,18198.679688,17400.0,-612.5605460000006,612.5605460000006,0.0,36.21857087450291,15332.419922,18919.570313,61.17696574712694,-38.82303425287305,-451.851442078565,-456.44566276385285,-0.04546051178968358,3203200.0
1140,BSESN,2008-02-08,17464.890625,17688.730469,17203.060547,17610.070313,19200.0,-62.03906300000017,62.03906300000017,0.0,35.427978363181964,15332.419922,18895.339844,59.85177185242395,-40.14822814757605,-478.71284976681636,-460.89910016444554,-0.03789439957074148,3184000.0
1141,BSESN,2008-02-11,16630.910156,17427.339844,16457.740234,17427.339844,20000.0,-833.9804689999983,833.9804689999983,0.0,26.46685769126914,16457.740234,18895.339844,7.104116742125714,-92.89588325787429,-560.831051610694,-480.88549045369524,-0.08075581397978482,3164000.0
1142,BSESN,2008-02-12,16608.009766,16966.720703,16565.480469,16812.630859,14400.0,-22.900390000002517,22.900390000002517,0.0,26.256437860794023,16457.740234,18895.339844,6.1646519544692,-93.8353480455308,-620.6042488204475,-508.82924212704575,-0.06479273291786658,3149600.0
1143,BSESN,2008-02-13,16949.140625,17141.060547,16725.679688,16816.939453,14200.0,341.1308590000008,0.0,341.1308590000008,35.12202685679463,16457.740234,18895.339844,20.15919222271289,-79.84080777728711,-633.1499701463727,-533.6933877309111,-0.03963860677743514,3163800.0
1144,BSESN,2008-02-14,17766.630859,17836.640625,17265.189453,17265.189453,14400.0,817.4902340000008,0.0,817.4902340000008,51.30832871121669,16457.740234,18895.339844,53.695882606413825,-46.30411739358617,-570.5509585567597,-541.0649018960809,-0.026090016706243113,3178200.0
1145,BSESN,2008-02-15,18115.25,18142.919922,17445.050781,17541.169922,17400.0,348.61914099999916,0.0,348.61914099999916,56.63227389304899,16457.740234,18895.339844,67.99762189000354,-32.00237810999646,-487.194069755129,-530.2907354678905,-0.029210126292433913,3195600.0
1146,BSESN,2008-02-18,18048.050781,18256.820313,17900.960938,18228.210938,11800.0,-67.19921899999828,67.19921899999828,0.0,55.28774942753452,16457.740234,18895.339844,65.24084351162178,-34.75915648837823,-421.6945182808631,-508.57149203048505,-0.032958479156717124,3183800.0
1147,BSESN,2008-02-19,18075.660156,18314.099609,18018.480469,18215.259766,12800.0,27.609375,0.0,27.609375,55.785384316090365,16457.740234,18895.339844,66.37348953300835,-33.62651046699164,-363.3691130713305,-479.5310162386542,-0.0035188462948291255,3196600.0
1148,BSESN,2008-02-20,17617.599609,17991.289063,17505.560547,17991.289063,12800.0,-458.0605470000009,458.0605470000009,0.0,45.98738837116393,16457.740234,18895.339844,47.582029888821694,-52.417970111178306,-350.0720544704527,-453.63922388501396,0.005173177653703842,3183800.0
1149,BSESN,2008-02-21,17734.679688,17887.210938,17482.310547,17825.220703,15800.0,117.08007899999942,0.0,117.08007899999942,48.647421860145215,16457.740234,18895.339844,52.38511889981804,-47.61488110018197,-326.3249845413229,-428.1763760162757,0.015447509451551378,3199600.0
1150,BSESN,2008-02-22,17349.070313,17526.800781,17347.259766,17503.039063,9800.0,-385.609375,385.609375,0.0,40.97811093322887,16457.740234,18729.830078,39.22952612784093,-60.77047387215908,-334.7617889040739,-409.4934585938353,0.04318225221972627,3189800.0
1151,BSESN,2008-02-25,17650.570313,17674.060547,17137.990234,17523.810547,13200.0,301.5,0.0,301.5,48.327387258689,16457.740234,18314.099609,64.25642012339337,-35.74357987660663,-313.5055895996302,-390.2958847949943,0.0627745624966054,3203000.0
1152,BSESN,2008-02-26,17806.189453,17860.099609,17678.740234,17799.560547,11000.0,155.61913999999888,0.0,155.61913999999888,51.89475211313353,16457.740234,18314.099609,72.63944886749087,-27.36055113250912,-280.86509647392813,-368.4097271307811,0.05056591640615982,3214000.0
1153,BSESN,2008-02-27,17825.990234,18137.279297,17770.650391,17983.419922,13000.0,19.800781000001734,0.0,19.800781000001734,52.37744072780733,16457.740234,18314.099609,73.70609475872634,-26.293905241273663,-250.5117692275926,-344.83013555014344,0.0033410597355845173,3227000.0
1154,BSESN,2008-02-28,17824.480469,17921.509766,17690.160156,17810.519531,18200.0,-1.509765000002517,1.509765000002517,0.0,52.331244065723,16457.740234,18314.099609,73.62476540944543,-26.375234590554562,-223.9962744992372,-320.6633633399622,-0.016051091262886286,3208800.0
1155,BSESN,2008-02-29,17578.720703,17779.539063,17258.199219,17779.539063,23000.0,-245.7597659999992,245.7597659999992,0.0,44.89411856046089,16565.480469,18314.099609,57.94516431977288,-42.05483568022713,-220.27413005395283,-300.58551668276033,-0.02600447459368227,3185800.0
1156,BSESN,2008-03-03,16677.880859,17227.560547,16634.630859,17227.560547,21800.0,-900.8398439999983,900.8398439999983,0.0,28.03998244019354,16634.630859,18314.099609,2.5752190983011745,-97.42478090169882,-286.7095414195719,-297.81032163012264,-0.07732936362692266,3164000.0
1157,BSESN,2008-03-04,16339.889647999997,16754.060547,16164.570313,16742.199219,20600.0,-337.99121100000235,337.99121100000235,0.0,24.11987610353465,16164.570313,18314.099609,8.156173322514999,-91.843826677485,-362.45499403457507,-310.73925611101316,-0.07252463385234853,3143400.0
1158,BSESN,2008-03-05,16542.080078,16595.640625,16253.019531,16328.910156,21600.0,202.19043000000056,0.0,202.19043000000056,30.797823023997466,16164.570313,18314.099609,17.562438702393884,-82.43756129760612,-401.5400295131767,-328.8994107914459,-0.06724675218165699,3165000.0
1159,BSESN,2008-03-07,15975.519531,16211.959961000002,15689.919922,16211.959961000002,24400.0,-566.5605469999991,566.5605469999991,0.0,23.97569608706104,15689.919922,18314.099609,10.88338616501152,-89.11661383498848,-472.78196670566103,-357.675921974289,-0.07917143438924057,3140600.0
1160,BSESN,2008-03-10,15923.719727000003,15998.330078,15362.169922,15684.240234,21800.0,-51.799803999998396,51.799803999998396,0.0,23.42821555265388,15362.169922,18314.099609,19.023142979082884,-80.97685702091711,-527.3426486803364,-391.6092673154985,-0.09783539882154046,3118800.0
1161,BSESN,2008-03-11,16123.150391,16168.129883,15739.040038999998,15778.269531,22400.0,199.43066399999768,0.0,199.43066399999768,30.480293633938558,15362.169922,18137.279297,27.42163879576817,-72.57836120423184,-548.1710200658454,-422.92161786556795,-0.09451988963963542,3141200.0
1162,BSESN,2008-03-12,16127.980469,16683.369141,16064.089844,16541.140625,23000.0,4.830078000000867,0.0,4.830078000000867,30.65875741074416,15362.169922,18137.279297,27.595688800554047,-72.40431119944594,-557.8572760964744,-449.90874951174936,-0.09525472317163841,3164200.0
1163,BSESN,2008-03-13,15357.349609,15873.280272999997,15228.990234,15873.280272999997,21200.0,-770.6308599999992,770.6308599999992,0.0,20.819649504629695,15228.990234,18137.279297,4.413570048212226,-95.58642995178778,-620.5637016920264,-484.0397399478048,-0.1384124975923301,3143000.0
1164,BSESN,2008-03-14,15760.519531,15798.419922,15331.349609,15467.389647999997,23800.0,403.16992199999913,0.0,403.16992199999913,33.669648858764546,15228.990234,18137.279297,18.27635718066169,-81.72364281933831,-630.4590134185437,-513.3235946419526,-0.1034319392587939,3166800.0
1165,BSESN,2008-03-17,14809.490234,15326.929688,14739.719727000003,15326.929688,22600.0,-951.0292969999992,951.0292969999992,0.0,23.353932626636222,14739.719727000003,18137.279297,2.0535477174870405,-97.94645228251296,-706.8926173704494,-552.037399187652,-0.1120280592478119,3144200.0
1166,BSESN,2008-03-18,14833.459961000002,15164.730469,14677.240234,14725.679688,47600.0,23.969727000001512,0.0,23.969727000001512,24.030818338198827,14677.240234,18137.279297,4.514970038070969,-95.48502996192903,-756.8086238128744,-592.9916441126965,-0.09219338192925808,3191800.0
1167,BSESN,2008-03-19,14994.830078,15465.80957,14930.080078,15325.790038999998,28200.0,161.37011699999857,0.0,161.37011699999857,28.90784449821767,14677.240234,17921.509766,9.78925582068439,-90.21074417931561,-774.4191765206142,-629.2771505942801,-0.09353418631177768,3220000.0
1168,BSESN,2008-03-24,15289.400391,15351.30957,15056.089844,15093.769531,20200.0,294.57031299999835,0.0,294.57031299999835,37.37571463307276,14677.240234,17779.539063,19.732469073500674,-80.26753092649933,-755.8928418327105,-654.6002888419662,-0.0429481581909501,3240200.0
1169,BSESN,2008-03-25,16217.490234,16262.379883,15612.610352000003,15612.610352000003,29400.0,928.0898430000017,0.0,928.0898430000017,56.298887296983395,14677.240234,17227.560547,60.39437446930612,-39.605625530693885,-658.7280868170292,-655.4258484369789,0.018448610754049133,3269600.0
1170,BSESN,2008-03-26,16086.830078,16309.879883,16009.870117,16270.120117,24600.0,-130.66015599999992,130.66015599999992,0.0,53.66473305208159,14677.240234,16754.060547,67.87249889538228,-32.127501104617714,-585.518013858109,-641.444281521205,-0.002252680904116122,3245000.0
1171,BSESN,2008-03-27,16015.55957,16111.44043,15869.089844,15950.290038999998,24200.0,-71.27050800000144,71.27050800000144,0.0,52.12961940253687,14677.240234,16683.369141,66.7115324110127,-33.28846758898731,-527.1725212793772,-618.5899294728395,-0.006970550294011613,3220800.0
1172,BSESN,2008-03-28,16371.290038999998,16452.080078,15884.450195,16100.259766,23800.0,355.73046899999827,0.0,355.73046899999827,58.90052758026855,14677.240234,16683.369141,84.44371640770132,-15.556283592298675,-447.07521735838236,-584.286987049948,0.06602313913631219,3244600.0
1173,BSESN,2008-03-31,15644.44043,16226.660156,15563.150391,16226.660156,23200.0,-726.8496089999971,726.8496089999971,0.0,44.171003551906885,14677.240234,16683.369141,48.2122655540799,-51.78773444592011,-437.20835013414217,-554.8712596667868,-0.007365182395902559,3221400.0
1174,BSESN,2008-04-01,15626.620117,15834.049805,15297.959961000002,15771.719727000003,15300.0,-17.82031300000199,17.82031300000199,0.0,43.86071630800265,14677.240234,16683.369141,47.32397203825349,-52.676027961746506,-425.91703069482173,-529.0804138723938,0.055176097899981125,3206100.0
1175,BSESN,2008-04-02,15750.400391,16236.700195,15719.469727000003,16023.299805,16800.0,123.78027400000065,0.0,123.78027400000065,46.85291300895392,14677.240234,16683.369141,53.49407773625183,-46.50592226374817,-402.3425901233313,-503.73284912258134,0.06181568106232849,3222900.0
1176,BSESN,2008-04-03,15832.549805,16002.730469,15699.209961000002,15805.629883,15600.0,82.14941400000134,0.0,82.14941400000134,48.93706774645242,14677.240234,16452.080078,65.09373648025905,-34.906263519740946,-372.7342564775972,-477.5331305935846,0.05586723708387198,3238500.0
1177,BSESN,2008-04-04,15343.120117,15896.089844,15303.040038999998,15896.089844,19000.0,-489.429688000002,489.429688000002,0.0,38.54593627568858,14677.240234,16452.080078,37.51774478418799,-62.48225521581201,-384.3319843565532,-458.8929013461784,0.0035135273212951734,3219500.0
1178,BSESN,2008-04-07,15757.080078,15851.879883,15321.55957,15390.150391,19800.0,413.9599610000023,0.0,413.9599610000023,49.09474561775882,14677.240234,16452.080078,60.84153720407469,-39.15846279592532,-356.01622458813836,-438.3175659945704,-0.028389729197107805,3239300.0
1179,BSESN,2008-04-08,15587.620117,15770.400391,15479.419922,15770.160156,18400.0,-169.4599610000023,169.4599610000023,0.0,45.41271829734155,14677.240234,16452.080078,51.29363565268261,-48.70636434731739,-343.29252109336267,-419.3125570143289,-0.0310322144623576,3220900.0
1180,BSESN,2008-04-09,15790.509766,15829.589844,15464.719727000003,15512.700195,16400.0,202.88964900000062,0.0,202.88964900000062,50.53742922212718,14930.080078,16452.080078,56.5328310118265,-43.4671689881735,-313.22671278157395,-398.09538816777797,-0.014051947608596738,3237300.0
1181,BSESN,2008-04-10,15695.099609,15953.540038999998,15655.200195,15754.870117,22000.0,-95.41015699999843,95.41015699999843,0.0,48.087826376432446,15056.089844,16452.080078,45.774658692920426,-54.225341307079574,-293.71241152554103,-377.2187928393306,-0.04130342986955604,3215300.0
1182,BSESN,2008-04-11,15807.639647999997,15957.240234,15673.669922,15840.55957,19600.0,112.5400389999977,0.0,112.5400389999977,51.30050544042649,15297.959961000002,16452.080078,44.16175400571376,-55.83824599428624,-266.0987261024329,-354.9947794919511,0.010431770872868285,3234900.0
1183,BSESN,2008-04-15,16153.660156,16249.459961000002,15573.030272999997,15694.410156,22400.0,346.02050800000137,0.0,346.02050800000137,60.06777440652856,15297.959961000002,16452.080078,74.14307942437503,-25.85692057562497,-213.82883259883056,-326.761590113327,0.03372706542130888,3257300.0
1184,BSESN,2008-04-16,16244.19043,16413.800781,16198.55957,16288.759766,22000.0,90.53027400000065,0.0,90.53027400000065,62.12612576921457,15297.959961000002,16452.080078,81.98717404386089,-18.01282595613911,-163.21805278148895,-294.0528826469594,0.03135095151499523,3279300.0
1185,BSESN,2008-04-17,16481.199219,16570.570313,16397.169922,16456.039063,17800.0,237.00878899999768,0.0,237.00878899999768,67.22889170485709,15297.959961000002,16570.570313,92.9773403257683,-7.022659674231697,-102.79901359945325,-255.80210883745818,0.040969358820216684,3297100.0
1186,BSESN,2008-04-21,16739.330078,16778.589844,16611.410156,16611.410156,20200.0,258.1308590000008,0.0,258.1308590000008,71.97404005071766,15297.959961000002,16778.589844,97.34844160240421,-2.651558397595797,-33.69902533319146,-211.38149213660483,0.0909990895171977,3317300.0
1187,BSESN,2008-04-22,16783.869141,16853.960938,16597.529297,16686.550781,21400.0,44.53906300000017,0.0,44.53906300000017,72.75932203382303,15297.959961000002,16853.960938,95.49538862532468,-4.504611374675315,24.376150275225882,-164.2299636542387,0.06516366344000502,3338700.0
1188,BSESN,2008-04-23,16698.039063,16871.269531,16589.449219,16823.990234,17000.0,-85.83007799999905,85.83007799999905,0.0,68.4920378864067,15303.040038999998,16871.269531,88.95375524540887,-11.046244754591129,62.75200927013793,-118.83356906936338,0.07123723427086648,3321700.0
1189,BSESN,2008-04-24,16721.080078,16844.019531,16668.599609,16796.259766,19000.0,23.04101499999888,0.0,23.04101499999888,69.05421661135301,15303.040038999998,16871.269531,90.42299269551026,-9.577007304489737,93.94147253657684,-76.27856074817532,0.05893225271318947,3340700.0
1190,BSESN,2008-04-25,17125.980469,17150.919922,16781.970703,16781.970703,21600.0,404.90039099999916,0.0,404.90039099999916,77.27554595056174,15303.040038999998,17150.919922,98.65037477655129,-1.3496252234487172,149.60684990445225,-31.101478617649796,0.09116736405925652,3362300.0
1191,BSESN,2008-04-28,17015.960938,17271.560547,16978.890625,17251.560547,19200.0,-110.0195309999981,110.0195309999981,0.0,71.33390929992791,15321.55957,17271.560547,86.89233431086632,-13.107665689133682,182.7379168803709,11.666400481954357,0.07643907103821679,3343100.0
1192,BSESN,2008-04-29,17378.460938,17424.939453,17011.599609,17050.869141,27600.0,362.5,0.0,362.5,77.81802028689759,15464.719727000003,17424.939453,97.62891300482714,-2.3710869951728557,235.53020107084376,56.439160599732254,0.0758218738150851,3370700.0
1193,BSESN,2008-04-30,17287.310547,17480.740234,17241.880859,17479.009766,26200.0,-91.15039099999922,91.15039099999922,0.0,73.02559340231576,15464.719727000003,17480.740234,90.40537106004746,-9.594628939952548,266.9363161708352,98.53859171395285,0.06421496482050304,3344500.0
1194,BSESN,2008-05-02,17600.119141,17621.240234,17445.929688,17560.150391,24600.0,312.80859399999827,0.0,312.80859399999827,78.31398022348674,15573.030272999997,17621.240234,98.9688023492626,-1.0311976507374052,313.4536296176011,141.52159929468255,0.06789068605578641,3369100.0
1195,BSESN,2008-05-05,17490.900391,17735.699219,17457.269531,17687.0,20200.0,-109.21875,109.21875,0.0,72.58124161213723,15573.030272999997,17735.699219,88.68070730599935,-11.31929269400065,337.61409024264503,180.74009748427505,0.04489847021941262,3348900.0
1196,BSESN,2008-05-06,17373.009766,17502.150391,17237.679688,17441.410156,23200.0,-117.890625,117.890625,0.0,66.51688513695223,15573.030272999997,17735.699219,83.2295435845224,-16.7704564154776,343.291391698247,213.25035632706948,0.03510159785271649,3325700.0
1197,BSESN,2008-05-07,17339.310547,17413.810547,17229.980469,17404.150391,21200.0,-33.699218999998266,33.699218999998266,0.0,64.73296942394558,16198.55957,17735.699219,74.21257904199715,-25.787420958002862,341.1390105059327,238.82808716284217,0.03840399951039464,3304500.0
1198,BSESN,2008-05-08,17080.650391,17212.609375,17038.029297,17212.609375,18200.0,-258.66015600000173,258.66015600000173,0.0,52.30862835400984,16397.169922,17735.699219,51.06204776629553,-48.93795223370448,314.9311893153026,254.04870759333426,0.021504012379743864,3286300.0
1199,BSESN,2008-05-09,16737.070313,17125.949219,16678.939453,17020.789063,18600.0,-343.58007799999905,343.58007799999905,0.0,40.41875744400493,16589.449219,17735.699219,12.878612344602129,-87.12138765539788,263.4009392620719,255.9191539270818,-0.022708781941213285,3267700.0
1200,BSESN,2008-05-12,16860.900391,16897.359375,16546.550781,16641.449219,18000.0,123.83007799999905,0.0,123.83007799999905,45.56432732535299,16546.550781,17735.699219,26.4348503479259,-73.5651496520741,229.9046989837625,250.71626293841797,-0.009112652971230095,3285700.0
1201,BSESN,2008-05-13,16752.859375,17085.630859,16697.470703,17008.029297,17000.0,-108.04101599999922,108.04101599999922,0.0,41.919704760623084,16546.550781,17735.699219,17.349271748360053,-82.65072825163995,192.4225527715971,239.05752090505385,-0.035998674752149684,3268700.0
1202,BSESN,2008-05-14,16978.349609,17014.939453,16626.349609,16691.300781,19000.0,225.4902340000008,0.0,225.4902340000008,51.30048962085073,16546.550781,17735.699219,36.31160031847936,-63.68839968152065,178.85117423190604,227.0162515704243,-0.017872122859134754,3287700.0
1203,BSESN,2008-05-15,17353.539063,17366.189453,17079.939453,17084.890625,25000.0,375.1894539999994,0.0,375.1894539999994,62.827221200382965,16546.550781,17735.699219,67.86270378130882,-32.13729621869118,196.1097808320701,220.83495742275343,-0.014010136864675116,3312700.0
1204,BSESN,2008-05-16,17434.939453,17497.359375,17315.519531,17476.410156,17000.0,81.40038999999888,0.0,81.40038999999888,64.90658729734709,16546.550781,17735.699219,74.70797115069665,-25.292028849303342,213.8900902671594,219.44598399163465,-0.0031994315186195665,3329700.0
1205,BSESN,2008-05-20,17230.179688,17367.130859,17136.259766,17366.050781,16600.0,-204.7597649999989,204.7597649999989,0.0,55.84047527581415,16546.550781,17735.699219,57.48894630427968,-42.51105369572033,209.0489259183887,217.36657237698546,-0.008221377868532942,3313100.0
1206,BSESN,2008-05-21,17243.160156,17293.339844,17041.630859,17065.609375,19600.0,12.980468000001563,0.0,12.980468000001563,56.28709266991139,16546.550781,17735.699219,58.580523065027315,-41.419476934972685,203.90914587398584,214.67508707638552,-0.005545225730825498,3332700.0
1207,BSESN,2008-05-22,16907.109375,17104.589844,16863.380859,17104.589844,16800.0,-336.05078100000173,336.05078100000173,0.0,43.2274031069046,16546.550781,17735.699219,30.32073898246161,-69.6792610175384,170.7510320172696,205.89027606456236,-0.010160094143220721,3315900.0
1208,BSESN,2008-05-23,16649.640625,17054.339844,16626.109375,16958.800781,17600.0,-257.46875,257.46875,0.0,35.8700227173275,16546.550781,17735.699219,8.669215777080183,-91.33078422291982,122.28775441423204,189.16977173449632,-0.0052237151643016455,3298300.0
1209,BSESN,2008-05-26,16348.5,16498.240234,16300.879883,16468.320313,15800.0,-301.140625,301.140625,0.0,29.169787372932447,16300.879883,17502.150391,3.9641460173099006,-96.0358539826901,58.90174342137834,163.11616607187273,-0.03038985932646321,3282500.0
1210,BSESN,2008-05-27,16275.589844,16506.349609,16237.919922,16454.75,16200.0,-72.91015599999993,72.91015599999993,0.0,27.723125032011595,16237.919922,17497.359375,2.9910069841206512,-97.00899301587935,2.7528990774444537,131.04351267298708,-0.02848884004316432,3266300.0
1211,BSESN,2008-05-28,16525.369141,16563.300781,16217.780272999997,16358.620117,21600.0,249.77929699999916,0.0,249.77929699999916,39.56997765604118,16217.780272999997,17497.359375,24.03828473903927,-75.96171526096073,-21.344318799739995,100.56594637844165,-0.026679888118211648,3287900.0
1212,BSESN,2008-05-29,16316.259766,16666.029297,16196.019531,16666.029297,20000.0,-209.109375,209.109375,0.0,34.161172259924285,16196.019531,17497.359375,9.239725929731796,-90.76027407026821,-56.661755098961294,69.12040608296107,-0.05977335765542002,3267900.0
1213,BSESN,2008-05-30,16415.570313,16540.490234,16314.990234,16454.029297,18400.0,99.31054700000095,0.0,99.31054700000095,38.74911212025781,16196.019531,17497.359375,16.87113347157303,-83.12886652842697,-75.76418428953184,40.14348800846248,-0.05846703068559256,3286300.0
1214,BSESN,2008-06-02,16063.179688,16632.720703,15991.209961000002,16591.460938,17600.0,-352.390625,352.390625,0.0,30.147747246262256,15991.209961000002,17497.359375,4.778392258498597,-95.2216077415014,-117.97799850676529,8.519190705416916,-0.06772999592179296,3268700.0
1215,BSESN,2008-06-03,15962.55957,15985.400391,15709.509766,15851.719727000003,20200.0,-100.62011800000073,100.62011800000073,0.0,28.09320407015936,15709.509766,17497.359375,14.153864101664498,-85.84613589833549,-157.73369713842112,-24.731386863350703,-0.07426716300343583,3248500.0
1216,BSESN,2008-06-04,15514.790038999998,15992.900391,15442.339844,15992.900391,23800.0,-447.7695310000017,447.7695310000017,0.0,20.810898969075197,15442.339844,17497.359375,3.5255234272514375,-96.47447657274856,-222.80329600779623,-64.34576869223983,-0.08235111662900696,3224700.0
1217,BSESN,2008-06-05,15769.719727000003,15814.799805,15314.019531,15479.650391,28600.0,254.9296880000038,0.0,254.9296880000038,32.333603565618574,15314.019531,17497.359375,20.871702463192136,-79.12829753680785,-250.9084106546561,-101.6582970847231,-0.05284924268447966,3253300.0
1218,BSESN,2008-06-06,15572.179688,15970.700195,15526.5,15914.410156,19600.0,-197.5400390000013,197.5400390000013,0.0,28.61131937287965,15314.019531,17367.130859,12.574094423388235,-87.42590557661177,-285.82691201439593,-138.4920200706577,-0.04748572113649574,3233700.0
1219,BSESN,2008-06-09,15066.099609,15202.740234,14846.179688,15115.969727000003,24400.0,-506.0800789999994,506.0800789999994,0.0,21.346883271596823,14846.179688,17293.339844,8.98674001621007,-91.01325998378994,-350.298485911464,-180.85331323881897,-0.07431314297010738,3209300.0
1220,BSESN,2008-06-10,14889.25,15088.030272999997,14645.30957,14979.959961000002,26400.0,-176.84960900000075,176.84960900000075,0.0,19.364436005439558,14645.30957,17104.589844,9.919179712007102,-90.0808202879929,-410.9260583617415,-226.86786226340354,-0.09900651096142432,3182900.0
1221,BSESN,2008-06-11,15185.320313,15225.80957,15009.480469,15018.679688,34600.0,296.07031300000017,0.0,296.07031300000017,31.62961425664014,14645.30957,17054.339844,22.416104472749396,-77.5838955272506,-430.1252305166672,-267.51933591405634,-0.06931364597152734,3217500.0
1222,BSESN,2008-06-12,15250.200195,15270.849609,14748.070313,14957.530272999997,25000.0,64.87988199999927,0.0,64.87988199999927,34.16175913224107,14645.30957,16666.029297,29.93441479873273,-70.06558520126728,-435.09000181165175,-301.03346909357543,-0.07099175330369778,3242500.0
1223,BSESN,2008-06-13,15189.620117,15337.099609,15135.80957,15327.099609,20200.0,-60.58007800000087,60.58007800000087,0.0,32.85095964109448,14645.30957,16666.029297,26.936469205855413,-73.0635307941446,-438.8540880876426,-328.5975928923889,-0.05438273044113384,3222300.0
1224,BSESN,2008-06-16,15395.820313,15553.370117,15340.339844,15400.570313,15200.0,206.2001960000016,0.0,206.2001960000016,41.64487346303864,14645.30957,16666.029297,37.14076390565173,-62.85923609434827,-420.35295385843347,-346.94866508559784,-0.03550428454250709,3237500.0
1225,BSESN,2008-06-17,15696.900391,15732.75,15358.75,15388.360352000003,18200.0,301.08007799999905,0.0,301.08007799999905,52.19298822632818,14645.30957,16666.029297,52.04040951098208,-47.95959048901793,-377.0496321704959,-352.96885850257746,0.011737854752930987,3255700.0
1226,BSESN,2008-06-18,15422.30957,15789.620117,15390.219727000003,15744.209961000002,22000.0,-274.59082099999983,274.59082099999983,0.0,43.85168322081899,14645.30957,16632.720703,39.096087724290726,-60.90391227570928,-360.730347256349,-354.5211562533318,-0.02203020491259511,3233700.0
1227,BSESN,2008-06-19,15087.990234,15259.360352000003,15051.660156,15250.469727000003,18600.0,-334.3193359999986,334.3193359999986,0.0,35.81147289623134,14645.30957,16632.720703,22.274236902948928,-77.72576309705107,-370.50304431499353,-357.71753386566417,-0.031093235738418712,3215100.0
1228,BSESN,2008-06-20,14571.290038999998,15194.730469,14520.879883,15194.730469,26000.0,-516.7001950000031,516.7001950000031,0.0,26.9874285253089,14520.879883,15992.900391,3.4245552780028325,-96.57544472199717,-415.1557080582061,-369.2051687041726,-0.03284257922365119,3189100.0
1229,BSESN,2008-06-23,14293.320313,14509.69043,14163.450195,14423.049805,24600.0,-277.96972599999754,277.96972599999754,0.0,23.40726436898059,14163.450195,15992.900391,7.098860536567499,-92.9011394634325,-467.58309274524436,-388.880753512387,-0.04002415749618016,3164500.0
1230,BSESN,2008-06-24,14106.580078,14432.900391,13991.30957,14290.160156,24800.0,-186.7402349999993,186.7402349999993,0.0,21.224680663312625,13991.30957,15970.700195,5.823535109448214,-94.17646489055178,-518.2267537080752,-414.74995355152475,-0.07103835893909338,3139700.0
1231,BSESN,2008-06-25,14220.070313,14247.160156,13736.009766,13776.209961000002,23000.0,113.49023499999929,0.0,113.49023499999929,26.059404724648886,13736.009766,15970.700195,21.6611903249889,-78.3388096750111,-542.9457655882652,-440.38911595887294,-0.06754861371182141,3162700.0
1232,BSESN,2008-06-26,14421.820313,14449.80957,14196.679688,14300.719727000003,21800.0,201.75,0.0,201.75,34.32686679468161,13736.009766,15789.620117,33.3953588939619,-66.60464110603812,-540.0310795617661,-460.3175086794515,-0.05054766334417338,3184500.0
1233,BSESN,2008-06-27,13802.219727000003,14127.759766,13760.780272999997,14127.759766,32200.0,-619.6005859999988,619.6005859999988,0.0,24.58558674389222,13736.009766,15789.620117,3.2240761236796125,-96.77592387632039,-581.0201206799047,-484.45803107954214,-0.10350865063385961,3152300.0
1234,BSESN,2008-06-30,13461.599609,13872.05957,13405.540039,13791.019531,22400.0,-340.6201180000008,340.6201180000008,0.0,20.83512780498006,13405.540039,15789.620117,2.3514130467894976,-97.6485869532105,-633.6847050923498,-514.3033658821038,-0.14240396042021353,3129900.0
1235,BSESN,2008-07-01,12961.679688,13613.009766,12904.089844,13480.019531,27600.0,-499.9199210000006,499.9199210000006,0.0,16.55770615361385,12904.089844,15789.620117,1.9958149300622527,-98.00418506993775,-707.6043053232679,-552.9635537703366,-0.15955002529494677,3102300.0
1236,BSESN,2008-07-02,13664.620117,13711.009766,12822.75,12948.049805,32000.0,702.9404289999983,0.0,702.9404289999983,37.406506545627586,12822.75,15789.620117,28.375698422931677,-71.62430157706832,-701.3796353238686,-582.646770081043,-0.09433795322802574,3134300.0
1237,BSESN,2008-07-03,13094.110352,13458.299805,12934.919922,13458.299805,29200.0,-570.5097649999989,570.5097649999989,0.0,30.313592299437843,12822.75,15789.620117,9.146350911862303,-90.8536490881377,-734.0205772864556,-612.9215315221255,-0.10137604035375958,3105100.0
1238,BSESN,2008-07-04,13454.0,13508.379883,13031.429688,13097.009766,31400.0,359.8896480000003,0.0,359.8896480000003,38.76504116017732,12822.75,15789.620117,21.27663076259971,-78.72336923740029,-722.519912290918,-634.8412076758841,-0.0587211574791775,3136500.0
1239,BSESN,2008-07-07,13525.990234,13793.389647999997,13476.290038999998,13561.919922,21200.0,71.99023400000078,0.0,71.99023400000078,40.43246070496685,12822.75,15789.620117,23.703101459361953,-76.29689854063805,-699.5327639292773,-647.7795189265628,-0.041157377676922735,3157700.0
1240,BSESN,2008-07-08,13349.650391,13451.669922,13049.959961,13226.040039,25400.0,-176.33984300000157,176.33984300000157,0.0,37.54310866727073,12822.75,15259.360352000003,21.62431882338151,-78.37568117661849,-687.6180025299345,-655.7472156472372,-0.061210662313270214,3132300.0
1241,BSESN,2008-07-09,13964.259766,13998.480469,13581.410156,13581.410156,27600.0,614.609375,0.0,614.609375,51.48553030436368,12822.75,15194.730469,48.12475401541762,-51.875245984582385,-621.4183048235573,-648.8814334825013,-0.03172696213580961,3159900.0
1242,BSESN,2008-07-10,13926.240234,14046.589844,13763.94043,13851.589844,26400.0,-38.019531999998435,38.019531999998435,0.0,50.678047623723174,12822.75,14509.69043,65.41370485737902,-34.58629514262099,-565.5036518533343,-632.205877156668,0.008985547937437,3133500.0
1243,BSESN,2008-07-11,13469.849609,14063.450195,13351.339844,14063.450195,29000.0,-456.390625,456.390625,0.0,41.633808763710164,12822.75,14449.80957,39.771107397131196,-60.22889260286881,-551.6586185934357,-616.0964254440215,0.0006128543590380175,3104500.0
1244,BSESN,2008-07-14,13330.509766,13557.209961000002,13270.400391,13333.030273,23600.0,-139.33984300000157,139.33984300000157,0.0,39.171146048019345,12822.75,14449.80957,31.20720195880716,-68.79279804119284,-545.640091479916,-602.0051586512004,0.028455422975886657,3080900.0
1245,BSESN,2008-07-15,12676.19043,13067.080078,12607.620117,13067.080078,30000.0,-654.3193359999988,654.3193359999988,0.0,29.663988668866722,12607.620117,14449.80957,3.7222183032441998,-96.27778169675581,-586.903014801459,-598.9847298812522,-0.07233495542040758,3050900.0
1246,BSESN,2008-07-16,12575.799805,12935.25,12514.990234,12759.759766,31200.0,-100.390625,100.390625,0.0,28.441922654747003,12514.990234,14127.759766,3.7705059398406244,-96.22949406015937,-620.5515314801451,-603.2980902010307,-0.039583487008022056,3019700.0
1247,BSESN,2008-07-17,13111.849609,13150.349609,12843.790039,12909.570313,33600.0,536.0498040000001,0.0,536.0498040000001,42.92792823775176,12514.990234,14063.450195,38.54535409585579,-61.454645904144215,-597.0807093967214,-602.0546140401689,-0.02543112762003863,3053300.0
1248,BSESN,2008-07-18,13635.400391,13684.269531,13093.339844,13234.530273,36600.0,523.5507819999984,0.0,523.5507819999984,53.52947318026297,12514.990234,14063.450195,72.3564176807281,-27.643582319271903,-530.1228153610282,-587.6682543043407,0.008088883335504393,3089900.0
1249,BSESN,2008-07-21,13850.040038999998,13878.879883,13581.19043,13782.129883,32400.0,214.63964799999852,0.0,214.63964799999852,57.283045949887985,12514.990234,14063.450195,86.21790931796642,-13.782090682033587,-454.4993901038779,-561.0344814642482,0.037483352248486534,3122300.0
1250,BSESN,2008-07-22,14104.200195,14206.129883,13798.179688,13837.639647999997,35600.0,254.1601560000017,0.0,254.1601560000017,61.528743406044846,12514.990234,14206.129883,93.97272200079556,-6.027277999204443,-369.79590328298764,-522.7867658279961,0.010021328115130457,3157900.0
1251,BSESN,2008-07-23,14942.280272999997,14979.900391,14568.219727000003,14568.219727000003,39000.0,838.0800779999989,0.0,838.0800779999989,72.08504260271229,12514.990234,14979.900391,98.4737732572862,-1.5262267427137943,-232.3631834172429,-464.7020493458454,0.07295867527255506,3196900.0
1252,BSESN,2008-07-24,14777.009766,15130.089844,14608.049805,15082.370117,31200.0,-165.27050699999927,165.27050699999927,0.0,67.84885127261055,12514.990234,15130.089844,86.49840806637569,-13.501591933624315,-135.22393412736164,-398.8064263021487,0.09704341139240391,3165700.0
1253,BSESN,2008-07-25,14274.94043,14484.389647999997,14210.629883,14451.950195,27800.0,-502.0693359999986,502.0693359999986,0.0,56.259867438916466,12514.990234,15130.089844,67.29954718627334,-32.700452813726656,-97.62778631189758,-338.57069830409847,0.07084730295977204,3137900.0
1254,BSESN,2008-07-28,14349.110352000003,14421.610352000003,14219.379883,14267.030272999997,21800.0,74.16992200000095,0.0,74.16992200000095,57.497327325588,12514.990234,15130.089844,70.13576503879342,-29.86423496120658,-61.14285864665544,-283.08513037260985,0.13197339778367478,3159700.0
1255,BSESN,2008-07-29,13791.540038999998,14153.120117,13727.139647999997,14085.530272999997,23600.0,-557.5703130000038,557.5703130000038,0.0,46.16783874301582,12514.990234,15130.089844,48.814576703638345,-51.185423296361655,-76.33956013233,-241.73601632455387,0.09667299518529493,3136100.0
1256,BSESN,2008-07-30,14287.209961000002,14322.669922,14002.19043,14007.320313,26000.0,495.66992200000465,0.0,495.66992200000465,55.21887801831028,12514.990234,15130.089844,67.76872744055827,-32.23127255944174,-47.83522067942977,-202.95585719552906,0.08964107940905852,3162100.0
1257,BSESN,2008-07-31,14355.75,14369.419922,14161.759766,14359.480469,27800.0,68.5400389999977,0.0,68.5400389999977,56.38879332828193,12514.990234,15130.089844,70.38966160069137,-29.610338399308635,-19.490048815423506,-166.26269551950796,0.052829369754001876,3189900.0
1258,BSESN,2008-08-01,14656.69043,14682.330078,14032.870117,14064.259766,40200.0,300.94043000000056,0.0,300.94043000000056,61.486310270636714,12514.990234,15130.089844,81.89746148904823,-18.102538510951774,26.946459725497334,-127.6208644705069,0.05824173711617986,3230100.0
1259,BSESN,2008-08-04,14577.870117,14725.94043,14503.509766,14594.639647999997,24800.0,-78.82031300000199,78.82031300000199,0.0,59.388489510523534,12514.990234,15130.089844,78.88341519044471,-21.1165848095553,56.733597178063064,-90.7499721407929,0.033583607397172255,3205300.0
1260,BSESN,2008-08-05,14961.070313,14986.629883,14529.209961000002,14562.679688,35600.0,383.2001960000016,0.0,383.2001960000016,65.91257465853292,12843.790039,15130.089844,92.60728927018388,-7.3927107298161125,109.99323791522511,-50.6013301295893,0.0012575082020083173,3240900.0
1261,BSESN,2008-08-06,15073.540038999998,15422.820313,15035.599609,15263.650391,32600.0,112.46972599999754,0.0,112.46972599999754,67.67137112617053,13093.339844,15422.820313,85.00608703751263,-14.993912962487366,159.43933643106357,-8.593196817458718,0.02006700121984606,3273500.0
1262,BSESN,2008-08-07,15117.25,15280.05957,14992.969727000003,15031.860352000003,25800.0,43.709961000002295,0.0,43.709961000002295,68.40245534588625,13581.19043,15422.820313,83.4076154052068,-16.59238459479321,199.84901920636548,33.09524638730613,0.05900617057776403,3299300.0
1263,BSESN,2008-08-08,15167.820313,15228.820313,14888.120117,15036.570313,21000.0,50.57031300000017,0.0,50.57031300000017,69.32838894173639,13727.139647999997,15422.820313,84.96179114007887,-15.038208859921125,233.26564442112976,73.12932599407087,0.05705649625071585,3320300.0
1264,BSESN,2008-08-11,15503.919922,15520.709961000002,15367.969727000003,15430.30957,26200.0,336.0996089999989,0.0,336.0996089999989,74.95627931823108,13727.139647999997,15520.709961000002,99.0638761760101,-0.9361238239898938,283.59982792077426,115.22342637941155,0.1241616148854805,3346500.0
1265,BSESN,2008-08-12,15212.129883,15579.780272999997,15124.910156,15577.200195,27000.0,-291.79003899999765,291.79003899999765,0.0,63.31804946002587,13727.139647999997,15579.780272999997,80.15533152847725,-19.844668471522752,296.5268366350738,151.484108430544,0.06473761668826628,3319500.0
1266,BSESN,2008-08-13,15093.120117,15272.55957,15013.05957,15030.209961000002,19200.0,-119.00976600000286,119.00976600000286,0.0,59.006449689235744,13727.139647999997,15579.780272999997,73.7315402980545,-26.268459701945503,293.7819551589837,179.94367777623197,0.051364095710777935,3300300.0
1267,BSESN,2008-08-14,14724.179688,15033.280272999997,14686.660156,15017.679688,22000.0,-368.9404289999984,368.9404289999984,0.0,47.44905309869783,13727.139647999997,15579.780272999997,53.81723937960194,-46.182760620398064,258.8523191516888,195.72540605132335,0.004604672406934407,3278300.0
1268,BSESN,2008-08-18,14645.660156,14824.919922,14600.650391,14681.139647999997,19600.0,-78.51953200000025,78.51953200000025,0.0,45.27156686441845,13727.139647999997,15579.780272999997,49.57898988099774,-50.42101011900226,222.2722448650402,201.03477381406674,0.004650201878321436,3258700.0
1269,BSESN,2008-08-19,14543.730469,14604.110352000003,14368.719727000003,14517.759766,17600.0,-101.92968699999984,101.92968699999984,0.0,42.3598246885453,14002.19043,15579.780272999997,34.32704903640793,-65.67295096359207,182.94848234569872,197.41751552039315,-0.027895052644553386,3241100.0
1270,BSESN,2008-08-20,14678.230469,14746.200195,14584.030272999997,14610.570313,18400.0,134.5,0.0,134.5,47.50084376406097,14032.870117,15579.780272999997,41.71931702024466,-58.28068297975534,160.78372843629404,190.09075810357336,-0.026225396886013996,3259500.0
1271,BSESN,2008-08-21,14243.730469,14646.980469,14201.179688,14646.980469,19400.0,-434.5,434.5,0.0,35.64898444477126,14032.870117,15579.780272999997,13.631066496146282,-86.36893350385371,106.92491863905525,173.45759021066976,-0.057782965221849225,3240100.0
1272,BSESN,2008-08-22,14401.490234,14428.519531,14136.860352000003,14153.389647999997,20400.0,157.7597650000007,0.0,157.7597650000007,41.738988231504656,14136.860352000003,15579.780272999997,18.33988692987202,-81.66011307012798,76.09415240316412,153.98490264916865,-0.05052341491303103,3260500.0
1273,BSESN,2008-08-25,14450.349609,14672.69043,14416.200195,14643.370117,17000.0,48.859375,0.0,48.859375,43.64486669409002,14136.860352000003,15579.780272999997,21.726032916832875,-78.27396708316712,54.96943780350193,134.18180968003531,-0.0679550925379192,3277500.0
1274,BSESN,2008-08-26,14482.219727000003,14495.269531,14286.379883,14338.269531,18800.0,31.87011800000073,0.0,31.87011800000073,44.999030481653406,14136.860352000003,15579.780272999997,23.934756875534298,-76.0652431244657,40.334648737625685,115.41237749155339,-0.04798211437937383,3296300.0
1275,BSESN,2008-08-27,14296.790038999998,14563.099609,14261.69043,14563.099609,15600.0,-185.4296880000038,185.4296880000038,0.0,38.74826161200289,14136.860352000003,15579.780272999997,11.083753482948492,-88.9162465170515,13.616879928324124,95.05327797890753,-0.052761130357868335,3280700.0
1276,BSESN,2008-08-28,14048.339844,14347.19043,14002.429688,14289.969727000003,18800.0,-248.4501949999976,248.4501949999976,0.0,31.898070623761114,14002.429688,15579.780272999997,2.9105866784840364,-97.08941332151596,-27.290411816040432,70.58454001991794,-0.045899999750125264,3261900.0
1277,BSESN,2008-08-29,14564.530272999997,14586.160156,14279.019531,14279.019531,32400.0,516.1904289999984,0.0,516.1904289999984,52.16915635853222,14002.429688,15579.780272999997,35.63574200595347,-64.36425799404654,-17.851698341499286,52.89729234763449,-0.005539516971979297,3294300.0
1278,BSESN,2008-09-01,14498.509766,14547.410156,14281.099609,14412.990234,14800.0,-66.02050699999927,66.02050699999927,0.0,49.973936759207966,14002.429688,15579.780272999997,31.45021041723582,-68.54978958276418,-15.519849900290865,39.213863898049425,-0.0031092918764129562,3279500.0
1279,BSESN,2008-09-02,15049.860352000003,15106.150391,14543.209961000002,14609.44043,25700.0,551.3505860000023,0.0,551.3505860000023,64.40622279470055,14002.429688,15272.55957,82.46642165056973,-17.53357834943027,30.46634419923612,37.464359958286764,0.025318439016533745,3305200.0
1280,BSESN,2008-09-04,14899.099609,14994.150391,14766.009766,14895.849609,19800.0,-150.76074300000073,150.76074300000073,0.0,59.03291902021411,14002.429688,15106.150391,81.24065432158532,-18.75934567841468,54.12172082764664,40.79583213215874,0.04601106019426182,3285400.0
1281,BSESN,2008-09-05,14483.830078,14601.389647999997,14438.589844,14569.009766,23200.0,-415.26953099999986,415.26953099999986,0.0,46.660544203085855,14002.429688,15106.150391,43.616142081191086,-56.383857918808914,38.91144966383945,40.418955638494886,0.005717453031742981,3262200.0
1282,BSESN,2008-09-08,14944.969727000003,15107.009766,14917.05957,15038.05957,23400.0,461.13964900000076,0.0,461.13964900000076,57.95209261491556,14002.429688,15107.009766,85.33016824878892,-14.66983175121107,63.337204089184524,45.00260532863282,0.03422893780313396,3285600.0
1283,BSESN,2008-09-09,14900.759766,14998.320313,14714.919922,14814.330078,19800.0,-44.209961000002295,44.209961000002295,0.0,56.626052144390876,14002.429688,15107.009766,81.32774580060821,-18.672254199391798,78.22567913936655,51.64722009077956,0.028900268528565976,3265800.0
1284,BSESN,2008-09-10,14662.610352000003,14866.320313,14609.830078,14717.530272999997,22800.0,-238.14941399999768,238.14941399999768,0.0,49.575373182718295,14002.429688,15107.009766,59.76756933687915,-40.23243066312085,70.00130401185197,55.31803687499405,0.025587583786436774,3243000.0
1285,BSESN,2008-09-11,14324.290038999998,14557.330078,14265.379883,14557.330078,22800.0,-338.3203130000038,338.3203130000038,0.0,41.172169805617806,14002.429688,15107.009766,29.138706863405677,-70.86129313659431,35.77145460981774,51.40872042195878,0.019642904290776864,3220200.0
1286,BSESN,2008-09-12,14000.80957,14433.200195,13933.870117,14433.200195,26800.0,-323.48046899999827,323.48046899999827,0.0,34.68584039332903,13933.870117,15107.009766,5.706008918636345,-94.29399108136366,-17.259165150862827,37.675143307394464,-0.038705038366052436,3193400.0
1287,BSESN,2008-09-15,13531.269531,13592.049805,13150.80957,13592.049805,24000.0,-469.54003899999947,469.54003899999947,0.0,27.444446172728817,13150.80957,15107.009766,19.44892765975372,-80.55107234024628,-96.06687132061597,10.926740381792369,-0.06671307952409311,3169400.0
1288,BSESN,2008-09-16,13518.799805,13556.030272999997,13051.730469,13051.730469,33600.0,-12.469725999999357,12.469725999999357,0.0,27.269989683231174,13051.730469,15107.009766,22.72534621848043,-77.27465378151956,-157.71075747275063,-22.800759189116242,-0.10173254177714264,3135800.0
1289,BSESN,2008-09-17,13262.900391,13620.740234,13127.959961,13620.740234,30400.0,-255.8994140000013,255.8994140000013,0.0,23.70232596503581,13051.730469,15107.009766,10.274512194436765,-89.72548780556323,-224.6236043500885,-63.16532822131071,-0.10981866427764764,3105400.0
1290,BSESN,2008-09-18,13315.599609,13346.790039,12558.139648,12712.820313,48000.0,52.69921800000157,0.0,52.69921800000157,26.002695586954218,12558.139648,15107.009766,29.717479743312715,-70.28252025668729,-270.28446010469816,-104.58915459798821,-0.0806575652095275,3153400.0
1291,BSESN,2008-09-19,14042.320313,14097.44043,13674.959961000002,13763.830078,47400.0,726.7207039999994,0.0,726.7207039999994,49.992725135439855,12558.139648,15107.009766,58.22896406210685,-41.771035937893146,-245.0064480821893,-132.67261329482844,-0.0603982095975244,3200800.0
1292,BSESN,2008-09-22,13994.959961000002,14215.330078,13917.480469,14215.330078,35800.0,-47.36035199999787,47.36035199999787,0.0,48.80297309398125,12558.139648,15107.009766,56.37087205241434,-43.62912794758565,-226.18767531147932,-151.37562569815861,-0.060788833537657405,3165000.0
1293,BSESN,2008-09-23,13570.30957,13978.259766,13543.469727000003,13721.419922,29600.0,-424.6503910000029,424.6503910000029,0.0,39.160964029776785,12558.139648,15107.009766,39.71053349686606,-60.28946650313394,-242.7412301115055,-169.648746580828,-0.07449565635159994,3135400.0
1294,BSESN,2008-09-24,13692.519531,13840.80957,13592.790038999998,13636.709961000002,40200.0,122.20996100000048,0.0,122.20996100000048,42.90663705997584,12558.139648,15107.009766,44.505205462964284,-55.494794537035716,-243.19531484529944,-184.3580602337223,-0.04410483914245722,3175600.0
1295,BSESN,2008-09-25,13547.179688,13716.879883,13430.679688,13716.879883,36600.0,-145.33984299999975,145.33984299999975,0.0,39.564110021610745,12558.139648,15107.009766,38.803077215094106,-61.196922784905894,-252.37368420829625,-197.96118502863712,-0.03240026083720238,3139000.0
1296,BSESN,2008-09-26,13102.179688,13486.200195,13054.419922,13486.200195,29000.0,-445.0,445.0,0.0,31.025418381151383,12558.139648,14998.320313,22.29507215606103,-77.70492784393896,-292.1872364532828,-216.80639531356627,-0.031710981886581946,3110000.0
1297,BSESN,2008-09-29,12595.75,13109.959961,12402.839844,13109.959961,37000.0,-506.42968800000017,506.42968800000017,0.0,24.174430076209333,12402.839844,14866.320313,7.830797054311857,-92.16920294568814,-360.4493708850732,-245.5349904278677,-0.06827897581992493,3073000.0
1298,BSESN,2008-09-30,12860.429688,12995.200195,12153.549805,12178.179688,38400.0,264.67968800000017,0.0,264.67968800000017,33.08505328500577,12153.549805,14557.330078,29.407009073994487,-70.59299092600551,-388.70936581727256,-274.1698655057487,-0.030345602480216893,3111400.0
1299,BSESN,2008-10-01,13055.669922,13203.860352,12697.299805,13006.719727,32400.0,195.24023399999896,0.0,195.24023399999896,39.169363759899035,12153.549805,14433.200195,39.572739791911644,-60.42726020808835,-390.8459316038443,-297.5050787253678,-0.019520689614631825,3143800.0
1300,BSESN,2008-10-03,12526.320313,13001.19043,12472.610352,12851.469727,37200.0,-529.349608999999,529.349608999999,0.0,30.494993434515308,12153.549805,14215.330078,18.080030781243174,-81.91996921875683,-430.2931137032501,-324.0626857209443,-0.10795936613100388,3106600.0
1301,BSESN,2008-10-06,11801.700195,12284.490234,11732.969727,12284.490234,33000.0,-724.6201180000007,724.6201180000007,0.0,22.592401770061954,11732.969727,14215.330078,2.7687546641772682,-97.23124533582273,-514.099854234657,-362.07011942368683,-0.15671783071277068,3073600.0
1302,BSESN,2008-10-07,11695.240234,12181.080078,11501.849609,12068.110352,40400.0,-106.45996099999867,106.45996099999867,0.0,21.64167506703403,11501.849609,14215.330078,7.127032134904966,-92.87296786509503,-582.3942506369312,-406.1349456663358,-0.13817439656242114,3033200.0
1303,BSESN,2008-10-08,11328.360352,11405.730469,10740.759766,11316.240234,66200.0,-366.87988200000115,366.87988200000115,0.0,18.53943571545706,10740.759766,14215.330078,16.911460504069378,-83.08853949593062,-658.5310560616508,-456.61416774539884,-0.1726606395300383,2967000.0
1304,BSESN,2008-10-10,10527.849609,10904.129883,10239.759766,10632.269531,62400.0,-800.5107429999989,800.5107429999989,0.0,13.623016672703287,10239.759766,14215.330078,7.246503530082742,-92.75349646991727,-774.536178772627,-520.1985699508444,-0.222875177604273,2904600.0
1305,BSESN,2008-10-13,11309.089844,11361.320313,10817.679688,10817.679688,43800.0,781.2402349999992,0.0,781.2402349999992,33.48551796106291,10239.759766,14215.330078,26.89752649506153,-73.10247350493847,-794.2756017083175,-575.0139763023391,-0.13685431635793022,2948400.0
1306,BSESN,2008-10-14,11483.400391,11870.219727,11410.490234,11781.429688,36000.0,174.31054699999913,0.0,174.31054699999913,37.203104204884724,10239.759766,13978.259766,33.26576501270563,-66.73423498729437,-786.7842728891756,-617.3680356197065,-0.08831150261000742,2984400.0
1307,BSESN,2008-10-15,10809.120117,11257.150391,10760.330078,11245.269531,34800.0,-674.2802739999988,674.2802739999988,0.0,29.775228366045354,10239.759766,13840.80957,15.810954637938163,-84.18904536206183,-825.7375354395444,-659.0419355836741,-0.15950552359180237,2949600.0
1308,BSESN,2008-10-16,10581.490234,10787.200195,10017.799805,10221.530273,51600.0,-227.62988299999958,227.62988299999958,0.0,27.6266536197505,10017.799805,13716.879883,15.238665211724037,-84.76133478827596,-865.0048681563349,-700.2345220982063,-0.18950997557243532,2898000.0
1309,BSESN,2008-10-17,9975.349609,10786.929688,9911.320313,10763.339844,47400.0,-606.140625,606.140625,0.0,22.61308271705532,9911.320313,13486.200195,1.7910894383443965,-98.2089105616556,-934.2653653771085,-747.0406907539868,-0.2036488482058505,2850600.0
1310,BSESN,2008-10-20,10223.089844,10538.049805,10023.280273,10160.469727,35400.0,247.7402349999993,0.0,247.7402349999993,28.713987675284756,9911.320313,13203.860352,9.46896703782195,-90.53103296217805,-958.119635161167,-789.2564796354229,-0.13376126531911103,2886000.0
1311,BSESN,2008-10-21,10683.389648,10750.200195,10250.230469,10428.110352,45800.0,460.29980400000017,0.0,460.29980400000017,39.020317220825106,9911.320313,13203.860352,23.44904924024829,-76.55095075975171,-929.1710629046775,-817.2393962892739,-0.08651815317639933,2931800.0
1312,BSESN,2008-10-22,10169.900391,10484.849609,10128.219727,10455.230469,33400.0,-513.4892570000011,513.4892570000011,0.0,32.89809686182298,9911.320313,13203.860352,7.853513546900837,-92.14648645309916,-936.8638195253207,-841.1642809364835,-0.10226192714601245,2898400.0
1313,BSESN,2008-10-23,9771.700195,10260.549805,9682.400391,9683.259766,41000.0,-398.20019599999983,398.20019599999983,0.0,28.848110598359455,9682.400391,13001.19043,2.690733759912921,-97.30926624008708,-963.9796550825195,-865.7273557656908,-0.07182372868943598,2857400.0
1314,BSESN,2008-10-24,8701.070313,9570.709961,8566.820313,9497.480469,63600.0,-1070.6298819999993,1070.6298819999993,0.0,20.87543481587109,8566.820313,12284.490234,3.6111328561382514,-96.38886714386175,-1059.6451048087274,-904.5109055742981,-0.2306126812126863,2793800.0
1315,BSESN,2008-10-27,8509.55957,8739.480469,7697.390137,8588.860352,55400.0,-191.51074300000076,191.51074300000076,0.0,19.748932615720307,7697.390137,12181.080078,18.113862548195304,-81.8861374518047,-1137.7981505622101,-951.1683545718806,-0.25896866082721615,2738400.0
1316,BSESN,2008-10-29,9044.509766,9297.759766,8894.339844,9297.759766,55000.0,534.9501959999999,0.0,534.9501959999999,31.638736976187644,7697.390137,11870.219727,32.283121079957624,-67.71687892004238,-1143.3887189153684,-989.6124274405781,-0.16325198831167742,2793400.0
1317,BSESN,2008-10-31,9788.05957,9870.419922,9361.660156,9361.660156,57200.0,743.5498040000003,0.0,743.5498040000003,44.763577942629226,7697.390137,11870.219727,50.101960502058255,-49.898039497941745,-1075.424208685903,-1006.7747836896433,-0.07498288487292493,2850600.0
1318,BSESN,2008-11-03,10337.679688,10373.169922,10112.660156,10209.370117,44800.0,549.6201180000007,0.0,549.6201180000007,52.53588305999257,7697.390137,11870.219727,63.27336149377718,-36.72663850622282,-966.0757743501563,-998.6349818217459,0.036322544392138,2895400.0
1319,BSESN,2008-11-04,10631.120117,10668.480469,10116.219727,10304.570313,51000.0,293.44042900000017,0.0,293.44042900000017,56.32198601618268,7697.390137,11870.219727,70.30553049735254,-29.69446950264747,-845.9861602426608,-968.1052175059289,0.039912617342346524,2946400.0
1320,BSESN,2008-11-05,10120.009766,10945.410156,10051.519531,10931.169922,53400.0,-511.11035100000123,511.11035100000123,0.0,48.54032468912874,7697.390137,11257.150391,68.05569634297062,-31.944303657029383,-783.0303235118008,-931.0902387071034,-0.05273418835804322,2893000.0
1321,BSESN,2008-11-06,9734.219727,10109.450195,9635.219727,9755.030273,49400.0,-385.79003899999947,385.79003899999947,0.0,43.3267594377942,7697.390137,10945.410156,62.7098841166348,-37.290115883365196,-755.5578012809347,-895.9837512218696,-0.042840209564447784,2843600.0
1322,BSESN,2008-11-07,9964.290039,10065.370117,9631.589844,9631.589844,42000.0,230.07031199999986,0.0,230.07031199999986,47.22708365341154,7697.390137,10945.410156,69.79328602469428,-30.20671397530572,-707.0702128062567,-858.201043538747,0.019708939095219646,2885600.0
1323,BSESN,2008-11-10,10536.160156,10570.580078,10095.900391,10154.55957,45400.0,571.8701170000004,0.0,571.8701170000004,55.9264132724948,7697.390137,10945.410156,87.40001608345999,-12.599983916540019,-615.4043126416946,-809.6416973593365,0.2109039206657426,2931000.0
1324,BSESN,2008-11-11,9839.69043,10397.360352,9800.669922,10386.450195,63600.0,-696.4697259999994,696.4697259999994,0.0,45.40781157269106,7697.390137,10945.410156,65.9571148105045,-34.042885189495486,-592.1319836735402,-766.1397546221773,0.1563101884484488,2867400.0
1325,BSESN,2008-11-12,9536.330078,9928.599609,9376.730469,9683.75,52400.0,-303.3603519999997,303.3603519999997,0.0,41.48632699138451,7697.390137,10945.410156,56.61726006129031,-43.3827399387097,-591.3504208674531,-731.1818878712326,0.0543777744426619,2815000.0
1326,BSESN,2008-11-14,9385.419922,9826.25,9267.490234,9784.849609,46200.0,-150.9101560000017,150.9101560000017,0.0,39.526937981885204,7697.390137,10945.410156,51.971040052878415,-48.028959947121585,-596.0374662032282,-704.1530035376318,-0.04113579868619455,2768800.0
1327,BSESN,2008-11-17,9291.009766,9424.25,8956.679688,9396.929688,41800.0,-94.41015599999993,94.41015599999993,0.0,38.22377883958319,7697.390137,10945.410156,49.064341342657194,-50.935658657342806,-600.4484974582829,-683.4121023217621,-0.10124805116712776,2727000.0
1328,BSESN,2008-11-18,8937.200195,9169.049805,8871.709961,9084.120117,41000.0,-353.80957099999983,353.80957099999983,0.0,33.45445309399621,7697.390137,10945.410156,38.17125666552116,-61.82874333447883,-625.2858410289609,-671.7868500632019,-0.1593359780867577,2686000.0
1329,BSESN,2008-11-19,8773.780273,9236.269531,8726.799805,8970.669922,42600.0,-163.41992199999913,163.41992199999913,0.0,31.368518427336085,8726.799805,10945.410156,2.1175628239011925,-97.8824371760988,-650.6558807264537,-667.5606561958523,-0.13302650136988015,2643400.0
1330,BSESN,2008-11-20,8451.009766,8540.459961,8316.389648,8400.879883,40000.0,-322.7705070000011,322.7705070000011,0.0,27.46573269510347,8316.389648,10945.410156,5.120542711262827,-94.87945728873719,-688.8658852560966,-671.8217020079012,-0.13182463484368812,2603400.0
1331,BSESN,2008-11-21,8915.209961,8988.030273,8442.30957,8481.019531,59200.0,464.2001950000012,0.0,464.2001950000012,39.878530230437946,8316.389648,10945.410156,22.777316159300202,-77.2226838406998,-673.9219600271153,-672.2417536117441,-0.10528397646936449,2662600.0
1332,BSESN,2008-11-24,8903.120117,9042.019531,8701.929688,8840.530273,43800.0,-12.089844000000086,12.089844000000086,0.0,39.67449688216628,8316.389648,10945.410156,22.317455007087382,-77.68254499291261,-655.4981661636466,-668.8930361221246,-0.1549938511583877,2618800.0
1333,BSESN,2008-11-25,8695.530273,9182.799805,8649.400391,9170.280273,41600.0,-207.58984400000008,207.58984400000008,0.0,36.02296740809473,8316.389648,10945.410156,14.421364300745884,-85.57863569925411,-650.1533788556408,-665.1451046688279,-0.11628009693390329,2577200.0
1334,BSESN,2008-11-26,9026.719727,9061.719727,8658.530273,8806.019531,44600.0,331.1894539999994,0.0,331.1894539999994,45.29196559377531,8316.389648,10570.580078,31.51153822439035,-68.48846177560965,-612.1370405732378,-654.5434918497099,-0.05343883305545971,2621800.0
1335,BSESN,2008-11-28,9092.719727,9157.620117,8889.179688,8889.179688,34000.0,66.0,0.0,66.0,47.05573958290083,8316.389648,10570.580078,34.43941863421003,-65.56058136578997,-570.1112821973002,-637.657049919228,-0.031186691424844204,2655800.0
1336,BSESN,2008-12-01,8839.870117,9326.679688,8803.339844,9162.94043,45200.0,-252.8496099999993,252.8496099999993,0.0,41.186131745520846,8316.389648,10570.580078,23.222548638004817,-76.77745136199519,-550.8584628178942,-620.2973324989613,-0.04855657892546006,2610600.0
1337,BSESN,2008-12-02,8739.240234,8785.040039,8467.429688,8535.830078,41000.0,-100.6298829999996,100.6298829999996,0.0,38.954771312574024,8316.389648,10397.360352,20.319872124446814,-79.68012787555318,-537.524210804766,-603.7427081601222,-0.022150109282630726,2569600.0
1338,BSESN,2008-12-03,8747.429688,8854.80957,8601.410156,8851.219727,52400.0,8.189453999999387,0.0,8.189453999999387,39.26375995277592,8316.389648,9928.599609,26.73597424820772,-73.26402575179229,-520.2982254519757,-587.0538116184929,-0.003003333133505759,2622000.0
1339,BSESN,2008-12-04,9229.75,9245.05957,8726.709961,8779.019531,55200.0,482.32031199999983,0.0,482.32031199999983,54.80830270172953,8316.389648,9826.25,60.49303505388026,-39.50696494611974,-462.39706417042,-562.1224621288783,0.09214759603438383,2677200.0
1340,BSESN,2008-12-05,8965.200195,9340.69043,8914.379883,9172.580078,53000.0,-264.54980500000056,264.54980500000056,0.0,47.16820066437271,8316.389648,9424.25,58.564289788754834,-41.435710211245166,-432.8671124065768,-536.271392184418,0.005607297440967107,2624200.0
1341,BSESN,2008-12-08,9162.620117,9432.110352,9095.700195,9276.889648,50200.0,197.41992200000092,0.0,197.41992200000092,52.82994931931906,8316.389648,9432.110352,75.8460845950207,-24.153915404979294,-389.049554000072,-506.82702454754883,0.02914708513305353,2674400.0
1342,BSESN,2008-12-10,9654.900391,9678.700195,9280.160156,9349.530273,65000.0,492.28027399999877,0.0,492.28027399999877,63.946537704153926,8316.389648,9678.700195,98.25298247507436,-1.747017524925632,-311.0157236587929,-467.66476436979775,0.11032911023021619,2739400.0
1343,BSESN,2008-12-11,9645.459961,9746.009766,9441.969727,9679.320313,68800.0,-9.440429999998742,9.440429999998742,0.0,63.61480321945041,8316.389648,9746.009766,92.96667669026193,-7.033323309738064,-247.0868512984307,-423.54918175552433,0.06854541325231067,2670600.0
1344,BSESN,2008-12-12,9690.070313,9745.509766,9281.889648,9370.870117,6400.0,44.610351999999686,0.0,44.610351999999686,64.61567015014575,8442.30957,9746.009766,95.70917813991039,-4.290821860089608,-190.6256628075662,-376.96447796593276,0.06569547989324054,2677000.0
1345,BSESN,2008-12-15,9832.389648,9948.330078,9749.290039,9821.849609,47000.0,142.31933500000014,0.0,142.31933500000014,67.8691627066161,8467.429688,9948.330078,92.17095013392492,-7.829049866075091,-132.86420734825515,-328.14442384239726,0.11227761470061415,2724000.0
1346,BSESN,2008-12-16,9976.980469,10009.209961,9790.30957,9794.480469,41000.0,144.59082099999978,0.0,144.59082099999978,70.99545528738894,8467.429688,10009.209961,97.90959240013571,-2.0904075998642893,-74.56107324938603,-277.42775372379504,0.1416301877346926,2765000.0
1347,BSESN,2008-12-17,9715.290039,10073.099609,9682.910156,10073.099609,75800.0,-261.69043000000056,261.69043000000056,0.0,59.00601552337291,8467.429688,10073.099609,77.71587015984208,-22.28412984015792,-48.90787059928152,-231.72377709889233,0.11064511353863637,2689200.0
1348,BSESN,2008-12-18,10076.429688,10110.339844,9633.040039,9710.200195,69200.0,361.13964900000076,0.0,361.13964900000076,67.69349129338596,8467.429688,10110.339844,97.93597015173604,-2.0640298482639556,0.5570079852641356,-185.26762008206103,0.09173376180286574,2758400.0
1349,BSESN,2008-12-19,10099.910156,10188.540039,9987.419922,10001.330078,59600.0,23.480467999999746,0.0,23.480467999999746,68.19907458856746,8467.429688,10188.540039,94.85042414924158,-5.1495758507584295,41.17828058586019,-139.9784399484768,0.12656827915932567,2818000.0
1350,BSESN,2008-12-22,9928.349609,10173.339844,9895.549805,10102.419922,39000.0,-171.56054699999913,171.56054699999913,0.0,60.24997173187941,8467.429688,10188.540039,84.88240862366419,-15.1175913763358,58.84905416654692,-100.21294112547204,0.0835710181391558,2779000.0
1351,BSESN,2008-12-23,9686.75,9838.379883,9643.55957,9813.200195,52600.0,-241.5996090000008,241.5996090000008,0.0,50.65602219221926,8601.410156,10188.540039,68.38380750216146,-31.61619249783854,52.75012956831961,-69.62032698671372,0.003298802443336468,2726400.0
1352,BSESN,2008-12-24,9568.719727,9653.419922,9502.530273,9626.070313,68800.0,-118.0302730000003,118.0302730000003,0.0,46.48362483984567,8726.709961,10188.540039,57.599701817053436,-42.40029818294656,37.95510840938368,-48.10523990749424,-0.00795609896368743,2657600.0
1353,BSESN,2008-12-26,9328.919922,9706.379883,9294.980469,9655.070313,43000.0,-239.79980500000056,239.79980500000056,0.0,38.96073010161115,8914.379883,10188.540039,32.53437466616242,-67.4656253338376,6.801701593587495,-37.12385160727789,-0.03727015174652437,2614600.0
1354,BSESN,2008-12-29,9533.519531,9550.400391,9162.660156,9318.860352,65800.0,204.5996090000008,0.0,204.5996090000008,47.349384973894495,9095.700195,10188.540039,40.062534176782854,-59.93746582321714,-1.3624141577456612,-29.971564117371447,-0.030396488310529213,2680400.0
1355,BSESN,2008-12-30,9716.160156,9785.040039,9494.700195,9625.129883,56600.0,182.640625,0.0,182.640625,53.87813905984142,9162.660156,10188.540039,53.95368494617417,-46.04631505382583,6.826347451979018,-22.611981803501354,-0.026142209440061404,2737000.0
1356,BSESN,2008-12-31,9647.30957,9825.900391,9587.919922,9806.639648,63800.0,-68.85058600000048,68.85058600000048,0.0,51.12084521862636,9162.660156,10188.540039,47.24231579458701,-52.75768420541299,7.671896297753847,-16.555206183250313,-0.006997266033963667,2673200.0
1357,BSESN,2009-01-02,9958.219727,10070.280273,9863.860352,9973.05957,51600.0,310.91015700000025,0.0,310.91015700000025,61.410761629144794,9162.660156,10188.540039,77.54899810234413,-22.45100189765588,33.04888417067923,-6.634388112464401,-0.011731333881163875,2724800.0
1358,BSESN,2009-01-05,10275.599609,10306.169922,10069.110352,10124.919922,51200.0,317.3798820000011,0.0,317.3798820000011,69.07812959484488,9162.660156,10306.169922,97.32662423103447,-2.6733757689655246,77.87256743100079,10.26700299622864,0.01739515008414516,2776000.0
1359,BSESN,2009-01-06,10335.929688,10392.120117,10150.679688,10241.509766,55600.0,60.33007899999939,0.0,60.33007899999939,70.36941639289239,9162.660156,10392.120117,95.42966580592858,-4.570334194071425,116.91605700041328,31.59681379706558,0.04105214814660929,2831600.0
1360,BSESN,2009-01-07,9586.879883,10469.719727,9510.150391,10424.959961,217600.0,-749.0498050000006,749.0498050000006,0.0,44.02908163075815,9162.660156,10469.719727,32.45603616026769,-67.54396383973231,86.42004806476507,42.56146065060548,-0.010309971559088527,2614000.0
1361,BSESN,2009-01-09,9406.469727,9630.400391,9250.820313,9434.849609,158200.0,-180.41015599999992,180.41015599999992,0.0,39.88053037832002,9162.660156,10469.719727,18.653286843955165,-81.34671315604484,47.150626362306866,43.47929379294576,-0.0169562913983341,2455800.0
1362,BSESN,2009-01-12,9110.049805,9327.299805,9024.450195,9306.740234,98000.0,-296.4199219999992,296.4199219999992,0.0,33.83638261049413,9024.450195,10469.719727,5.922743689306605,-94.07725631069339,-7.799377311839635,33.22355957198868,-0.02346146379537961,2357800.0
1363,BSESN,2009-01-13,9071.360352,9261.0,8992.919922,9042.360352,45200.0,-38.68945300000087,38.68945300000087,0.0,33.081307895964756,8992.919922,10469.719727,5.311514108711609,-94.6884858912884,-53.84883083076602,15.809081491437734,-0.04847728873866619,2312600.0
1364,BSESN,2009-01-14,9370.490234,9412.969727,9071.360352,9223.160156,32000.0,299.1298820000011,0.0,299.1298820000011,44.1914978305656,8992.919922,10469.719727,25.56679048315567,-74.43320951684433,-65.45158780621205,-0.4430523680922265,-0.03557680363950555,2344600.0
1365,BSESN,2009-01-15,9046.740234,9123.780273,8946.620117,9000.620117,37600.0,-323.75,323.75,0.0,36.60252541494126,8946.620117,10469.719727,6.573445120900559,-93.42655487909944,-99.62239070371288,-20.278920035216363,-0.062252520419534774,2307000.0
1366,BSESN,2009-01-16,9323.589844,9342.469727,9125.650391,9125.650391,35400.0,276.8496099999993,0.0,276.8496099999993,45.78836403816166,8946.620117,10469.719727,24.750168966296293,-75.24983103370371,-103.1742202022815,-36.8579800686294,-0.06372925084985925,2342400.0
1367,BSESN,2009-01-19,9329.570313,9409.509766,9273.469727,9365.040039,30000.0,5.980469000000085,0.0,5.980469000000085,45.98344414159302,8946.620117,10469.719727,25.14282017313365,-74.85717982686634,-104.30414356210349,-50.34721276732423,-0.09206560512258677,2372400.0
1368,BSESN,2009-01-20,9100.549805,9159.759766,9033.549805,9159.759766,31200.0,-229.02050799999958,229.02050799999958,0.0,39.67497275050722,8946.620117,10469.719727,10.106344128077103,-89.89365587192289,-122.27020217663994,-64.73181064918738,-0.11952286057385564,2341200.0
1369,BSESN,2009-01-21,8779.169922,9051.30957,8734.929688,8900.780273,32400.0,-321.37988300000137,321.37988300000137,0.0,32.46368699920433,8734.929688,10469.719727,2.5501780045670976,-97.4498219954329,-160.58992307205517,-83.90343313376094,-0.08425159914982117,2308800.0
1370,BSESN,2009-01-22,8813.839844,8927.69043,8699.320313,8905.969727,39200.0,34.66992200000095,0.0,34.66992200000095,33.95785463005609,8699.320313,10469.719727,6.468570317771238,-93.53142968222876,-186.01672004627653,-104.32609051626409,-0.06300236966679817,2348000.0
1371,BSESN,2009-01-23,8674.349609,8858.839844,8631.599609,8804.150391,44000.0,-139.4902349999993,139.4902349999993,0.0,30.79498810399872,8631.599609,10469.719727,2.325745721477383,-97.67425427852262,-214.9455772192814,-126.44998785686758,-0.04782632426014488,2304000.0
1372,BSESN,2009-01-27,9004.080078,9021.969727,8791.580078,8803.070313,34200.0,329.73046900000014,0.0,329.73046900000014,44.814394190197376,8631.599609,10469.719727,20.264207183874603,-79.7357928161254,-208.85782873409698,-142.9315560323135,-0.007416778894156151,2338200.0
1373,BSESN,2009-01-28,9257.469727,9270.75,9053.799805,9077.650391,39800.0,253.38964899999885,0.0,253.38964899999885,53.21771911804149,8631.599609,10469.719727,34.049467816117954,-65.95053218388205,-181.49465973021506,-150.64417677189383,-0.01206132274594518,2378000.0
1374,BSESN,2009-01-29,9236.280273,9379.679688,9164.959961,9340.589844,38800.0,-21.189453999999387,21.189453999999387,0.0,52.44712475208399,8631.599609,9630.400391,60.54066785862814,-39.45933214137187,-159.67829106073077,-152.45099962966123,0.02095119723761485,2339200.0
1375,BSESN,2009-01-30,9424.240234,9438.30957,9088.150391,9111.120117,48000.0,187.95996100000045,0.0,187.95996100000045,58.58503283740582,8631.599609,9438.30957,98.25596104174068,-1.7440389582593343,-125.77204189733857,-147.1152080831967,0.010795239997045902,2387200.0
1376,BSESN,2009-02-02,9066.700195,9363.580078,9048.969727,9363.580078,39800.0,-357.5400390000013,357.5400390000013,0.0,45.65176164888287,8631.599609,9438.30957,53.93519443600863,-46.06480556399137,-126.29572965938314,-142.951312398434,-0.028176015527072273,2347400.0
1377,BSESN,2009-02-03,9149.299805,9302.25,9040.55957,9128.990234,46000.0,82.59961000000112,0.0,82.59961000000112,48.672236788019184,8631.599609,9438.30957,64.17426597264995,-35.82573402735005,-118.67761608652108,-138.09657313605143,0.005356819208133468,2393400.0
1378,BSESN,2009-02-04,9201.849609,9338.209961,9164.160156,9226.200195,41600.0,52.54980400000022,0.0,52.54980400000022,50.68418598666353,8631.599609,9438.30957,70.68835486958875,-29.311645130411257,-107.16454996434368,-131.91016850170988,0.04814574621010537,2435000.0
1379,BSESN,2009-02-05,9090.879883,9247.089844,9017.080078,9241.55957,29600.0,-110.96972600000116,110.96972600000116,0.0,46.26540608253511,8631.599609,9438.30957,56.932515551273774,-43.067484448726226,-105.77537886617938,-126.68321057460378,0.031432388596054794,2405400.0
1380,BSESN,2009-02-06,9300.860352,9321.379883,9160.830078,9161.490234,28400.0,209.98046900000008,0.0,209.98046900000008,54.85814456572836,8631.599609,9438.30957,82.96175519766516,-17.038244802334848,-86.73100080504264,-118.69276862069155,0.0722256735363731,2433800.0
1381,BSESN,2009-02-09,9583.889648,9601.55957,9329.299805,9359.0,20000.0,283.0292960000006,0.0,283.0292960000006,63.848955572006275,8631.599609,9601.55957,98.17828336112122,-1.821716638878783,-48.24396873087244,-104.60300864272773,0.06439409300864285,2453800.0
1382,BSESN,2009-02-10,9647.469727,9724.870117,9510.629883,9589.950195,45000.0,63.58007899999939,0.0,63.58007899999939,65.62362364862044,8631.599609,9724.870117,92.92028922086311,-7.0797107791368985,-12.46860717155505,-86.17612834849321,0.042128142084282505,2498800.0
1383,BSESN,2009-02-11,9618.540039,9648.389648,9459.589844,9462.139648,37600.0,-28.929688000000173,28.929688000000173,0.0,63.974794038217325,8631.599609,9724.870117,90.27412911791444,-9.725870882085562,13.394833265763737,-66.26193602564182,0.04138676552696663,2461200.0
1384,BSESN,2009-02-12,9465.830078,9578.990234,9445.540039,9559.030273,33800.0,-152.70996099999866,152.70996099999866,0.0,55.48388893666752,8631.599609,9724.870117,76.30595199408785,-23.69404800591215,21.323573662341005,-48.744834088045245,0.00441307128928603,2427400.0
1385,BSESN,2009-02-13,9634.740234,9695.589844,9540.599609,9540.599609,30000.0,168.91015599999992,0.0,168.91015599999992,61.932113580346545,8791.580078,9724.870117,90.3427788539807,-9.657221146019287,40.76686050681383,-30.84249516907343,0.06265124320679072,2457400.0
1386,BSESN,2009-02-16,9305.450195,9637.040039,9279.099609,9637.040039,37200.0,-329.2900390000013,329.2900390000013,0.0,46.71188771499713,9017.080078,9724.870117,40.742324857725045,-59.257675142274955,29.267474034455518,-18.820501328367637,0.017066922423360165,2420200.0
1387,BSESN,2009-02-17,9035.0,9213.400391,8994.339844,9213.400391,28400.0,-270.45019499999944,270.45019499999944,0.0,37.8879420644615,8994.339844,9724.870117,5.565841348781435,-94.43415865121857,-1.6499237890093355,-15.386385820495976,-0.018132181690603932,2391800.0
1388,BSESN,2009-02-18,9015.179688,9112.990234,8929.620117,8939.379883,36800.0,-19.820311999999827,19.820311999999827,0.0,37.29224558127005,8929.620117,9724.870117,10.758826909776772,-89.24117309022323,-27.435261231450568,-17.796160902686896,-0.00832704820372332,2355000.0
1389,BSESN,2009-02-19,9042.629883,9111.269531,8977.799805,9034.900391,27400.0,27.450194999999443,0.0,27.450194999999443,38.82916563700217,8929.620117,9724.870117,14.210596164727974,-85.78940383527203,-45.135036991408924,-23.263936120431303,-0.027764148608517947,2382400.0
1390,BSESN,2009-02-20,8843.209961,8943.780273,8762.580078,8943.780273,28000.0,-199.41992199999916,199.41992199999916,0.0,32.21140933010257,8762.580078,9724.870117,8.378958498187224,-91.62104150181277,-74.39616520230084,-33.490381936805214,-0.07728382882148144,2354400.0
1391,BSESN,2009-02-24,8822.05957,8856.519531,8619.219727,8707.349609,32400.0,-21.15039100000104,21.15039100000104,0.0,31.553304132601113,8619.219727,9724.870117,18.34574878592496,-81.65425121407503,-98.16094168431118,-46.424493886306415,-0.08555716476517738,2322000.0
1392,BSESN,2009-02-25,8902.55957,8995.040039,8880.150391,8913.44043,32200.0,80.5,0.0,80.5,37.1889897621814,8619.219727,9724.870117,25.626531276310548,-74.37346872368946,-109.23977292595191,-58.98754969423553,-0.07443754105061018,2354200.0
1393,BSESN,2009-02-26,8954.860352,8998.30957,8788.94043,8905.55957,37200.0,52.30078200000026,0.0,52.30078200000026,40.84055109485561,8619.219727,9724.870117,30.356849510087887,-69.64315048991212,-112.5027290619837,-69.69058556778518,-0.05398044564391358,2391400.0
1394,BSESN,2009-02-27,8891.610352,8944.110352,8728.660156,8944.110352,42200.0,-63.25,63.25,0.0,37.7760510517566,8619.219727,9724.870117,24.636234696213496,-75.3637653037865,-118.82267784022042,-79.51700402227223,-0.07713024575147054,2349200.0
1395,BSESN,2009-03-02,8607.080078,8762.879883,8563.519531,8762.879883,30200.0,-284.5302739999988,284.5302739999988,0.0,27.18720807595767,8563.519531,9724.870117,3.7508524579158333,-96.24914754208417,-145.11767178510308,-92.63713757483842,-0.07504957872701812,2319000.0
1396,BSESN,2009-03-03,8427.290039,8635.200195,8393.049805,8583.05957,35200.0,-179.79003900000134,179.79003900000134,0.0,22.573801727451936,8393.049805,9695.589844,2.6287279449993917,-97.37127205500062,-178.40762545946927,-109.79123515176461,-0.06726175550636415,2283800.0
1397,BSESN,2009-03-04,8446.490234,8501.459961,8373.240234,8473.25,40600.0,19.200195000001262,0.0,19.200195000001262,24.159591744920718,8373.240234,9695.589844,5.539382281815778,-94.46061771818422,-200.92472317631655,-128.017932756675,-0.0630813221345965,2324400.0
1398,BSESN,2009-03-05,8197.919922,8535.030273,8167.75,8535.030273,51400.0,-248.57031200000165,248.57031200000165,0.0,18.499641819943022,8167.75,9695.589844,1.9746783092795903,-98.02532169072042,-236.10555427439976,-149.63545706021998,-0.09341419165988885,2273000.0
1399,BSESN,2009-03-06,8325.820313,8347.099609,8047.169922,8103.75,52200.0,127.90039100000105,0.0,127.90039100000105,28.451296298648018,8047.169922,9637.040039,17.526613527764056,-82.47338647223594,-250.77534170139552,-169.8634339884551,-0.05850699579471408,2325200.0
1400,BSESN,2009-03-09,8160.399901999999,8259.219727,8110.100098000001,8259.219727,26400.0,-165.42041100000097,165.42041100000097,0.0,24.065949849464047,8047.169922,9213.400391,9.709056915404535,-90.29094308459547,-272.6068564695397,-190.41211848467205,-0.0750005894598601,2298800.0
1401,BSESN,2009-03-12,8343.75,8439.259766,8274.780273,8274.780273,36200.0,183.3500980000008,0.0,183.3500980000008,36.569658790846304,8047.169922,9112.990234,27.82646142701771,-72.1735385729823,-271.9784701201406,-206.72538881176578,-0.0627695401087891,2335000.0
1402,BSESN,2009-03-13,8756.610352,8793.209961,8480.740234,8480.740234,49400.0,412.8603519999997,0.0,412.8603519999997,55.57573544621112,8047.169922,9111.269531,66.67049061945475,-33.32950938054524,-235.4519459532894,-212.4707002400705,-0.022138815370328135,2384400.0
1403,BSESN,2009-03-16,8943.540039,8955.730469,8697.459961,8793.889648,49400.0,186.92968699999986,0.0,186.92968699999986,61.588565898524784,8047.169922,8998.30957,94.24169404406955,-5.758305955930453,-189.2393158515879,-207.82442336237398,0.005840301693867955,2433800.0
1404,BSESN,2009-03-17,8863.820313,9024.120117,8801.790039,8942.009766,47200.0,-79.71972599999934,79.71972599999934,0.0,57.74272418510462,8047.169922,9024.120117,83.59181411494573,-16.40818588505427,-157.23567421804182,-197.70667353350757,0.02982895856357093,2386600.0
1405,BSESN,2009-03-18,8976.679688,9120.400391,8951.320313,8956.299805,45600.0,112.859375,0.0,112.859375,61.654103707431055,8047.169922,9120.400391,86.60858900754901,-13.391410992450975,-121.36670941434568,-182.4386807096752,0.06519173381449117,2432200.0
1406,BSESN,2009-03-19,9001.75,9086.769531,8900.389648,9023.040039,36000.0,25.070311999999827,0.0,25.070311999999827,62.54276083840238,8047.169922,9120.400391,88.94455623212471,-11.055443767875296,-89.88123677994736,-163.92719192372965,0.06573851986057933,2468200.0
1407,BSESN,2009-03-20,8966.679688,8999.980469,8867.129883,8951.339844,32800.0,-35.07031199999983,35.07031199999983,0.0,60.28763199272233,8047.169922,9120.400391,85.67682269184633,-14.323177308153667,-66.98647556746982,-144.5390486524777,0.093774978691479,2435400.0
1408,BSESN,2009-03-23,9424.019531,9454.69043,9040.299805,9040.299805,43200.0,457.33984299999975,0.0,457.33984299999975,74.25541589772583,8047.169922,9454.69043,97.82092702552646,-2.1790729744735367,-11.802655511341072,-117.99177002425037,0.13190282479256288,2478600.0
1409,BSESN,2009-03-24,9471.040039,9699.0,9402.639648,9549.519531,50000.0,47.02050799999961,0.0,47.02050799999961,75.28658677562461,8047.169922,9699.0,86.19955139235572,-13.800448607644283,35.31795805413094,-87.32982440857411,0.16060979274787512,2528600.0
1410,BSESN,2009-03-25,9667.900391,9704.69043,9430.450195,9442.299805,49400.0,196.8603519999997,0.0,196.8603519999997,79.29319362187522,8047.169922,9704.69043,97.78041726648722,-2.2195827335127807,87.53729353643394,-52.3564008195725,0.15869967232958793,2578000.0
1411,BSESN,2009-03-26,10003.099609,10061.360352,9739.929688,9739.929688,45200.0,335.1992180000016,0.0,335.1992180000016,84.29541675245503,8047.169922,10061.360352,97.10748585971591,-2.89251414028409,154.19184107913316,-11.04675243983136,0.14234837532942235,2623200.0
1412,BSESN,2009-03-27,10048.490234,10127.089844,9913.400391,10036.799805,52800.0,45.390625,0.0,45.390625,84.86662795892687,8047.169922,10127.089844,96.22102710933122,-3.778972890668783,208.27779751766866,32.818157551668655,0.12354729672832643,2676000.0
1413,BSESN,2009-03-30,9568.139648,9902.349609,9521.759766,9902.349609,41400.0,-480.35058600000053,480.35058600000053,0.0,58.76660148301449,8110.100098000001,10127.089844,72.28790096189215,-27.71209903810785,209.96073319438256,68.24667268021145,0.07946001950953585,2634600.0
1414,BSESN,2009-03-31,9708.5,9826.219727,9547.209961,9633.209961,53000.0,140.3603519999997,0.0,140.3603519999997,62.64042603216217,8274.780273,10127.089844,77.40173399989412,-22.59826600010588,220.083394830619,98.61401711029296,0.0815246101493734,2687600.0
1415,BSESN,2009-04-01,9901.990234,9921.959961,9546.290039,9745.769531,45800.0,193.4902340000008,0.0,193.4902340000008,67.49745498112344,8480.740234,10127.089844,86.32735060446855,-13.67264939553145,240.94130059313284,127.07947380686096,0.10000724681311968,2733400.0
1416,BSESN,2009-04-02,10348.830078,10431.980469,10107.25,10107.25,64600.0,446.83984400000014,0.0,446.83984400000014,75.86011902018309,8697.459961,10431.980469,95.20614540926493,-4.7938545907350685,290.1825385256652,159.70008675062184,0.1541429423256544,2798000.0
1417,BSESN,2009-04-06,10534.870117,10654.889648,10410.44043,10521.780273,53800.0,186.04003899999955,0.0,186.04003899999955,78.51565307432683,8801.790039,10654.889648,93.5233092480783,-6.476690751921684,340.29573331012034,195.81921606252155,0.11787439344176809,2851800.0
1418,BSESN,2009-04-08,10742.339844,10778.110352,10173.0,10283.580078,56400.0,207.4697269999997,0.0,207.4697269999997,81.17968733153788,8867.129883,10778.110352,98.12815941448538,-1.8718405855146187,392.2304854140639,235.10146993283004,0.13423022178821142,2908200.0
1419,BSESN,2009-04-09,10803.860352,10929.330078,10655.959961,10876.150391,58400.0,61.52050799999961,0.0,61.52050799999961,81.94565843705522,8867.129883,10929.330078,93.91573493668488,-6.084265063315112,433.3578617984749,274.7527483059591,0.11749810352385137,2966600.0
1420,BSESN,2009-04-13,10967.219727,11069.540039,10800.839844,10916.429688,43000.0,163.359375,0.0,163.359375,83.94737945717216,8867.129883,11069.540039,95.35416635628701,-4.645833643712994,473.67313119596474,314.5368248839602,0.09638213710603849,3009600.0
1421,BSESN,2009-04-15,11284.730469,11337.75,10719.179688,10805.139648,70200.0,317.5107420000004,0.0,317.5107420000004,87.14399374818008,9040.299805,11337.75,97.69224459727624,-2.307755402723754,525.1896763114255,356.6673951694533,0.12302746046536073,3079800.0
1422,BSESN,2009-04-16,10947.400391,11362.30957,10900.469727,11358.05957,60200.0,-337.33007800000087,337.33007800000087,0.0,70.04514451069815,9402.639648,11362.30957,78.82759875313326,-21.172401246866738,532.6570524296767,391.865326621498,0.1441514018128176,3019600.0
1423,BSESN,2009-04-17,11023.089844,11339.469727,10946.25,11067.709961,53600.0,75.68945300000088,0.0,75.68945300000088,71.49326630246395,9430.450195,11362.30957,82.44076507897998,-17.559234921020035,538.4753000273977,421.18732130267796,0.13540607138074878,3073200.0
1424,BSESN,2009-04-20,10979.5,11209.660156,10863.280273,11065.099609,43200.0,-43.5898440000001,43.5898440000001,0.0,69.26806765383189,9521.759766,11362.30957,79.2013468384255,-20.798653161574506,533.4200329540727,443.633863632957,0.10881749431545629,3030000.0
1425,BSESN,2009-04-21,10898.110352,11068.820313,10764.080078,10765.389648,45000.0,-81.38964800000029,81.38964800000029,0.0,64.91514038020452,9521.759766,11362.30957,74.77931773477836,-25.220682265221644,516.887871355837,458.28466517753304,0.053076557433065163,2985000.0
1426,BSESN,2009-04-22,10817.540039,11036.240234,10715.660156,10968.599609,39000.0,-80.57031300000017,80.57031300000017,0.0,60.567610585038615,9521.759766,11362.30957,70.40180440561446,-29.59819559438555,491.6176015867841,464.9512524593832,0.026831837399101666,2946000.0
1427,BSESN,2009-04-23,11134.990234,11200.860352,10758.969727,10841.570313,41800.0,317.45019500000126,0.0,317.45019500000126,69.77134120714433,9546.290039,11362.30957,87.48255004312513,-12.517449956874868,491.54013966987077,470.2690299014808,0.03655166339010507,2987800.0
1428,BSESN,2009-04-24,11329.049805,11362.879883,11070.330078,11149.469727,44600.0,194.05957099999972,0.0,194.05957099999972,74.04448773536703,9546.290039,11362.879883,98.13771511980339,-1.8622848801966025,501.35838867890016,476.4869016569647,0.048611277440547385,3032400.0
1429,BSESN,2009-04-27,11371.849609,11492.099609,11176.549805,11237.419922,52400.0,42.79980400000022,0.0,42.79980400000022,74.94577753517235,10107.25,11492.099609,91.31674665476257,-8.683253345237427,506.7514924816569,482.53981982190317,0.036894481196893425,3084800.0
1430,BSESN,2009-04-28,11001.75,11371.339844,10961.759766,11371.339844,47600.0,-370.09960900000084,370.09960900000084,0.0,55.66113272314109,10173.0,11492.099609,62.826946073334746,-37.17305392666525,475.67829739286026,481.1675153360946,-0.025076404773456407,3037200.0
1431,BSESN,2009-04-29,11403.25,11430.25,11091.55957,11091.55957,40400.0,401.5,0.0,401.5,66.4630880243246,10173.0,11492.099609,93.26437454807852,-6.73562545192148,477.940856256133,480.5221835201023,0.041639986911848004,3077600.0
1432,BSESN,2009-05-04,12134.75,12160.320313,11635.240234,11635.240234,46400.0,731.5,0.0,731.5,77.82165605795518,10655.959961,12160.320313,98.30025346214389,-1.6997465378561223,532.6201732429581,490.94178146467345,0.10084832580812986,3124000.0
1433,BSESN,2009-05-05,12131.080078,12197.879883,11985.879883,12159.740234,48400.0,-3.6699219999991333,3.6699219999991333,0.0,77.6693768029771,10715.660156,12197.879883,95.49325894243758,-4.506741057562429,569.0975910845682,506.5729433886525,0.10488456468873819,3075600.0
1434,BSESN,2009-05-06,11952.75,12272.040039,11899.410156,12100.69043,49200.0,-178.33007800000087,178.33007800000087,0.0,69.99054232846721,10715.660156,12272.040039,79.48508314149164,-20.514916858508357,576.9655607657769,520.6514668640774,0.09677270773886537,3026400.0
1435,BSESN,2009-05-07,12116.94043,12143.950195,11981.129883,12064.509766,47800.0,164.19043000000056,0.0,164.19043000000056,72.84287647240637,10715.660156,12272.040039,90.03459176682259,-9.965408233177413,589.6526304503041,534.4516995813227,0.12011976718508377,3074200.0
1436,BSESN,2009-05-08,11876.429688,12180.070313,11765.05957,12092.969727,55200.0,-240.51074200000042,240.51074200000042,0.0,62.760494330296254,10715.660156,12272.040039,74.58137596603724,-25.418624033962757,573.6869121182353,542.2987420887052,0.06658644852117246,3019000.0
1437,BSESN,2009-05-11,11682.990234,12026.599609,11621.299805,11997.370117,36000.0,-193.4394539999994,193.4394539999994,0.0,55.6165421759648,10715.660156,12272.040039,62.152568827568246,-37.847431172431754,539.2093482954679,541.6808633300577,0.031241845970505944,2983000.0
1438,BSESN,2009-05-12,12158.030273,12194.629883,11625.389648,11629.969727,40000.0,475.04003899999947,0.0,475.04003899999947,66.44077583560016,10715.660156,12272.040039,92.67468262438346,-7.325317375616532,543.9471079751147,542.1341122590691,0.06913393080557406,3023000.0
1439,BSESN,2009-05-13,12019.650391,12256.429688,11934.44043,12201.929688,217600.0,-138.3798820000011,138.3798820000011,0.0,61.40709983621928,10715.660156,12272.040039,83.78354470159903,-16.216455298400973,530.4213495249787,539.791559712251,0.09252167982366433,2805400.0
1440,BSESN,2009-05-14,11872.910156,11935.860352,11695.519531,11774.040039,39000.0,-146.7402349999993,146.7402349999993,0.0,56.19763881606187,10758.969727,12272.040039,73.62119395017251,-26.378806049827485,502.07378385008815,532.2480045398185,0.041186517527897815,2766400.0
1441,BSESN,2009-05-15,12173.419922,12218.980469,11948.700195,11948.700195,35000.0,300.5097659999992,0.0,300.5097659999992,63.512072252314205,10961.759766,12272.040039,92.47335711052102,-7.526642889478988,498.1148030865679,525.4213642491684,0.003186709408928845,2801400.0
1442,BSESN,2009-05-18,14284.209961000002,14284.209961000002,13479.389647999997,13479.389647999997,800.0,2110.790039000003,0.0,2110.790039000003,84.49547647394564,10961.759766,14284.209961000002,100.0,-0.0,657.7186269318281,551.8808167857004,0.17748872063788879,2802200.0
1443,BSESN,2009-05-19,14302.030272999997,14930.540038999998,13840.830078,14757.820313,89400.0,17.820311999996193,0.0,17.820311999996193,84.58184931550873,10961.759766,14930.540038999998,84.16365425226952,-15.836345747730471,776.690552247268,596.8427638780139,0.19654726092321817,2891600.0
1444,BSESN,2009-05-20,14060.660156,14405.509766,13976.490234,14230.730469,51000.0,-241.37011699999854,241.37011699999854,0.0,77.80766125627801,11091.55957,14930.540038999998,77.34086198082196,-22.659138019178034,841.7964040328989,645.8334919089909,0.160413409410481,2840600.0
1445,BSESN,2009-05-21,13736.540038999998,14089.509766,13704.429688,14043.379883,44800.0,-324.12011700000215,324.12011700000215,0.0,69.21811481223615,11621.299805,14930.540038999998,63.91921058699418,-36.08078941300582,857.356405026967,688.1380745325862,0.15662201519026064,2795800.0
1446,BSESN,2009-05-22,13887.150391,13936.929688,13611.299805,13663.540038999998,39400.0,150.6103520000015,0.0,150.6103520000015,70.93826419686792,11621.299805,14930.540038999998,68.47041694707016,-31.529583052929826,871.7913466487898,724.868728955827,0.18866404172669937,2835200.0
1447,BSESN,2009-05-25,13913.219727000003,14027.599609,13819.780272999997,13999.44043,37400.0,26.069336000002288,0.0,26.069336000002288,71.25903537803357,11621.299805,14930.540038999998,69.25819100264223,-30.741808997357765,875.2454348750198,754.9440701396657,0.1443646227709967,2872600.0
1448,BSESN,2009-05-26,13589.230469,13991.459961000002,13524.929688,13983.259766,37800.0,-323.98925800000137,323.98925800000137,0.0,61.52149596193024,11621.299805,14930.540038999998,59.46774863247965,-40.53225136752035,842.132025469642,772.381661205661,0.13058450345404893,2834800.0
1449,BSESN,2009-05-27,14109.639647999997,14122.780272999997,13848.150391,13851.849609,47000.0,520.4091789999984,0.0,520.4091789999984,69.29733993079992,11621.299805,14930.540038999998,75.19369000274273,-24.806309997257266,848.1056474743236,787.5264584593936,0.18838932179316292,2881800.0
1450,BSESN,2009-05-28,14296.009766,14376.339844,14080.980469,14139.139647999997,42600.0,186.37011800000076,0.0,186.37011800000076,71.66355371929656,11621.299805,14930.540038999998,80.82549986910382,-19.17450013089618,857.9879459512176,801.6187559577585,0.17436265713335186,2924400.0
1451,BSESN,2009-05-29,14625.25,14726.599609,14384.759766,14384.759766,45200.0,329.2402340000008,0.0,329.2402340000008,75.51070135013774,11625.389648,14930.540038999998,90.76320279309196,-9.236797206908033,882.2170252940687,817.7384098250207,0.023875316866045493,2969600.0
1452,BSESN,2009-06-01,14840.629883,14906.80957,14658.009766,14790.889647999997,44200.0,215.37988300000146,0.0,215.37988300000146,77.78705508308147,11695.519531,14930.540038999998,97.22072377044732,-2.779276229552674,908.3274681490784,835.8562214898324,0.03765896168020255,3013800.0
1453,BSESN,2009-06-02,14874.910156,14994.219727000003,14608.230469,14942.209961000002,43800.0,34.28027299999849,0.0,34.28027299999849,78.15988045145956,11695.519531,14994.219727000003,96.38313384330355,-3.6168661566964446,921.1676663158323,852.9185104550323,0.05790979875525548,3057600.0
1454,BSESN,2009-06-03,14870.900391,15045.879883,14734.900391,14902.620117,43000.0,-4.009765000000698,4.009765000000698,0.0,77.98322661563772,11948.700195,15045.879883,94.35036033982927,-5.64963966017074,920.4101461180962,866.4168375876452,0.08257977254675408,3014600.0
1455,BSESN,2009-06-04,15008.679688,15026.030272999997,14601.910156,14755.080078,39200.0,137.77929700000095,0.0,137.77929700000095,79.79387901762186,13479.389647999997,15045.879883,97.62525203356921,-2.374747966430788,920.3185839447342,877.197186859063,0.0807602182897682,3053800.0
1456,BSESN,2009-06-05,15103.549805,15257.299805,14994.049805,15040.240234,36800.0,94.8701170000004,0.0,94.8701170000004,81.03315996421836,13524.929688,15257.299805,91.12487577041252,-8.87512422958748,917.3268726699389,885.2231240212382,0.08555389056999085,3090600.0
1457,BSESN,2009-06-08,14665.919922,15184.870117,14604.230469,15153.209961000002,31400.0,-437.62988300000137,437.62988300000137,0.0,61.09040101792304,13524.929688,15257.299805,65.86295981460864,-34.137040185391356,869.6184259028469,882.1021843975599,0.07923108342714191,3059200.0
1458,BSESN,2009-06-09,15127.0,15159.269531,14526.69043,14618.980469,51600.0,461.08007800000087,0.0,461.08007800000087,70.05076248999863,13524.929688,15257.299805,92.47852386038356,-7.521476139616447,859.1111484653502,877.503977211118,0.07210392167203294,3110800.0
1459,BSESN,2009-06-10,15466.80957,15580.80957,15168.179688,15168.179688,42400.0,339.80956999999944,0.0,339.80956999999944,74.95524053391807,13524.929688,15580.80957,94.45492895776097,-5.5450710422390355,868.1958267298141,875.6423471148573,0.08189696447917205,3153200.0
1460,BSESN,2009-06-11,15411.469727000003,15568.740234,15242.19043,15517.360352000003,42000.0,-55.33984299999793,55.33984299999793,0.0,72.71756768526845,13524.929688,15580.80957,91.76314509020541,-8.236854909794587,861.0049082449386,872.7148593408735,0.053757694877010875,3111200.0
1461,BSESN,2009-06-12,15237.94043,15600.299805,15174.280272999997,15446.820313,40600.0,-173.52929700000095,173.52929700000095,0.0,65.62878377850089,13524.929688,15600.299805,82.54001192212405,-17.45998807787594,831.7161830816331,864.5151240890256,0.026771811582951832,3070600.0
1462,BSESN,2009-06-15,14875.519531,15261.030272999997,14808.089844,15195.830078,34600.0,-362.42089900000076,362.42089900000076,0.0,53.144141053733996,13848.150391,15600.299805,58.63479060581987,-41.36520939418013,770.3798602205625,845.688071315333,4.0966633990446866e-05,3036000.0
1463,BSESN,2009-06-16,14957.910156,15022.19043,14621.969727000003,14788.269531,32000.0,82.390625,0.0,82.390625,55.37109123301849,14080.980469,15600.299805,57.71858925383936,-42.28141074616064,720.1175504551011,820.5739671432867,0.005851008527544055,3068000.0
1464,BSESN,2009-06-17,14522.839844,14995.660156,14447.929688,14978.5,35400.0,-435.07031199999983,435.07031199999983,0.0,42.93713756487432,14384.759766,15600.299805,11.359566412439722,-88.64043358756028,637.825316485525,784.0242370117345,-0.03237059182417268,3032600.0
1465,BSESN,2009-06-18,14265.530272999997,14630.730469,14188.25,14503.049805,75800.0,-257.3095710000016,257.3095710000016,0.0,37.231762997255885,14188.25,15600.299805,5.472914108719886,-94.52708589128011,545.5565598029716,736.330701569982,-0.05548493849588787,2956800.0
1466,BSESN,2009-06-19,14521.889647999997,14559.080078,14179.769531,14321.980469,37400.0,256.359375,0.0,256.359375,45.54931610146054,14179.769531,15600.299805,24.083972250491904,-75.9160277495081,487.49937511090684,686.564436278167,-0.009820745972023648,2994200.0
1467,BSESN,2009-06-22,14326.219727000003,14668.400391,14269.769531,14591.280272999997,31600.0,-195.66992099999698,195.66992099999698,0.0,40.78914045998518,14179.769531,15600.299805,10.309544166744267,-89.69045583325574,420.8484318665742,633.4212353958485,-0.05293715032722923,2962600.0
1468,BSESN,2009-06-23,14324.009766,14394.19043,14016.950195,14147.870117,35600.0,-2.209961000002295,2.209961000002295,0.0,40.733664727129224,14016.950195,15600.299805,19.393036702740563,-80.60696329725944,363.6567451780902,579.4683373522969,-0.07388723568541355,2927000.0
1469,BSESN,2009-06-24,14422.730469,14479.820313,14207.019531,14388.209961000002,30600.0,98.72070300000088,0.0,98.72070300000088,44.61617803956179,14016.950195,15600.299805,25.627964376105183,-74.37203562389482,322.5793630241151,528.0905424866605,-0.0641560652886849,2957600.0
1470,BSESN,2009-06-25,14345.620117,14578.459961000002,14261.139647999997,14476.150391,29600.0,-77.11035200000151,77.11035200000151,0.0,42.128829603073726,14016.950195,15600.299805,20.757886945764348,-79.24211305423566,280.56885760975456,478.58620551127933,-0.058559115459148714,2928000.0
1471,BSESN,2009-06-26,14764.639647999997,14781.94043,14373.570313,14373.570313,32400.0,419.01953099999986,0.0,419.01953099999986,57.11828607303716,14016.950195,15600.299805,47.22200632619581,-52.77799367380419,277.8833375203285,438.44563191308913,-0.007453849444984728,2960400.0
1472,BSESN,2009-06-29,14785.740234,14955.549805,14685.450195,14764.639647999997,26600.0,21.100586000002295,0.0,21.100586000002295,57.754080250218124,14016.950195,15600.299805,48.55466121597748,-51.44533878402251,274.2957735127129,405.6156602330139,-0.011510292561219715,2987000.0
1473,BSESN,2009-06-30,14493.839844,14907.480469,14420.410156,14785.740234,35200.0,-291.9003900000007,291.9003900000007,0.0,46.70150762854526,14016.950195,15600.299805,30.119036628935053,-69.88096337106495,245.07362503366858,373.5072531931449,-0.001996854631154066,2951800.0
1474,BSESN,2009-07-01,14645.469727000003,14727.490234,14355.519531,14493.839844,28800.0,151.62988300000143,0.0,151.62988300000143,52.18597028409004,14016.950195,15600.299805,39.6955623717243,-60.3044376282757,231.481748657965,345.10215228610895,0.026633391590013877,2980600.0
1475,BSESN,2009-07-02,14658.490234,14764.349609,14469.69043,14694.30957,31200.0,13.02050699999927,0.0,13.02050699999927,52.668539998399105,14016.950195,15261.030272999997,51.567423218556094,-48.432576781443906,219.23354694300542,319.92843121748825,0.009406529681129872,3011800.0
1476,BSESN,2009-07-03,14913.049805,14945.849609,14499.740234,14552.719727000003,29000.0,254.55957099999972,0.0,254.55957099999972,61.44624268192284,14016.950195,15022.19043,89.14283161377838,-10.857168386221616,227.4457359134176,301.4318921566741,0.040961962693760956,3040800.0
1477,BSESN,2009-07-06,14043.400391,15097.870117,13959.44043,14962.120117,43400.0,-869.6494140000012,869.6494140000012,0.0,35.496978831827164,13959.44043,15097.870117,7.375067776144411,-92.6249322238556,161.9140704752699,273.52832782039326,-0.01959014127915948,2997400.0
1478,BSESN,2009-07-07,14170.450195,14251.879883,14000.679688,14103.650391,35800.0,127.04980400000021,0.0,127.04980400000021,39.783665342577905,13959.44043,15097.870117,18.535160090216348,-81.46483990978365,118.86145006104562,242.5949522685237,-0.017491852499237126,3033200.0
1479,BSESN,2009-07-08,13769.150391,14039.580078,13701.759766,14039.580078,37600.0,-401.29980400000017,401.29980400000017,0.0,32.02663006987477,13701.759766,15097.870117,4.827027100811169,-95.17297289918884,51.763698134678634,204.4287014417547,-0.04018437134807906,2995600.0
1480,BSESN,2009-07-09,13757.459961000002,13879.179688,13643.969727000003,13796.19043,28400.0,-11.690429999996926,11.690429999996926,0.0,31.818097151211106,13643.969727000003,15097.870117,7.805915369484094,-92.1940846305159,-2.328235233673695,163.07731410666904,-0.0682156633017742,2967200.0
1481,BSESN,2009-07-10,13504.219727000003,13897.19043,13418.389648,13803.120117,27800.0,-253.2402340000008,253.2402340000008,0.0,27.364587380828254,13418.389648,15097.870117,5.1105136727852605,-94.88948632721474,-64.88292266205099,117.48526675292503,-0.08667273242452378,2939400.0
1482,BSESN,2009-07-13,13400.320313,13461.679688,13219.990234,13405.950195,24600.0,-103.89941400000133,103.89941400000133,0.0,25.664066472463475,13219.990234,15097.870117,9.60285482753635,-90.39714517246365,-121.44187122089897,69.69983915816022,-0.07544719292953161,2914800.0
1483,BSESN,2009-07-14,13853.700195,13903.480469,13549.419922,13549.419922,23800.0,453.3798819999992,0.0,453.3798819999992,43.37987412572912,13219.990234,15097.870117,33.74603278605966,-66.25396721394033,-128.20342869326487,30.119185587875187,-0.05406241976249615,2938600.0
1484,BSESN,2009-07-15,14253.240234,14299.540038999998,13891.040038999998,13917.269531,27200.0,399.54003900000123,0.0,399.54003900000123,54.42426579236689,13219.990234,15097.870117,55.022156068328265,-44.977843931671735,-100.16779763379964,4.061788943540215,-0.027646094074547545,2965800.0
1485,BSESN,2009-07-16,14250.25,14493.099609,14169.580078,14351.969727000003,35000.0,-2.9902340000007825,2.9902340000007825,0.0,54.33274381787862,13219.990234,15097.870117,54.86292149602837,-45.13707850397163,-77.29958344608167,-12.210485534384167,-0.04444428293787228,2930800.0
1486,BSESN,2009-07-17,14744.919922,14800.700195,14250.25,14325.580078,37600.0,494.66992199999913,0.0,494.66992199999913,65.42951266641495,13219.990234,15097.870117,81.204857765655,-18.79514223434499,-19.041136006177112,-13.576615628742758,0.04995368012504886,2968400.0
1487,BSESN,2009-07-20,15191.009766,15209.360352000003,14854.169922,14854.169922,34800.0,446.08984400000014,0.0,446.08984400000014,72.40631041827125,13219.990234,15209.360352000003,99.07756802849474,-0.9224319715052687,62.405454369885774,1.6197983709829535,0.07202026449096866,3003200.0
1488,BSESN,2009-07-21,15062.490234,15234.209961000002,14955.879883,15218.830078,35000.0,-128.51953199999843,128.51953199999843,0.0,67.85410879966244,13219.990234,15234.209961000002,91.47462788204528,-8.525372117954705,115.2534419480562,24.34652708639761,0.09393025758839668,2968200.0
1489,BSESN,2009-07-22,14843.120117,15369.419922,14786.580078,15124.919922,41800.0,-219.37011700000218,219.37011700000218,0.0,60.37793230674143,13219.990234,15369.419922,75.51444422963608,-24.485555770363916,137.84552041017741,47.04632575115358,0.0789142878901814,2926400.0
1490,BSESN,2009-07-23,15231.040038999998,15264.839844,14843.120117,15008.780272999997,55200.0,387.91992199999913,0.0,387.91992199999913,67.65044146157577,13219.990234,15369.419922,93.56201862416998,-6.437981375830031,184.92015662511403,74.62109192594569,0.12787264624756012,2981600.0
1491,BSESN,2009-07-24,15378.959961000002,15418.610352000003,15168.519531,15272.009766,43200.0,147.9199220000046,0.0,147.9199220000046,70.0676825903107,13219.990234,15418.610352000003,98.19657835951809,-1.803421640481914,231.49452172086058,105.9957778849287,0.14765614565798635,3024800.0
1492,BSESN,2009-07-27,15375.040038999998,15463.089844,15228.459961000002,15350.889647999997,36600.0,-3.9199220000045893,3.9199220000045893,0.0,69.90795612367012,13219.990234,15463.089844,96.07463687267983,-3.925363127320164,265.0335943660084,137.80334118114465,0.10981469373424657,2988200.0
1493,BSESN,2009-07-28,15331.94043,15463.459961000002,15240.530272999997,15428.5,40800.0,-43.09960899999715,43.09960899999715,0.0,67.94302284773904,13219.990234,15463.459961000002,94.13767302419225,-5.862326975807757,284.85217427470343,167.2131077998564,0.0756810506446699,2947400.0
1494,BSESN,2009-07-29,15173.459961000002,15379.429688,14888.410156,15293.19043,39000.0,-158.4804689999983,158.4804689999983,0.0,60.70386762572407,13219.990234,15463.459961000002,87.073594240659,-12.926405759341,284.49105645644704,190.66869753117456,0.06478552734162579,2908400.0
1495,BSESN,2009-07-30,15387.959961000002,15409.910156,15065.480469,15169.230469,30400.0,214.5,0.0,214.5,66.30978023439786,13219.990234,15463.459961000002,96.63467712127502,-3.3653228787249843,298.07717718053027,212.15039346104575,0.04361095498664347,2938800.0
1496,BSESN,2009-07-31,15670.30957,15732.80957,15449.469727000003,15449.469727000003,34000.0,282.3496089999972,0.0,282.3496089999972,72.30954709775133,13549.419922,15732.80957,97.13747841310641,-2.862521586893591,327.84829838394944,235.28997444562654,0.03155154340514965,2972800.0
1497,BSESN,2009-08-03,15924.230469,15963.360352000003,15608.400391,15694.780272999997,32400.0,253.92089900000062,0.0,253.92089900000062,76.62848164073283,13891.040038999998,15963.360352000003,98.11178403480702,-1.8882159651929804,367.6928861600354,261.7705567885083,0.057211007052129004,3005200.0
1498,BSESN,2009-08-04,15830.980469,16002.459961000002,15699.129883,15940.099609,43400.0,-93.25,93.25,0.0,71.87796713087145,14169.580078,16002.459961000002,90.6442591470135,-9.355740852986495,387.2811770255139,286.8726808359094,0.06655341627725497,2961800.0
1499,BSESN,2009-08-05,15903.830078,15973.099609,15695.110352000003,15882.389647999997,29600.0,72.84960900000078,0.0,72.84960900000078,73.3663264541155,14250.25,16002.459961000002,94.37111503785125,-5.62888496214874,404.0260326719672,310.303351203121,0.04417229797028188,2991400.0
1500,BSESN,2009-08-06,15514.030272999997,15969.80957,15443.219727000003,15881.469727000003,37800.0,-389.7998050000024,389.7998050000024,0.0,55.29753353665297,14786.580078,16002.459961000002,59.829116771396976,-40.170883228603024,381.4457951565437,324.53183999380553,0.008782798859124696,2953600.0
1501,BSESN,2009-08-07,15160.240234,15501.94043,15104.0,15440.950195,33200.0,-353.7900389999977,353.7900389999977,0.0,43.95951527902091,14786.580078,16002.459961000002,30.731666937201847,-69.26833306279816,331.18519803583877,325.8625116022122,-0.013970682642460819,2920400.0
1502,BSESN,2009-08-10,15009.769531,15417.339844,14902.019531,15287.139647999997,37200.0,-150.47070300000087,150.47070300000087,0.0,39.94067247104284,14786.580078,16002.459961000002,18.35620904009963,-81.64379095990037,276.02968611464894,315.89594650469957,-0.02101305444479873,2883200.0
1503,BSESN,2009-08-11,15074.589844,15218.650391,14864.230469,15000.379883,31000.0,64.82031300000017,0.0,64.82031300000017,42.551245361419404,14843.120117,16002.459961000002,19.965649261339397,-80.03435073866059,234.84189193007478,299.68513558977463,-0.006515990239149505,2914200.0
1504,BSESN,2009-08-12,15020.160156,15043.620117,14701.049805,14953.44043,34000.0,-54.42968800000017,54.42968800000017,0.0,40.831655123668455,14701.049805,16002.459961000002,24.520351983483284,-75.4796480165167,195.55402232187407,278.85891293619454,-0.02390179113619817,2880200.0
1505,BSESN,2009-08-13,15518.490234,15545.129883,15207.959961000002,15207.959961000002,28800.0,498.33007800000087,0.0,498.33007800000087,58.53409153791427,14701.049805,16002.459961000002,62.81189871089335,-37.18810128910665,202.2972187676205,263.5465741024797,-0.009688343125693555,2909000.0
1506,BSESN,2009-08-14,15411.629883,15535.469727000003,15367.610352000003,15530.379883,28600.0,-106.86035099999935,106.86035099999935,0.0,54.499638660299816,14701.049805,16002.459961000002,54.600778603421176,-45.399221396578824,196.7504960311835,250.18735848822047,-0.032189975333369425,2880400.0
1507,BSESN,2009-08-17,14784.919922,15411.629883,14740.629883,15284.230469,25600.0,-626.7099610000022,626.7099610000022,0.0,37.16519007874839,14701.049805,16002.459961000002,6.4445568227145795,-93.55544317728543,140.1686451917376,228.18361582892393,-0.06607680105779812,2854800.0
1508,BSESN,2009-08-18,15035.259766,15134.509766,14740.259766,14745.799805,29200.0,250.33984400000008,0.0,250.33984400000008,45.19891330052461,14701.049805,16002.459961000002,25.680601880902966,-74.31939811909703,114.21090180252395,205.38907302364393,-0.0546139079542548,2884000.0
1509,BSESN,2009-08-19,14809.639647999997,15096.94043,14684.450195,15079.040038999998,26600.0,-225.62011800000076,225.62011800000076,0.0,39.89462955599828,14684.450195,16002.459961000002,9.498370666852628,-90.50162933314738,74.57390367362132,179.22603915363942,-0.04540345819911762,2857400.0
1510,BSESN,2009-08-20,15012.320313,15145.0,14928.179688,14930.049805,16800.0,202.68066500000168,0.0,202.68066500000168,46.41302095557445,14684.450195,16002.459961000002,24.876152397189447,-75.12384760281056,58.83768863047953,155.14836904900744,-0.009757096109088037,2874200.0
1511,BSESN,2009-08-21,15240.830078,15275.169922,14835.080078,14951.490234,21400.0,228.5097650000007,0.0,228.5097650000007,53.038395472768634,14684.450195,16002.459961000002,42.21363887830253,-57.786361121697475,64.06692945274517,136.932081129755,0.01539401031593357,2895600.0
1512,BSESN,2009-08-24,15628.75,15676.349609,15362.929688,15362.929688,19800.0,387.91992199999913,0.0,387.91992199999913,62.19417124588742,14684.450195,15973.099609,73.27825510499937,-26.721744895000622,98.37898450776447,129.2214618053569,0.0367612095410057,2915400.0
1513,BSESN,2009-08-25,15688.469727000003,15735.320313,15423.389647999997,15573.910156,29200.0,59.719727000001505,0.0,59.719727000001505,63.45963226446088,14684.450195,15969.80957,78.11197020288617,-21.88802979711383,128.9044875222935,129.15806694874422,0.04449417077174367,2944600.0
1514,BSESN,2009-08-26,15769.849609,15831.490234,15695.94043,15763.089844,20000.0,81.37988199999927,0.0,81.37988199999927,65.28661371802635,14684.450195,15831.490234,94.62611391894055,-5.373886081059453,157.84332534253736,134.89511862750285,0.016197411681794227,2964600.0
1515,BSESN,2009-08-27,15781.070313,15853.709961000002,15685.490234,15711.799805,18600.0,11.220703999999387,0.0,11.220703999999387,65.56056178502396,14684.450195,15853.709961000002,93.78755259419385,-6.21244740580614,179.61251853683098,143.8385986093685,0.02397153531486751,2983200.0
1516,BSESN,2009-08-28,15922.339844,15957.669922,15663.349609,15770.19043,30400.0,141.26953099999992,0.0,141.26953099999992,69.10271894980927,14684.450195,15957.669922,97.22513897241878,-2.774861027581224,205.8906522185498,156.24900933120477,0.07693108437520291,3013600.0
1517,BSESN,2009-08-31,15666.639647999997,15821.349609,15589.799805,15812.150391,25600.0,-255.7001960000016,255.7001960000016,0.0,56.88384517671167,14684.450195,15957.669922,77.14217995304415,-22.857820046955847,203.73486494105055,165.74618045317393,0.041993280583536574,2988000.0
1518,BSESN,2009-09-01,15551.19043,15923.089844,15475.280272999997,15691.269531,26800.0,-115.44921799999793,115.44921799999793,0.0,52.08581122638611,14684.450195,15957.669922,68.07467844079369,-31.925321559206303,190.51446874425346,170.69983811138985,0.05007216918341073,2961200.0
1519,BSESN,2009-09-02,15467.459961000002,15628.099609,15392.679688,15482.049805,23600.0,-83.73046899999827,83.73046899999827,0.0,48.65171130950701,14684.450195,15957.669922,61.4984004249569,-38.5015995750431,171.30614976677134,170.82110044246616,0.030317741595606185,2937600.0
1520,BSESN,2009-09-03,15398.330078,15598.179688,15356.719727000003,15539.339844,22000.0,-69.12988300000143,69.12988300000143,0.0,45.77652170683266,14684.450195,15957.669922,56.06886760088674,-43.93113239911326,148.79005563037572,166.41489148004808,0.0103340828021794,2915600.0
1521,BSESN,2009-09-04,15689.120117,15740.830078,15358.94043,15425.860352000003,30800.0,290.79003899999765,0.0,290.79003899999765,57.86286623024004,14684.450195,15957.669922,78.90781934138232,-21.09218065861768,152.6505541545066,163.6620240149398,0.0038627604254979353,2946400.0
1522,BSESN,2009-09-07,16016.320313,16035.5,15793.269531,15793.269531,25000.0,327.20019600000165,0.0,327.20019600000165,67.32020348646174,14684.450195,16035.5,98.58038638331324,-1.419613616686753,180.03699394230534,166.9370180004129,0.02089755034780505,2971400.0
1523,BSESN,2009-09-08,16123.669922,16232.160156,16030.55957,16030.55957,35000.0,107.34960899999895,0.0,107.34960899999895,69.87939287153972,14835.080078,16232.160156,92.23450139269677,-7.765498607303228,208.00540424964493,175.15069525025933,0.022436505215501112,3006400.0
1524,BSESN,2009-09-09,16183.549805,16215.740234,16044.769531,16111.089844,30600.0,59.87988300000143,0.0,59.87988300000143,71.32469775199645,14835.080078,16232.160156,96.52057517922754,-3.4794248207724707,232.32428727391925,186.58541365499133,0.025503941368821392,3037000.0
1525,BSESN,2009-09-10,16216.860352000003,16434.769531,16166.419922,16295.919922,30000.0,33.31054700000095,0.0,33.31054700000095,72.18149538204148,15356.719727000003,16434.769531,79.78672430610648,-20.21327569389352,251.38722459180826,199.54577584235474,0.01849731326460713,3067000.0
1526,BSESN,2009-09-11,16264.299805,16337.980469,16130.320313,16254.570313,28200.0,47.43945299999905,0.0,47.43945299999905,73.48344211187529,15356.719727000003,16434.769531,84.18721237483742,-15.812787625162578,267.24210649509223,213.0850419729023,0.03814858645046448,3095200.0
1527,BSESN,2009-09-14,16214.19043,16252.179688,16119.950195,16185.259766,23600.0,-50.109375,50.109375,0.0,69.51806643432975,15356.719727000003,16434.769531,79.53906209327583,-20.46093790672416,272.6211993652414,224.99227345137012,0.04263339214990247,3071600.0
1528,BSESN,2009-09-15,16454.449219,16477.230469,16255.419922,16255.419922,19600.0,240.25878899999768,0.0,240.25878899999768,76.52600218392053,15356.719727000003,16477.230469,97.96688696091054,-2.033113039089464,292.89473735336287,238.57276623176867,0.06381068775924503,3091200.0
1529,BSESN,2009-09-16,16677.039063,16700.560547,16498.589844,16498.589844,30200.0,222.5898440000019,0.0,222.5898440000019,81.15697465776059,15356.719727000003,16700.560547,98.24968228007832,-1.750317719921681,323.19718643974375,255.49765027336372,0.08304205576336643,3121400.0
1530,BSESN,2009-09-17,16711.109375,16820.019531,16636.550781,16686.380859,44200.0,34.07031199999983,0.0,34.07031199999983,81.79139978119653,15356.719727000003,16820.019531,92.55722199221987,-7.442778007780138,345.9731223058279,273.5927446798566,0.06513999831594242,3165600.0
1531,BSESN,2009-09-18,16741.300781,16765.029297,16610.050781,16650.050781,28000.0,30.19140600000173,0.0,30.19140600000173,82.39738504645601,15356.719727000003,16820.019531,94.62046329912582,-5.37953670087419,362.2832341062531,291.3308425651359,0.045265107954387984,3193600.0
1532,BSESN,2009-09-22,16886.429688,16943.490234,16763.779297,16805.220703,22800.0,145.12890699999843,0.0,145.12890699999843,85.14030904142872,15356.719727000003,16943.490234,96.40398244432453,-3.596017555675473,382.51046260965086,309.5667665740389,0.047306833350591715,3216400.0
1533,BSESN,2009-09-23,16719.5,16905.580078,16683.779297,16905.5,48400.0,-166.92968800000014,166.92968800000014,0.0,70.55009254413669,15356.719727000003,16943.490234,85.88389228235125,-14.116107717648745,380.68258433043775,323.78993012531873,0.03311697380721834,3168000.0
1534,BSESN,2009-09-24,16781.429688,16834.099609,16494.919922,16634.080078,24600.0,61.92968800000017,0.0,61.92968800000017,72.56279509829184,15358.94043,16943.490234,89.77245488965391,-10.227545110346092,379.85248290563686,335.0024406813824,0.03481372619271328,3192600.0
1535,BSESN,2009-09-25,16693.0,16812.019531,16613.220703,16679.990234,20400.0,-88.42968800000017,88.42968800000017,0.0,65.2190553932415,15793.269531,16943.490234,78.22241998021134,-21.777580019788655,367.81909519212604,341.56577158353116,0.026358355425064595,3172200.0
1536,BSESN,2009-09-29,16852.910156,16907.839844,16802.800781,16829.109375,16000.0,159.9101560000017,0.0,159.9101560000017,71.28314958898221,16030.55957,16943.490234,90.07809885548998,-9.921901144510018,366.9559224457298,346.6438017559709,0.039392637502161154,3188200.0
1537,BSESN,2009-09-30,17126.839844,17142.519531,16868.460938,16868.460938,20600.0,273.92968799999653,0.0,273.92968799999653,78.64308556387024,16044.769531,17142.519531,98.57165228877217,-1.4283477112278244,383.94975455102576,354.1049923149819,0.04086375764091743,3208800.0
1538,BSESN,2009-10-01,17134.550781,17195.609375,17059.359375,17186.199219,28000.0,7.710937000003469,0.0,7.710937000003469,78.8194014394868,16119.950195,17195.609375,94.32361149932284,-5.6763885006771595,393.50363217710037,361.98472028740565,0.027433629931049586,3236800.0
1539,BSESN,2009-10-05,16866.410156,17062.009766,16835.800781,17062.009766,24800.0,-268.140625,268.140625,0.0,59.20704878859484,16119.950195,17195.609375,69.39558318091069,-30.604416819089302,375.1143567311228,364.6106475761491,0.009293265785952798,3212000.0
1540,BSESN,2009-10-06,16958.539063,16988.560547,16622.050781,16879.380859,50200.0,92.12890699999843,0.0,92.12890699999843,62.86978186303968,16119.950195,17195.609375,77.96046216051448,-22.039537839485522,363.78131177793693,364.4447804165067,0.012976188937871891,3262200.0
1541,BSESN,2009-10-07,16806.660156,17120.560547,16764.070313,17069.419922,32800.0,-151.87890699999843,151.87890699999843,0.0,53.698469180588134,16255.419922,17195.609375,58.63076130465825,-41.36923869534175,338.6407932444963,359.28398298210465,-0.004723883821142194,3229400.0
1542,BSESN,2009-10-08,16843.539063,16998.519531,16775.359375,16908.019531,37000.0,36.878906999998435,0.0,36.878906999998435,55.51656330863629,16494.919922,17195.609375,49.753730344789375,-50.24626965521063,318.0265585616653,351.0324980980168,0.007418826101259102,3266400.0
1543,BSESN,2009-10-09,16642.660156,16963.080078,16606.949219,16915.960938,27000.0,-200.87890699999843,200.87890699999843,0.0,44.527645035522035,16494.919922,17195.609375,21.084980424273773,-78.91501957572623,282.22704241344036,337.27140696110155,-0.008269231798481935,3239400.0
1544,BSESN,2009-10-12,17026.669922,17068.779297,16687.320313,16687.320313,24200.0,384.00976599999916,0.0,384.00976599999916,61.386481174374836,16494.919922,17195.609375,75.88953961320732,-24.110460386792674,281.59598354616173,326.1363222781136,0.019988613310968795,3263600.0
1545,BSESN,2009-10-14,17231.109375,17274.589844,17117.900391,17117.900391,31800.0,204.43945299999905,0.0,204.43945299999905,67.4611609309276,16494.919922,17274.589844,94.42322093322994,-5.576779066770055,294.20105352141763,319.7492685267744,0.022441181700915358,3295400.0
1546,BSESN,2009-10-15,17195.199219,17350.390625,17092.830078,17274.070313,30200.0,-35.91015600000173,35.91015600000173,0.0,65.37663613059983,16494.919922,17350.390625,81.85894555409435,-18.14105444590566,297.8594742083369,315.37130966308695,0.003991359504885494,3265200.0
1547,BSESN,2009-10-16,17322.820313,17347.849609,17126.550781,17196.800781,28200.0,127.6210940000019,0.0,127.6210940000019,69.2703493130515,16494.919922,17350.390625,96.77717636579311,-3.2228236342068937,307.5119483509843,313.7994374006664,0.010987713328835191,3293400.0
1548,BSESN,2009-10-20,17223.009766,17457.259766,17185.039063,17414.800781,24600.0,-99.81054700000095,99.81054700000095,0.0,62.888216266197915,16606.949219,17457.259766,72.45124139334006,-27.548758606659945,303.6079235071811,311.7611346219694,0.021142590907119674,3268800.0
1549,BSESN,2009-10-21,17009.169922,17248.689453,16997.859375,17229.720703,25600.0,-213.8398439999983,213.8398439999983,0.0,51.2218887511445,16606.949219,17457.259766,47.30280065548831,-52.69719934451169,280.0308461337481,305.41507692432515,0.002985567259768729,3243200.0
1550,BSESN,2009-10-22,16789.740234,17031.539063,16721.259766,17031.539063,25600.0,-219.42968800000014,219.42968800000014,0.0,41.997406092070996,16606.949219,17457.259766,21.49697138826649,-78.5030286117335,240.863179677257,292.50469747491155,-0.0010067391047923202,3217600.0
1551,BSESN,2009-10-23,16810.810547,17006.769531,16765.199219,16795.660156,24400.0,21.070313000000173,0.0,21.070313000000173,43.1320959176856,16606.949219,17457.259766,23.974926421793807,-76.02507357820619,209.11220466231316,275.8261989123919,-0.001943090218604615,3242000.0
1552,BSESN,2009-10-26,16740.5,16938.880859,16706.080078,16808.050781,22000.0,-70.31054700000095,70.31054700000095,0.0,40.11083104558049,16606.949219,17457.259766,15.706118367128944,-84.29388163287106,176.24422100487936,255.90980333088936,0.005878858492746719,3220000.0
1553,BSESN,2009-10-27,16353.400391,16699.089844,16311.5,16699.089844,30800.0,-387.09960900000084,387.09960900000084,0.0,27.758785928035635,16311.5,17457.259766,3.6569961909449042,-96.34300380905509,117.60472971766285,228.2487886082441,-0.03954205573281688,3189200.0
1554,BSESN,2009-10-28,16283.490234,16411.140625,16144.169922,16335.780272999997,29600.0,-69.91015699999842,69.91015699999842,0.0,26.08487834658662,16144.169922,17457.259766,10.61011267710343,-89.38988732289657,64.74500487761543,195.54803186211836,-0.05499466809576792,3159600.0
1555,BSESN,2009-10-29,16052.719727000003,16264.089844,15993.830078,16191.389647999997,26200.0,-230.77050699999927,230.77050699999927,0.0,21.21277558598105,15993.830078,17457.259766,4.024084620046504,-95.97591537995349,4.183812437382585,157.2751879771712,-0.06644177118562267,3133400.0
1556,BSESN,2009-10-30,15896.280272999997,16360.879883,15805.200195,16135.870117,38600.0,-156.43945400000302,156.43945400000302,0.0,18.508707566472225,15805.200195,17457.259766,5.513123110013884,-94.48687688998612,-55.79159463616088,114.66183145450479,-0.08235033408096082,3094800.0
1557,BSESN,2009-11-03,15404.94043,15957.05957,15330.55957,15838.629883,32400.0,-491.33984299999787,491.33984299999787,0.0,12.660207159731144,15330.55957,17457.259766,3.4974774601469556,-96.50252253985305,-141.34027318510562,63.461410526582696,-0.10556048917704586,3062400.0
1558,BSESN,2009-11-04,15912.129883,15929.089844,15487.969727000003,15487.969727000003,30400.0,507.18945300000087,0.0,507.18945300000087,36.54295978506825,15330.55957,17457.259766,27.346135298893827,-72.65386470110617,-166.29531826835228,17.51006476759569,-0.06449697686781697,3092800.0
1559,BSESN,2009-11-05,16063.900391,16092.379883,15564.889647999997,15926.129883,33800.0,151.77050799999782,0.0,151.77050799999782,42.017345542279564,15330.55957,17457.259766,34.48256704820466,-65.51743295179534,-171.84483935330718,-20.360916056584898,-0.043231153840614045,3126600.0
1560,BSESN,2009-11-06,16158.280272999997,16283.860352000003,16075.19043,16137.419922,28200.0,94.37988199999927,0.0,94.37988199999927,45.397291235191375,15330.55957,17457.259766,38.92042256622791,-61.07957743377208,-166.70552950985984,-49.6298387472399,-0.03881611015576236,3154800.0
1561,BSESN,2009-11-09,16498.720703,16517.419922,16147.209961000002,16190.790038999998,20400.0,340.44043000000056,0.0,340.44043000000056,56.05829585565236,15330.55957,17457.259766,54.92834087273483,-45.07165912726517,-133.6215854500697,-66.42818808780586,-0.01444277632089852,3175200.0
1562,BSESN,2009-11-10,16440.560547,16677.529297,16371.660156,16552.429688,26600.0,-58.1601559999981,58.1601559999981,0.0,53.98072890865467,15330.55957,17248.689453,57.86891632509965,-42.13108367490035,-110.8179199508013,-75.30613446040495,0.005329787928874508,3148600.0
1563,BSESN,2009-11-11,16849.599609,16887.800781,16405.189453,16444.439453,26600.0,409.03906199999983,0.0,409.03906199999983,64.62090816032241,15330.55957,17031.539063,89.30384200698889,-10.696157993011107,-59.05902129524111,-72.05671182737218,0.034765849757318,3175200.0
1564,BSESN,2009-11-12,16696.029297,16896.619141,16605.009766,16822.179688,27200.0,-153.57031199999986,153.57031199999986,0.0,58.73767142874344,15330.55957,17006.769531,81.46173562799868,-18.53826437200133,-30.084763519000262,-63.6623221656978,0.040074802335082094,3148000.0
1565,BSESN,2009-11-13,16848.830078,16909.740234,16666.699219,16693.150391,21400.0,152.8007809999981,0.0,152.8007809999981,62.64238045130661,15330.55957,16938.880859,94.40094578018102,-5.599054219818989,5.147948191948672,-49.90026809416851,0.05992281141506539,3169400.0
1566,BSESN,2009-11-16,17032.509766,17083.199219,16893.109375,16893.109375,19000.0,183.67968800000014,0.0,183.67968800000014,66.9768583786886,15330.55957,17083.199219,97.10782230512012,-2.8921776948798836,47.34576925104193,-30.45106062512642,0.10565242646640982,3188400.0
1567,BSESN,2009-11-17,17050.650391,17080.169922,16882.980469,17036.230469,20400.0,18.140625,0.0,18.140625,67.407792024124,15330.55957,17083.199219,98.14286821489115,-1.8571317851088436,81.3143026249636,-8.09798797510841,0.07155047855764152,3208800.0
1568,BSESN,2009-11-18,16998.779297,17098.789063,16958.410156,17032.009766,18200.0,-51.87109399999825,51.87109399999825,0.0,64.62541222707844,15330.55957,17098.789063,94.34407318756337,-5.655926812436625,102.8633021558162,14.09427005107652,0.05819750392151213,3190600.0
1569,BSESN,2009-11-19,16785.650391,17004.980469,16712.330078,17004.980469,18200.0,-213.1289060000017,213.1289060000017,0.0,54.04858331927737,15330.55957,17098.789063,82.29083536726186,-17.709164632738133,101.57245399160092,31.589906839181406,0.038826540163950485,3172400.0
1570,BSESN,2009-11-20,17021.849609,17041.789063,16635.75,16772.75,22400.0,236.1992180000016,0.0,236.1992180000016,62.00113929984476,15330.55957,17098.789063,95.64878573145712,-4.351214268542876,118.24568773198189,48.92106301774151,0.031707240544103454,3194800.0
1571,BSESN,2009-11-23,17180.179688,17214.580078,17045.019531,17067.140625,22000.0,158.33007899999942,0.0,158.33007899999942,66.48707499847544,15487.969727000003,17214.580078,98.0076344393467,-1.9923655606532944,142.59155308718982,67.65516103163118,0.044987464927706666,3216800.0
1572,BSESN,2009-11-24,17131.080078,17230.859375,17027.519531,17230.859375,18200.0,-49.099610000001114,49.099610000001114,0.0,63.792355124719606,15564.889647999997,17230.859375,94.01073768731209,-5.989262312687915,156.12419605110335,85.34896803552563,0.016705469300863918,3198600.0
1573,BSESN,2009-11-25,17198.949219,17290.480469,17124.150391,17149.080078,17000.0,67.86914099999922,0.0,67.86914099999922,65.99079738742884,16075.19043,17290.480469,92.46836170274904,-7.531638297250964,170.36156351227328,102.35148713087517,0.03012212742645115,3215600.0
1574,BSESN,2009-11-26,16854.929688,17202.509766,16808.869141,17199.050781,24000.0,-344.0195309999981,344.0195309999981,0.0,48.69743249680962,16147.209961000002,17290.480469,61.903086106722206,-38.096913893277794,152.13160034923567,112.30750977454728,0.0003620197943574599,3191600.0
1575,BSESN,2009-11-27,16632.009766,16718.800781,16210.44043,16718.800781,28400.0,-222.91992200000092,222.91992200000092,0.0,40.71916363075927,16210.44043,17290.480469,39.032750710828005,-60.967249289171995,118.33238642549622,113.51248510473708,-0.02351385705936726,3163200.0
1576,BSESN,2009-11-30,16926.220703,17026.910156,16655.75,16655.75,23200.0,294.21093699999983,0.0,294.21093699999983,52.556132936205294,16210.44043,17290.480469,66.27349423663358,-33.726505763366426,113.97282192769126,113.60455246932793,-0.0072976505380509815,3186400.0
1577,BSESN,2009-12-01,17198.269531,17218.460938,16947.460938,16947.460938,20000.0,272.0488280000027,0.0,272.0488280000027,60.88847201654083,16210.44043,17290.480469,91.46226670583675,-8.537733294163248,130.96027394875273,117.07569676521288,0.011735562331538052,3206400.0
1578,BSESN,2009-12-02,17169.910156,17329.679688,17142.359375,17226.490234,22200.0,-28.359375,28.359375,0.0,59.628847874719625,16210.44043,17329.679688,85.72516726356658,-14.274832736433417,140.5148201310767,121.76352143838567,0.02289215824523727,3184200.0
1579,BSESN,2009-12-03,17185.679688,17361.269531,17128.210938,17199.640625,18200.0,15.769531999998437,0.0,15.769531999998437,60.15768329968403,16210.44043,17361.269531,84.74231813851209,-15.25768186148791,147.65723556018202,126.94226426274494,0.009624693130491302,3202400.0
1580,BSESN,2009-12-04,17101.539063,17291.830078,17032.810547,17182.230469,18200.0,-84.140625,84.140625,0.0,55.668247351865666,16210.44043,17361.269531,77.43101319089763,-22.568986809102363,144.85836889568964,130.5254851893339,-0.004577404103341731,3184200.0
1581,BSESN,2009-12-07,16983.140625,17176.619141,16943.009766,17106.740234,21000.0,-118.39843800000016,118.39843800000016,0.0,49.652001409997034,16210.44043,17361.269531,67.1429141241362,-32.8570858758638,131.56982737911312,130.73435362728975,-0.008635734135058137,3163200.0
1582,BSESN,2009-12-08,17227.679688,17237.789063,16964.109375,16984.539063,18600.0,244.53906300000014,0.0,244.53906300000014,59.963547743452246,16210.44043,17361.269531,88.39186088673635,-11.608139113263649,139.16659529200479,132.42080196023275,0.0016704781573668726,3181800.0
1583,BSESN,2009-12-09,17125.220703,17227.960938,17057.369141,17204.320313,21800.0,-102.45898500000112,102.45898500000112,0.0,54.561282896534216,16210.44043,17361.269531,79.48880265585129,-20.51119734414871,135.3591685537649,133.0084752789392,0.016036318157555796,3160000.0
1584,BSESN,2009-12-10,17189.310547,17231.050781,17032.300781,17107.0,19200.0,64.0898440000019,0.0,64.0898440000019,57.33551103116317,16210.44043,17361.269531,85.05781754644727,-14.94218245355273,135.9461674277445,133.59601370870024,0.03350772329025831,3179200.0
1585,BSESN,2009-12-11,17119.029297,17351.710938,17056.119141,17199.740234,19200.0,-70.28125,70.28125,0.0,53.22382132658017,16210.44043,17361.269531,78.95080739707497,-21.049192602925025,129.25034127570325,132.72687922210085,0.011391118985340176,3160000.0
1586,BSESN,2009-12-14,17097.550781,17275.189453,17048.169922,17118.140625,17200.0,-21.478515999999214,21.478515999999214,0.0,51.911108735583085,16210.44043,17361.269531,77.08445591349364,-22.915544086506355,120.81799938136464,130.3451032539536,-0.0058563304766479085,3142800.0
1587,BSESN,2009-12-15,16877.160156,17200.470703,16835.779297,17150.589844,18600.0,-220.390625,220.390625,0.0,40.17851085013998,16210.44043,17361.269531,57.93386050288978,-42.06613949711022,95.25360189284766,123.3268029817324,-0.01705017657868746,3124200.0
1588,BSESN,2009-12-16,16912.769531,16996.119141,16777.939453,16866.949219,19400.0,35.609375,0.0,35.609375,42.59723229691254,16210.44043,17361.269531,61.02809708146235,-38.971902918537644,76.97963831189918,114.05737004776576,-0.015880090980082695,3143600.0
1589,BSESN,2009-12-17,16894.25,16979.519531,16826.0,16912.25,22000.0,-18.519531000001734,18.519531000001734,0.0,41.588183595272156,16655.75,17361.269531,33.80487563001277,-66.19512436998723,60.307828038370644,103.30746164588673,-0.012121076485360316,3121600.0
1590,BSESN,2009-12-18,16719.830078,16899.189453,16693.060547,16855.910156,18600.0,-174.41992200000095,174.41992200000095,0.0,33.07417980347911,16693.060547,17361.269531,4.006161491536915,-95.99383850846309,32.644759795141,89.17492127573759,-0.015504231685651515,3103000.0
1591,BSESN,2009-12-21,16601.199219,16750.990234,16577.779297,16724.839844,17200.0,-118.63085900000078,118.63085900000078,0.0,28.495959695504027,16577.779297,17361.269531,2.9891785479482174,-97.01082145205179,1.1359653277067991,71.56713008613143,-0.03636476184522863,3085800.0
1592,BSESN,2009-12-22,16692.0,16738.119141,16633.810547,16633.810547,14400.0,90.80078100000172,0.0,90.80078100000172,36.28508210280069,16577.779297,17361.269531,14.578446296243042,-85.42155370375696,-16.31999043255928,53.98970598239328,-0.025297233274436448,3100200.0
1593,BSESN,2010-01-04,17558.730469,17582.839844,17378.380859,17473.449219,28200.0,866.7304689999983,0.0,866.7304689999983,71.0357305348729,16577.779297,17582.839844,97.60120173138186,-2.3987982686181457,39.330565862757794,51.057877958466186,0.021491258825646842,3128400.0
1594,BSESN,2010-01-05,17686.240234,17729.779297,17555.769531,17555.769531,27000.0,127.50976500000252,0.0,127.50976500000252,73.49008563752331,16577.779297,17729.779297,96.22056744791665,-3.779432552083348,92.65493662560766,59.3772896918945,0.03313335862445199,3155400.0
1595,BSESN,2010-01-06,17701.130859,17790.330078,17636.710938,17719.470703,21400.0,14.890625,0.0,14.890625,73.78936021653615,16577.779297,17790.330078,92.64367147358273,-7.35632852641727,134.5652491990586,74.41488159332732,0.03530213688095829,3176800.0
1596,BSESN,2010-01-07,17615.720703,17733.339844,17566.539063,17701.970703,18000.0,-85.41015600000173,85.41015600000173,0.0,68.65948786399743,16577.779297,17790.330078,85.59982990106208,-14.400170098937926,159.05411128709966,91.3427275320818,0.04376094912729922,3158800.0
1597,BSESN,2010-01-08,17540.289063,17658.119141,17508.960938,17603.869141,17200.0,-75.43163999999888,75.43163999999888,0.0,64.11715458211847,16577.779297,17790.330078,79.37892425471958,-20.621075745280418,170.41062042973135,107.15630611161173,0.03710329824159175,3141600.0
1598,BSESN,2010-01-11,17526.710938,17776.570313,17500.789063,17724.589844,18400.0,-13.578125,13.578125,0.0,63.24807428758419,16577.779297,17790.330078,78.25912579243976,-21.740874207560243,176.28301368472967,120.98164762623533,0.03743646139958856,3123200.0
1599,BSESN,2010-01-12,17422.509766,17612.0,17392.550781,17534.099609,18600.0,-104.20117200000095,104.20117200000095,0.0,56.470308875014446,16577.779297,17790.330078,69.66557460821096,-30.33442539178905,170.56262415306992,130.89784293160227,0.04202672423833942,3104600.0
1600,BSESN,2010-01-13,17509.800781,17528.310547,17276.460938,17368.029297,26200.0,87.29101500000252,0.0,87.29101500000252,60.55599566530234,16577.779297,17790.330078,76.86453207603866,-23.135467923961343,171.10048968634146,138.93837228255012,0.05473107996680815,3130800.0
1601,BSESN,2010-01-14,17584.869141,17628.039063,17525.710938,17525.710938,23400.0,75.06835999999748,0.0,75.06835999999748,63.91663430249351,16577.779297,17790.330078,83.05547774002876,-16.944522259971244,175.56039037838127,146.26277590171637,0.053490842379583015,3154200.0
1602,BSESN,2010-01-15,17554.300781,17639.849609,17529.109375,17604.310547,17600.0,-30.568359999997483,30.568359999997483,0.0,61.45642950330312,16577.779297,17790.330078,80.53448146680154,-19.465518533198463,174.6154247054401,151.93330566246112,-0.00025227837558172705,3136600.0
1603,BSESN,2010-01-18,17641.080078,17712.599609,17505.5,17538.720703,15400.0,86.77929699999731,0.0,86.77929699999731,65.77193440248735,16577.779297,17790.330078,87.69123715569978,-12.308762844300228,178.80771261746122,157.30818705346115,-0.0025534062300694993,3152000.0
1604,BSESN,2010-01-19,17486.060547,17664.859375,17463.779297,17650.820313,13400.0,-155.0195309999981,155.0195309999981,0.0,53.43923604065439,16577.779297,17790.330078,74.90665663098537,-25.093343369014626,167.6883435500422,159.38421835277737,-0.012150088811452964,3138600.0
1605,BSESN,2010-01-20,17474.490234,17590.589844,17425.050781,17486.689453,17000.0,-11.57031300000017,11.57031300000017,0.0,52.59000222416814,16633.810547,17790.330078,72.6904876628496,-27.309512337150387,156.1426209524907,158.73589887272004,-0.00801729724154554,3121600.0
1606,BSESN,2010-01-21,17051.140625,17474.490234,17025.259766,17474.490234,17200.0,-423.34960900000084,423.34960900000084,0.0,31.473731066021443,17025.259766,17790.330078,3.3828079058962084,-96.61719209410379,111.54594502617692,149.29790810341143,-0.027887136651118527,3104400.0
1607,BSESN,2010-01-22,16859.679688,17000.330078,16608.089844,16978.359375,23200.0,-191.46093699999986,191.46093699999986,0.0,26.021489210595774,16608.089844,17790.330078,21.280771603312036,-78.71922839668797,60.06111341409269,131.45054916554767,-0.03805798203436994,3081200.0
1608,BSESN,2010-01-25,16780.460938,16877.769531,16705.560547,16847.699219,16400.0,-79.21875,79.21875,0.0,24.033814552432446,16608.089844,17790.330078,14.580039575949822,-85.41996042405017,12.720093052328593,107.70445794290384,-0.036851684207573565,3064800.0
1609,BSESN,2010-01-27,16289.820313,16708.599609,16230.849609,16708.599609,25600.0,-490.640625,490.640625,0.0,15.547019396916184,16230.849609,17776.570313,3.8150943988390424,-96.18490560116095,-63.654831368454325,73.4326000806322,-0.06967414896712076,3039200.0
1610,BSESN,2010-01-28,16306.870117,16524.689453,16182.139647999997,16317.160156,21600.0,17.049803999998407,0.0,17.049803999998407,16.72607380933428,16182.139647999997,17776.570313,7.822884477701854,-92.17711552229815,-121.40722560846189,34.46463494281337,-0.07267606109278801,3060800.0
1611,BSESN,2010-01-29,16357.959961000002,16390.310547,15982.080078,16253.820313,25400.0,51.08984400000372,0.0,51.08984400000372,20.560652267965864,15982.080078,17776.570313,20.94633203729869,-79.05366796270131,-161.19572669555055,-4.6674373848594275,-0.06815086712510166,3086200.0
1612,BSESN,2010-02-01,16356.030272999997,16422.400391,16160.799805,16339.320313,20000.0,-1.9296880000038072,1.9296880000038072,0.0,20.519473322310432,15982.080078,17712.599609,21.609128836812637,-78.39087116318736,-190.68600064474595,-41.871150036836745,-0.07284416823222595,3066200.0
1613,BSESN,2010-02-02,16163.44043,16525.980469,16129.110352000003,16368.44043,20600.0,-192.58984299999798,192.58984299999798,0.0,16.67383797223556,15982.080078,17712.599609,10.480110091285628,-89.51988990871438,-226.98114861468275,-78.89314975240596,-0.07563854153684235,3045600.0
1614,BSESN,2010-02-03,16496.050781,16552.990234,16210.25,16210.25,16400.0,332.6103510000012,0.0,332.6103510000012,39.33151302851088,15982.080078,17712.599609,29.70036996363729,-70.29963003636271,-226.29781889751757,-108.3740835814283,-0.055992446125624595,3062000.0
1615,BSESN,2010-02-04,16224.950195,16508.220703,16188.799805,16500.289063,15800.0,-271.10058600000235,271.10058600000235,0.0,31.321707126390052,15982.080078,17712.599609,14.034520422872857,-85.96547957712714,-244.80981166158745,-135.66122919746013,-0.04845367522150734,3046200.0
1616,BSESN,2010-02-05,15790.929688,16222.55957,15725.429688,16222.55957,23000.0,-434.0205069999992,434.0205069999992,0.0,22.75970018127302,15725.429688,17712.599609,3.296144899729487,-96.7038551002705,-291.14637279968883,-166.7582579179059,-0.06339088403682369,3023200.0
1617,BSESN,2010-02-08,15935.610352000003,16061.410156,15651.990234,15931.339844,26600.0,144.68066400000134,0.0,144.68066400000134,30.1082894021922,15651.990234,17664.859375,14.090340609976229,-85.90965939002378,-312.5905614885196,-195.92471863202866,-0.05034728122913479,3049800.0
1618,BSESN,2010-02-09,16042.179688,16094.129883,15862.900391,15940.730469,21200.0,106.56933599999867,0.0,106.56933599999867,35.33689906679622,15651.990234,17590.589844,20.127387418591294,-79.8726125814087,-317.328020848845,-220.20537907539196,-0.015202170450116737,3071000.0
1619,BSESN,2010-02-10,15922.169922,16141.129883,15892.009766,16042.179688,19800.0,-120.00976600000105,120.00976600000105,0.0,32.206259464925864,15651.990234,17474.490234,14.824674238683036,-85.17532576131697,-326.99686041777204,-241.563675343868,-0.02359129570787155,3051200.0
1620,BSESN,2010-02-11,16152.589844,16202.870117,15928.280272999997,15928.280272999997,14400.0,230.41992200000092,0.0,230.41992200000092,43.329108148609166,15651.990234,17000.330078,37.12710947671142,-62.87289052328858,-312.46462572769815,-255.74386542063402,-0.012554751172495715,3065600.0
1621,BSESN,2010-02-15,16038.349609,16227.040038999998,16011.820313,16186.900391,17000.0,-114.24023499999929,114.24023499999929,0.0,39.611256782476225,15651.990234,16877.769531,31.519489352249984,-68.48051064775001,-306.6313024721985,-265.92135283094694,-0.01942284641796077,3048600.0
1622,BSESN,2010-02-16,16226.679688,16310.389647999997,16021.290038999998,16042.179688,20600.0,188.3300789999994,0.0,188.3300789999994,48.08463668868784,15651.990234,16708.599609,54.389963556777964,-45.61003644322204,-283.5431790615112,-269.4457180770598,0.003912487460443481,3069200.0
1623,BSESN,2010-02-17,16428.910156,16480.890625,16228.910156,16228.910156,19600.0,202.2304680000016,0.0,202.2304680000016,55.773438516830296,15651.990234,16552.990234,86.22862619311886,-13.771373806881137,-246.09058715784704,-264.7746918932172,-0.004070102953206978,3088800.0
1624,BSESN,2010-02-18,16327.839844,16452.509766,16287.169922,16421.199219,14000.0,-101.07031200000164,101.07031200000164,0.0,51.38486930155505,15651.990234,16552.990234,75.0110554938956,-24.988944506104403,-222.00552622867872,-256.2208587603095,0.00634144621483701,3074800.0
1625,BSESN,2010-02-19,16191.629883,16301.94043,16074.580078,16256.530272999997,19400.0,-136.20996099999866,136.20996099999866,0.0,45.78300027406138,15651.990234,16552.990234,59.893412763595876,-40.106587236404124,-211.47123861489854,-247.2709347312273,0.025375339065976776,3055400.0
1626,BSESN,2010-02-22,16237.049805,16423.230469,16191.320313,16191.320313,14000.0,45.41992199999913,0.0,45.41992199999913,47.96559793349001,15651.990234,16552.990234,64.93446958934514,-35.06553041065486,-197.18470908712334,-237.25368960240652,0.0189160908394177,3069400.0
1627,BSESN,2010-02-23,16286.320313,16324.929688,16178.910156,16213.139647999997,13400.0,49.27050799999961,0.0,49.27050799999961,50.46173023783625,15651.990234,16552.990234,70.40289445061036,-29.597105549389635,-179.81402908573727,-225.7657574990727,0.015218669142736507,3082800.0
1628,BSESN,2010-02-24,16255.969727000003,16328.44043,16187.44043,16218.679688,12400.0,-30.350585999998657,30.350585999998657,0.0,48.797910744520465,15651.990234,16508.220703,70.53936000495257,-29.460639995047433,-166.57648860504378,-213.92790372026693,0.020964466943590665,3070400.0
1629,BSESN,2010-02-25,16254.200195,16329.330078,16167.129883,16264.099609,12200.0,-1.7695320000020733,1.7695320000020733,0.0,48.6899111067015,15651.990234,16480.890625,72.65166810616202,-27.348331893837987,-154.44804789105183,-202.03193255442392,0.006290653819687186,3058200.0
1630,BSESN,2010-02-26,16429.550781,16669.25,16249.669922,16255.330078,31000.0,175.35058600000232,0.0,175.35058600000232,59.052060156040476,15651.990234,16669.25,76.43677386922246,-23.56322613077754,-129.19753565198334,-187.46505317393581,0.02439161020535896,3089200.0
1631,BSESN,2010-03-02,16772.560547,16808.490234,16438.449219,16438.449219,22400.0,343.0097659999992,0.0,343.0097659999992,71.87295516413604,15862.900391,16808.490234,96.20028839501825,-3.7997116049817565,-80.57943178773348,-166.08792889669536,0.03364094623767633,3111600.0
1632,BSESN,2010-03-03,17000.009766,17012.609375,16778.289063,16778.289063,20000.0,227.4492189999983,0.0,227.4492189999983,77.30882595856943,15892.009766,17012.609375,98.8756368555898,-1.1243631444101971,-23.425943406480656,-137.55553179865242,0.03476186822967242,3131600.0
1633,BSESN,2010-03-04,16971.699219,17024.960938,16888.050781,17013.679688,19000.0,-28.31054700000095,28.31054700000095,0.0,75.22099276327614,15928.280272999997,17024.960938,95.1433702900195,-4.856629709980501,19.361001785739063,-106.17222508177412,0.03943322455092546,3112600.0
1634,BSESN,2010-03-05,16994.490234,17097.710938,16936.119141,16988.289063,19600.0,22.791015000002517,0.0,22.791015000002517,75.82738504881158,16011.820313,17097.710938,90.4943737772854,-9.505626222714593,54.48098566243061,-74.04158293293317,0.04958490014911621,3132200.0
1635,BSESN,2010-03-08,17102.599609,17187.550781,17034.919922,17034.919922,15200.0,108.109375,0.0,108.109375,78.68267413630099,16021.290038999998,17187.550781,92.71593658770342,-7.284063412296583,89.99988629901054,-41.23328908654442,0.053307085609447746,3147400.0
1636,BSESN,2010-03-09,17052.539063,17130.830078,17031.210938,17089.220703,56600.0,-50.06054600000061,50.06054600000061,0.0,74.0117050506451,16074.580078,17187.550781,87.86924780355145,-12.130752196448558,112.80901120460476,-10.424829028314575,0.04704676902298144,3090800.0
1637,BSESN,2010-03-10,17098.330078,17183.509766,17027.919922,17072.939453,16800.0,45.791014999998886,0.0,45.791014999998886,75.54401172659843,16074.580078,17187.550781,91.98355331730573,-8.016446682694271,133.04667993457406,18.269472764263163,0.05181852360372541,3107600.0
1638,BSESN,2010-03-11,17167.960938,17215.070313,17054.279297,17087.630859,11400.0,69.63086000000112,0.0,69.63086000000112,77.83682782638962,16074.580078,17215.070313,95.86937497978664,-4.130625020213349,152.9408003362987,45.20373827867028,0.056216899757459915,3119000.0
1639,BSESN,2010-03-12,17166.619141,17244.539063,17126.929688,17176.019531,24000.0,-1.3417970000009518,1.3417970000009518,0.0,77.67490886044136,16167.129883,17244.539063,92.7678431327269,-7.232156867273111,166.6774088637285,69.49847239568194,0.04486235623997592,3095000.0
1640,BSESN,2010-03-15,17164.990234,17195.490234,17061.140625,17166.970703,14200.0,-1.6289069999984351,1.6289069999984351,0.0,77.44923197028149,16167.129883,17244.539063,92.6166557259147,-7.383344274085296,175.41031004203978,90.68083992495352,0.02339712448199749,3080800.0
1641,BSESN,2010-03-16,17383.179688,17416.550781,17150.060547,17169.839844,12400.0,218.1894539999994,0.0,218.1894539999994,84.43751687506321,16167.129883,17416.550781,97.32907516967101,-2.670924830328995,197.65877527243356,112.07642699444955,0.022539394228251686,3093200.0
1642,BSESN,2010-03-17,17490.080078,17576.779297,17389.470703,17389.470703,16800.0,106.90038999999888,0.0,106.90038999999888,86.75744482301032,16167.129883,17576.779297,93.84958996620405,-6.150410033795951,221.36505378317088,133.93415235219382,0.03054383961858509,3110000.0
1643,BSESN,2010-03-18,17519.259766,17548.130859,17417.609375,17492.810547,13600.0,29.179688000000173,0.0,29.179688000000173,87.35131333486855,16249.669922,17576.779297,95.66580328015529,-4.334196719844711,239.74339463593424,155.0960008089419,0.030878803940239452,3123600.0
1644,BSESN,2010-03-19,17578.230469,17600.869141,17502.140625,17531.470703,13800.0,58.97070299999905,0.0,58.97070299999905,88.5488059645526,16438.449219,17600.869141,98.05245319943846,-1.9475468005615386,256.1144768010781,175.29969600736916,0.027810442323031648,3137400.0
1645,BSESN,2010-03-22,17410.570313,17559.179688,17337.380859,17481.960938,12200.0,-167.6601559999981,167.6601559999981,0.0,67.56476398581091,16778.289063,17600.869141,76.86561672357944,-23.13438327642057,252.64754039141917,190.7692648841792,0.020995773630968717,3125200.0
1646,BSESN,2010-03-23,17451.019531,17530.789063,17356.640625,17422.509766,12600.0,40.44921800000157,0.0,40.44921800000157,69.57204151486557,16888.050781,17600.869141,78.97786892021159,-21.022131079788405,250.27882366714402,202.6711766407722,0.020627128578702525,3137800.0
1647,BSESN,2010-03-25,17558.849609,17575.230469,17383.210938,17458.509766,13800.0,107.83007799999905,0.0,107.83007799999905,74.43794811664985,16936.119141,17600.869141,93.67889702895849,-6.321102971041509,254.17264073311162,212.97146945924013,0.022768497226411943,3151600.0
1648,BSESN,2010-03-26,17644.759766,17682.939453,17558.849609,17558.849609,13000.0,85.91015699999843,0.0,85.91015699999843,77.71416316119057,17027.919922,17682.939453,94.17121395728276,-5.828786042717242,261.1800296966685,222.61318150672585,0.027852929052176068,3164600.0
1649,BSESN,2010-03-29,17711.349609,17793.009766,17639.179688,17639.179688,14800.0,66.58984300000158,0.0,66.58984300000158,80.00601924607977,17027.919922,17793.009766,89.32672317631776,-10.673276823682242,269.00574892798613,231.89169499097792,0.03182986809498933,3179400.0
1650,BSESN,2010-03-30,17590.169922,17783.349609,17558.220703,17703.669922,12600.0,-121.17968699999984,121.17968699999984,0.0,65.79780372788608,17027.919922,17793.009766,73.48810135297016,-26.51189864702984,262.40466219550945,237.99428843188426,0.01190750125783313,3166800.0
1651,BSESN,2010-03-31,17527.769531,17699.5,17488.550781,17602.390625,13600.0,-62.40039099999922,62.40039099999922,0.0,59.51767922718478,17054.279297,17793.009766,64.0951272310391,-35.90487276896089,249.26469510658717,240.24836976682485,0.0021549045419986257,3153200.0
1652,BSESN,2010-04-01,17692.619141,17706.560547,17555.039063,17555.039063,13000.0,164.84960999999745,0.0,164.84960999999745,68.6412381753955,17061.140625,17793.009766,86.28298156377656,-13.717018436223437,249.27962203000425,242.05462021946076,0.009895359582283492,3166200.0
1653,BSESN,2010-04-05,17935.679688,17948.539063,17693.660156,17693.660156,12800.0,243.06054700000092,0.0,243.06054700000092,77.33241501941215,17061.140625,17948.539063,98.55089050765267,-1.449109492347337,265.83996884430235,246.8116899444291,0.020334766894220646,3179000.0
1654,BSESN,2010-04-06,17941.369141,17991.410156,17898.0,17940.320313,12400.0,5.689452999999047,0.0,5.689452999999047,77.50083362117465,17150.060547,17991.410156,94.05229235686227,-5.947707643137737,276.23894372337236,252.69714070021777,0.030487159148581577,3191400.0
1655,BSESN,2010-04-07,17970.019531,18047.859375,17878.310547,17915.599609,13200.0,28.650390000002517,0.0,28.650390000002517,78.43194928296313,17337.380859,18047.859375,89.04402564651254,-10.955974353487468,283.52376775999073,258.8624661121724,0.029740382736839432,3204600.0
1656,BSESN,2010-04-08,17714.400391,17960.910156,17679.339844,17950.560547,11800.0,-255.6191400000025,255.6191400000025,0.0,54.999916259982875,17337.380859,18047.859375,53.06557812931797,-46.93442187068204,265.60894046377507,260.21176098249293,0.008858825348117882,3192800.0
1657,BSESN,2010-04-09,17933.140625,17971.470703,17715.160156,17715.160156,12200.0,218.7402340000008,0.0,218.7402340000008,65.25050244052478,17337.380859,18047.859375,83.85331189944101,-16.146688100558993,265.99558799564693,261.36852638512374,0.016343711267505334,3205000.0
1658,BSESN,2010-04-12,17853.0,17995.25,17816.189453,17874.160156,9800.0,-80.140625,80.140625,0.0,59.51906641392962,17337.380859,18047.859375,72.57350213809981,-27.426497861900188,256.874243891034,260.4696698863058,0.007997718645225138,3195200.0
1659,BSESN,2010-04-13,17821.960938,17892.779297,17736.089844,17831.380859,12800.0,-31.039061999999827,31.039061999999827,0.0,57.27095523085691,17356.640625,18047.859375,67.31882099552423,-32.681179004475766,244.3244993316839,257.2406357753814,0.013177303973061605,3182400.0
1660,BSESN,2010-04-15,17639.259766,17975.570313,17619.019531,17804.550781,12600.0,-182.70117200000092,182.70117200000092,0.0,45.57857199699578,17383.210938,18047.859375,38.52394946653566,-61.476050533464345,217.13330113468328,249.21916884724178,0.006360777097326187,3169800.0
1661,BSESN,2010-04-16,17591.179688,17663.990234,17529.550781,17645.910156,11600.0,-48.08007799999905,48.08007799999905,0.0,42.917972245068434,17488.550781,18047.859375,18.3492454972002,-81.6507545027998,189.5197544317889,237.27928596415123,-0.005733433370807672,3158200.0
1662,BSESN,2010-04-19,17400.679688,17584.859375,17276.800781,17584.859375,11800.0,-190.5,190.5,0.0,33.87722408054066,17276.800781,18047.859375,16.066082132274207,-83.9339178677258,150.5288588163421,219.92920053458943,-0.029828811023980606,3146400.0
1663,BSESN,2010-04-20,17460.580078,17560.089844,17394.679688,17394.679688,14000.0,59.900389999998886,0.0,59.900389999998886,38.57199258179094,17276.800781,18047.859375,23.83467332185623,-76.16532667814377,123.04338642456787,200.55203771258513,-0.026797791139656746,3160400.0
1664,BSESN,2010-04-21,17472.560547,17565.550781,17446.509766,17458.759766,10000.0,11.980469000001905,0.0,11.980469000001905,39.56228446913125,17276.800781,18047.859375,25.388442269278393,-74.61155773072161,101.06268750309391,180.65416767068692,-0.02768271804834921,3170400.0
1665,BSESN,2010-04-22,17573.990234,17778.339844,17408.019531,17476.480469,17600.0,101.42968699999984,0.0,101.42968699999984,47.785261429563974,17276.800781,18047.859375,38.54304398039039,-61.45695601960962,90.78088773837226,162.679511684224,-0.007926328518087167,3188000.0
1666,BSESN,2010-04-23,17694.199219,17725.880859,17533.880859,17533.880859,17200.0,120.20898499999748,0.0,120.20898499999748,55.976114811205335,17276.800781,18047.859375,54.13316721297026,-45.866832787029736,91.280127321701,148.3996348117194,-0.013324013400469403,3205200.0
1667,BSESN,2010-04-26,17745.279297,17826.480469,17692.259766,17692.259766,14800.0,51.080078000002686,0.0,51.080078000002686,59.12028759628802,17276.800781,18047.859375,60.75783599916665,-39.24216400083335,94.70580413118296,137.66086867561214,-0.006033759200134381,3220000.0
1668,BSESN,2010-04-27,17690.619141,17769.25,17678.560547,17744.929688,12200.0,-54.66015600000173,54.66015600000173,0.0,54.329357562837046,17276.800781,18047.859375,53.66886034603985,-46.33113965396014,91.95011620549485,128.51871818158867,-0.0073696602442862025,3207800.0
1669,BSESN,2010-04-28,17380.080078,17643.589844,17344.580078,17643.589844,17000.0,-310.53906300000017,310.53906300000017,0.0,35.48103094632441,17276.800781,17995.25,14.375309245064063,-85.62469075493594,63.97088997077299,115.60915253942552,-0.0146933426593997,3190800.0
1670,BSESN,2010-04-29,17503.470703,17532.859375,17382.089844,17382.089844,10800.0,123.390625,0.0,123.390625,44.33493448972447,17276.800781,17995.25,31.5498877311742,-68.4501122688258,51.16395756498605,102.72011354453763,-0.004985963792970227,3201600.0
1671,BSESN,2010-04-30,17558.710938,17646.609375,17503.470703,17503.470703,12200.0,55.240235000001114,0.0,55.240235000001114,48.019680616038436,17276.800781,17995.25,39.238703243687304,-60.7612967563127,44.95359955401727,91.16681074643357,0.009081900985108193,3213800.0
1672,BSESN,2010-05-03,17386.080078,17536.859375,17345.919922,17536.859375,10400.0,-172.6308600000011,172.6308600000011,0.0,38.766478958530286,17276.800781,17975.570313,15.638818236281882,-84.36118176371812,25.804519977857126,78.09435259271828,-0.004266754006292617,3203400.0
1673,BSESN,2010-05-04,17137.140625,17464.820313,17101.960938,17371.75,19800.0,-248.93945299999905,248.93945299999905,0.0,29.354668972781937,17101.960938,17975.570313,4.02693560837758,-95.97306439162242,-9.35080665278656,60.60532074361731,-0.019196952907831966,3183600.0
1674,BSESN,2010-05-05,17087.960938,17121.660156,16858.230469,17103.949219,20000.0,-49.17968699999983,49.17968699999983,0.0,27.815307559283966,16858.230469,17826.480469,23.72635879163459,-76.27364120836542,-40.710757743428985,40.34210504620805,-0.0276561719637064,3163600.0
1675,BSESN,2010-05-06,16987.529297,17080.470703,16823.0,17080.470703,16400.0,-100.43164099999922,100.43164099999922,0.0,24.75629184551778,16823.0,17826.480469,16.395864402219992,-83.60413559778,-72.82822061224215,17.708039914518004,-0.03993794312212651,3147200.0
1676,BSESN,2010-05-07,16769.109375,16939.580078,16684.130859,16939.580078,19400.0,-218.41992200000092,218.41992200000092,0.0,19.40188503958349,16684.130859,17826.480469,7.438923710929389,-92.56107628907061,-114.58533520618585,-8.750635109622776,-0.05501011878494533,3127800.0
1677,BSESN,2010-05-10,17330.550781,17356.539063,16799.490234,16799.490234,19800.0,561.4414060000017,0.0,561.4414060000017,50.89923988095043,16684.130859,17826.480469,56.586872910124455,-43.413127089875545,-101.20785886576414,-27.242079860851053,-0.020353632460805127,3147600.0
1678,BSESN,2010-05-11,17141.529297,17379.150391,17104.449219,17336.130859,20400.0,-189.0214840000008,189.0214840000008,0.0,44.19061000573226,16684.130859,17826.480469,40.04014480295583,-59.95985519704418,-104.65220109630536,-42.72410410794192,-0.013725528301906986,3127200.0
1679,BSESN,2010-05-12,17195.810547,17252.519531,17028.080078,17141.529297,18400.0,54.28125,0.0,54.28125,46.525960687944156,16684.130859,17826.480469,44.791864375040255,-55.208135624959745,-101.82801394249691,-54.54488607485293,-0.017577094350051725,3145600.0
1680,BSESN,2010-05-13,17265.869141,17389.150391,17240.349609,17323.630859,18000.0,70.05859399999828,0.0,70.05859399999828,49.66280744538704,16684.130859,17826.480469,50.92471489529372,-49.07528510470628,-92.86617874287549,-62.20914460845745,-0.016677864225570382,3163600.0
1681,BSESN,2010-05-14,16994.599609,17329.320313,16923.650391,17267.25,15200.0,-271.26953199999843,271.26953199999843,0.0,39.34989374563474,16684.130859,17769.25,28.61148958388895,-71.38851041611105,-106.42622860365373,-71.05256140749671,-0.022516890940550205,3148400.0
1682,BSESN,2010-05-17,16835.560547,16961.919922,16551.0,16961.919922,20400.0,-159.03906199999986,159.03906199999986,0.0,34.5030570491824,16551.0,17646.609375,25.972810519260204,-74.02718948073979,-128.52424151903324,-82.54689742980402,-0.017598039521251718,3128000.0
1683,BSESN,2010-05-18,16875.759766,17000.339844,16744.130859,16840.589844,16800.0,40.199218999998266,0.0,40.199218999998266,36.7743332891641,16551.0,17646.609375,29.64193018154844,-70.35806981845157,-141.1660604753124,-94.27073003890571,-0.012418168134274654,3144800.0
1684,BSESN,2010-05-19,16408.490234,16802.390625,16373.320313,16802.390625,22200.0,-467.2695319999984,467.2695319999984,0.0,25.100214357101805,16373.320313,17646.609375,2.7621317145973108,-97.23786828540268,-186.736951834504,-112.7639743980254,-0.03408612593841165,3122600.0
1685,BSESN,2010-05-20,16519.679688,16617.800781,16419.099609,16419.099609,21600.0,111.18945399999942,0.0,111.18945399999942,31.10517222643685,16373.320313,17536.859375,12.578810611516886,-87.42118938848311,-211.44277122036874,-132.4997337624941,-0.014874355066933909,3144200.0
1686,BSESN,2010-05-21,16445.609375,16486.740234,16187.030272999997,16317.94043,24200.0,-74.07031300000017,74.07031300000017,0.0,29.29958157601608,16187.030272999997,17464.820313,20.23643117456156,-79.76356882543844,-234.29832110706775,-152.85945123140883,-0.05106250904444365,3120000.0
1687,BSESN,2010-05-24,16469.550781,16757.730469,16413.029297,16494.609375,22200.0,23.94140600000173,0.0,23.94140600000173,30.797748787531816,16187.030272999997,17389.150391,23.50185341461896,-76.49814658538105,-247.62516887463062,-171.8125947600532,-0.03920178324565271,3142200.0
1688,BSESN,2010-05-25,16022.480469,16444.570313,15960.150391,16444.570313,21600.0,-447.0703120000017,447.0703120000017,0.0,21.143945866630517,15960.150391,17389.150391,4.3617969209237835,-95.6382030790762,-290.90822071674484,-195.63171995139155,-0.06823348482428482,3120600.0
1689,BSESN,2010-05-26,16387.839844,16410.349609,16069.780272999997,16069.780272999997,18400.0,365.3593749999982,0.0,365.3593749999982,39.13445016038106,15960.150391,17389.150391,29.929282925122397,-70.0707170748776,-292.3587730635045,-214.97713057381415,-0.05085346644467548,3139000.0
1690,BSESN,2010-05-27,16666.400391,16694.550781,16331.099609,16410.880859,18800.0,278.5605470000009,0.0,278.5605470000009,49.30843824841916,15960.150391,17389.150391,49.42267319804059,-50.57732680195941,-267.9421676136626,-225.57013798178386,-0.01931197118796457,3157800.0
1691,BSESN,2010-05-28,16863.060547,16891.169922,16692.660156,16692.660156,19000.0,196.6601560000017,0.0,196.6601560000017,55.38361273324628,15960.150391,17389.150391,63.18475549335212,-36.81524450664788,-230.07088688100703,-226.4702877616285,0.0016334472453845006,3176800.0
1692,BSESN,2010-05-31,16944.630859,16971.150391,16806.5,16872.169922,15600.0,81.57031199999983,0.0,81.57031199999983,57.80385853136827,15960.150391,17389.150391,68.89296487053895,-31.107035129461053,-191.27073165307593,-219.430376539918,0.004081066213016182,3192400.0
1693,BSESN,2010-06-01,16572.029297,16942.820313,16318.389647999997,16942.820313,20600.0,-372.60156199999983,372.60156199999983,0.0,44.95180183637025,15960.150391,17389.150391,42.818677816655125,-57.181322183344875,-188.41522772631288,-213.22734677719697,0.009966734334956096,3171800.0
1694,BSESN,2010-06-02,16741.839844,16774.150391,16571.449219,16574.789063,29000.0,169.8105469999973,0.0,169.8105469999973,50.71422669003532,15960.150391,17329.320313,57.09221627204272,-42.90778372795729,-170.48468696630152,-204.67881481501792,0.01344821208375957,3200800.0
1695,BSESN,2010-06-03,17022.330078,17072.630859,16786.279297,16786.279297,21800.0,280.4902340000008,0.0,280.4902340000008,58.91172075438301,15960.150391,17072.630859,95.47850209986773,-4.521497900132272,-132.1184077387552,-190.1667333997654,0.03506836930449708,3222600.0
1696,BSESN,2010-06-04,17117.689453,17150.419922,16963.919922,17036.550781,22400.0,95.359375,0.0,95.359375,61.42836127010736,15960.150391,17150.419922,97.25016324894888,-2.7498367510511246,-92.94671851217572,-170.72273042224748,0.03935375534029251,3245000.0
1697,BSESN,2010-06-07,16781.070313,17069.769531,16686.730469,17069.769531,26000.0,-336.6191399999989,336.6191399999989,0.0,49.16334855637416,15960.150391,17150.419922,68.9692460925474,-31.030753907452603,-88.05023563080977,-154.18823146395994,0.047345343654355165,3219000.0
1698,BSESN,2010-06-08,16617.099609,16895.730469,16560.640625,16760.599609,27400.0,-163.97070399999942,163.97070399999942,0.0,44.202856378276266,15960.150391,17150.419922,55.193315538209866,-44.80668446179014,-96.29082246015969,-142.6087496631999,0.013989626893012419,3191600.0
1699,BSESN,2010-06-09,16657.890625,16817.689453,16591.259766,16621.119141,36600.0,40.79101599999922,0.0,40.79101599999922,45.77337136936076,15960.150391,17150.419922,58.62035579569916,-41.37964420430084,-98.39580719016158,-133.76616116859222,-0.0005105941175272966,3228200.0
1700,BSESN,2010-06-10,16922.080078,16942.599609,16668.910156,16668.910156,24800.0,264.18945299999905,0.0,264.18945299999905,55.19732111558004,15960.150391,17150.419922,80.81612289880572,-19.183877101194284,-77.84874989098535,-122.58267891307084,0.0034999299703337705,3253000.0
1701,BSESN,2010-06-11,17064.949219,17131.560547,16994.070313,16994.070313,24600.0,142.86914099999922,0.0,142.86914099999922,59.58043593041004,15960.150391,17150.419922,92.81921440699278,-7.180785593007216,-49.4664943216485,-107.95944199478637,0.007100677553922186,3277600.0
1702,BSESN,2010-06-14,17338.169922,17351.179688,17118.740234,17118.740234,17400.0,273.2207030000027,0.0,273.2207030000027,66.75680409756527,16069.780272999997,17351.179688,98.9847220275187,-1.0152779724812955,-4.870579954542336,-87.34166958673757,0.046230948019063245,3295000.0
1703,BSESN,2010-06-15,17412.830078,17442.5,17249.460938,17355.490234,22400.0,74.6601559999981,0.0,74.6601559999981,68.51911763634241,16318.389647999997,17442.5,97.36058635638284,-2.6394136436171585,36.08054009894113,-62.65722764960183,0.04007864370058911,3317400.0
1704,BSESN,2010-06-16,17462.869141,17530.380859,17407.300781,17500.300781,27400.0,50.03906300000017,0.0,50.03906300000017,69.7589019784474,16318.389647999997,17530.380859,94.42968584365407,-5.570314156345919,71.74529684626759,-35.77672275042794,0.025880068179935156,3344800.0
1705,BSESN,2010-06-17,17616.689453,17647.419922,17394.900391,17490.519531,25400.0,153.82031199999986,0.0,153.82031199999986,73.46540336260978,16318.389647999997,17647.419922,97.68775252142964,-2.3122474785703644,111.14072606031186,-6.393232988279973,0.029151130552409033,3370200.0
1706,BSESN,2010-06-18,17570.820313,17721.990234,17525.289063,17628.019531,24000.0,-45.869139999998886,45.869139999998886,0.0,70.4926080607759,16318.389647999997,17721.990234,89.22984768545828,-10.770152314541722,137.08045315324853,22.30150424002574,0.0470619564348167,3346200.0
1707,BSESN,2010-06-21,17876.550781,17919.619141,17654.810547,17654.810547,26200.0,305.7304680000016,0.0,305.7304680000016,77.49599330889744,16560.640625,17919.619141,96.83082848676928,-3.1691715132307148,180.23018603628225,53.88724059927706,0.07579247893043073,3372400.0
1708,BSESN,2010-06-22,17749.689453,17868.119141,17725.630859,17868.119141,15200.0,-126.86132800000269,126.86132800000269,0.0,69.58826663895479,16560.640625,17919.619141,87.49577818932936,-12.504221810670646,201.863059582407,83.48240439590306,0.06554244187204827,3357200.0
1709,BSESN,2010-06-23,17755.939453,17782.410156,17629.189453,17694.869141,17600.0,6.25,0.0,6.25,69.76365483672825,16560.640625,17919.619141,87.95568244288563,-12.044317557114367,217.01003390392725,110.1879302975079,0.049276411124190345,3374800.0
1710,BSESN,2010-06-24,17730.240234,17845.650391,17632.800781,17750.509766,15600.0,-25.699218999998266,25.699218999998266,0.0,67.90562469540349,16560.640625,17919.619141,86.06461362189786,-13.935386378102136,224.35419251020357,133.02118274004707,0.03898581861932948,3359200.0
1711,BSESN,2010-06-25,17574.529297,17714.730469,17546.730469,17705.109375,19200.0,-155.71093699999986,155.71093699999986,0.0,57.24654083576802,16560.640625,17919.619141,74.60667406165246,-25.393325938347537,215.13003470588956,149.44295313321558,0.01363231390990638,3340000.0
1712,BSESN,2010-06-28,17774.259766,17794.800781,17571.849609,17577.660156,19200.0,199.7304689999983,0.0,199.7304689999983,65.30653786585523,16591.259766,17919.619141,89.05722519555373,-10.942774804446275,221.38442102209592,163.83124671099165,0.020756516108007217,3359200.0
1713,BSESN,2010-06-29,17534.089844,17777.949219,17465.730469,17777.949219,19200.0,-240.16992200000092,240.16992200000092,0.0,51.76613551351575,16668.910156,17919.619141,69.1751397308462,-30.8248602691538,204.60282767984245,171.98556290476182,0.004078407873582712,3340000.0
1714,BSESN,2010-06-30,17700.900391,17725.039063,17373.779297,17476.849609,18200.0,166.81054700000098,0.0,166.81054700000098,58.63874154652893,16994.070313,17919.619141,76.36875080133532,-23.631249198664666,202.43002379426252,178.07445508266198,0.0047801795124258195,3358200.0
1715,BSESN,2010-07-01,17509.330078,17679.339844,17455.410156,17679.339844,16200.0,-191.57031300000014,191.57031300000014,0.0,49.32563296918097,17118.740234,17919.619141,48.77014996725329,-51.229850032746704,183.13882741901398,179.0873295499324,-0.003499565410415517,3342000.0
1716,BSESN,2010-07-02,17460.949219,17598.939453,17426.779297,17523.470703,17200.0,-48.38085900000078,48.38085900000078,0.0,47.143769348447165,17249.460938,17919.619141,31.557963485824615,-68.44203651417538,162.0781483168248,175.6854933033109,-0.02324842007227279,3324800.0
1717,BSESN,2010-07-05,17441.439453,17505.730469,17423.740234,17473.830078,7800.0,-19.509765999999214,19.509765999999214,0.0,46.1930379186795,17373.779297,17919.619141,12.395605916961664,-87.60439408303834,142.17423722175226,168.98324208699918,-0.017366501020551706,3317000.0
1718,BSESN,2010-07-06,17614.480469,17643.140625,17395.580078,17402.679688,15600.0,173.04101599999925,0.0,173.04101599999925,55.39818940065687,17373.779297,17919.619141,44.09739865014289,-55.90260134985711,138.76362738690295,162.93931914697995,-0.007966854379879096,3332600.0
1719,BSESN,2010-07-07,17471.029297,17623.660156,17447.150391,17623.660156,15200.0,-143.4511719999973,143.4511719999973,0.0,47.607578557860364,17373.779297,17919.619141,17.81658137803519,-82.1834186219648,123.06674695918264,154.9648047094205,-0.014619708113313035,3317400.0
1720,BSESN,2010-07-08,17651.730469,17728.369141,17536.480469,17536.480469,14200.0,180.70117199999734,0.0,180.70117199999734,56.4991489169701,17373.779297,17919.619141,50.921744730675655,-49.07825526932435,123.78105952482292,148.72805567250097,0.004392787465048897,3331600.0
1721,BSESN,2010-07-09,17833.539063,17857.580078,17667.849609,17667.849609,26000.0,181.8085940000019,0.0,181.8085940000019,63.65905823545365,17373.779297,17868.119141,93.00479651403556,-6.995203485964439,137.43334542069715,146.4691136221402,0.0033351204371050436,3357600.0
1722,BSESN,2010-07-12,17937.199219,18010.070313,17874.949219,17875.970703,16200.0,103.6601559999981,0.0,103.6601559999981,67.20965321255116,17373.779297,18010.070313,88.54752115500527,-11.452478844994724,154.83257507221424,148.14180591215504,0.022990037041354716,3373800.0
1723,BSESN,2010-07-13,17985.900391,17998.039063,17855.849609,17908.300781,17000.0,48.70117200000095,0.0,48.70117200000095,68.85900358371411,17373.779297,18010.070313,96.20143591654907,-3.7985640834509256,170.58497014308887,152.63043875834182,0.016100875870975973,3390800.0
1724,BSESN,2010-07-14,17938.160156,18167.220703,17897.259766,18024.949219,16800.0,-47.740234999997476,47.740234999997476,0.0,65.1522850348403,17373.779297,18167.220703,71.13075455000923,-28.86924544999078,177.17426411436827,157.53920382954712,0.024491518298510817,3374000.0
1725,BSESN,2010-07-15,17909.460938,17978.560547,17858.730469,17874.710938,11800.0,-28.699218000001565,28.699218000001565,0.0,62.807131641099346,17373.779297,18167.220703,67.51369879983305,-32.48630120016694,178.0283401304514,161.637031089728,0.025686559955856003,3362200.0
1726,BSESN,2010-07-16,17955.820313,17980.269531,17892.160156,17911.130859,13200.0,46.359375,0.0,46.359375,65.14551488390364,17373.779297,18167.220703,73.35652155264513,-26.643478447354862,180.36685877404307,165.38299662659102,0.02949188118252044,3375400.0
1727,BSESN,2010-07-19,17928.419922,18005.070313,17856.400391,17914.119141,11800.0,-27.400390999999214,27.400390999999214,0.0,62.46712006732641,17373.779297,18167.220703,69.90316119196851,-30.096838808031485,177.95778254581455,167.89795381043575,0.017822805137654107,3363600.0
1728,BSESN,2010-07-20,17878.140625,18040.169922,17848.070313,17918.429688,11600.0,-50.27929700000095,50.27929700000095,0.0,57.46479108130086,17395.580078,18167.220703,62.53695455705186,-37.46304544294814,170.0314366513776,168.32465037862414,0.0233020803227606,3352000.0
1729,BSESN,2010-07-21,17977.230469,18012.199219,17873.919922,17873.919922,13000.0,99.08984399999828,0.0,99.08984399999828,64.01723296937793,17395.580078,18167.220703,75.37840442239536,-24.621595577604637,169.78825934204724,168.61737217130877,0.018440118410579798,3365000.0
1730,BSESN,2010-07-22,18113.150391,18127.900391,17879.880859,17978.369141,16000.0,135.91992200000095,0.0,135.91992200000095,71.07059254889668,17395.580078,18167.220703,92.99281164726133,-7.007188352738663,178.50544173112212,170.59498608327146,0.01567895901156935,3381000.0
1731,BSESN,2010-07-23,18130.980469,18237.560547,18093.929688,18132.289063,17400.0,17.830077999999045,0.0,17.830077999999045,71.90419872438481,17395.580078,18237.560547,87.34173987116529,-12.658260128834703,184.72323538944693,173.42063594450659,0.010803317041533367,3398400.0
1732,BSESN,2010-07-26,18020.050781,18194.089844,17993.880859,18056.240234,16800.0,-110.9296879999965,110.9296879999965,0.0,59.57986722924871,17447.150391,18237.560547,72.4814054641273,-27.51859453587268,178.64052613155945,174.46461398191718,0.0018987311870741763,3381600.0
1733,BSESN,2010-07-27,18077.609375,18149.560547,17998.740234,17998.740234,15800.0,57.55859399999825,0.0,57.55859399999825,63.34163910141149,17536.480469,18237.560547,77.18503534484967,-22.814964655150327,176.43065001063587,174.85782118766093,0.007773886384516038,3397400.0
1734,BSESN,2010-07-28,17957.369141,18137.140625,17925.400391,18077.849609,15400.0,-120.24023400000078,120.24023400000078,0.0,51.735867981105095,17667.849609,18237.560547,50.81867183669876,-49.18132816330124,163.0968463488207,172.5056262198929,0.0026750220548708015,3382000.0
1735,BSESN,2010-07-29,17992.0,18013.099609,17902.839844,17961.580078,11600.0,34.63085900000078,0.0,34.63085900000078,54.505998306050714,17848.070313,18237.560547,36.95334938744563,-63.046650612554366,153.5540562052447,168.71531221696327,0.0020149281051673462,3393600.0
1736,BSESN,2010-07-30,17868.289063,18000.349609,17838.919922,17981.060547,14000.0,-123.71093699999984,123.71093699999984,0.0,44.07820642879185,17838.919922,18237.560547,7.367322635518951,-92.63267736448105,134.45892871150136,161.8640355158709,-0.00335394079688045,3379600.0
1737,BSESN,2010-08-02,18081.210938,18104.240234,17911.310547,17911.310547,11000.0,212.921875,0.0,212.921875,59.475022740287876,17838.919922,18237.560547,60.77930868184828,-39.22069131815173,134.95128405159994,156.48148522301673,0.011358581256265321,3390600.0
1738,BSESN,2010-08-03,18114.830078,18167.449219,18072.380859,18149.900391,13800.0,33.61913999999888,0.0,33.61913999999888,61.410691569754924,17838.919922,18237.560547,69.21275421941708,-30.78724578058293,136.4809948844195,152.48138715529728,0.00765410496557184,3404400.0
1739,BSESN,2010-08-04,18217.439453,18249.460938,18093.029297,18115.560547,11200.0,102.609375,0.0,102.609375,66.96720039865892,17838.919922,18249.460938,92.20017397725708,-7.799826022742922,144.30951055247715,150.84701183473325,0.0057576434661426035,3415600.0
1740,BSESN,2010-08-05,18172.830078,18295.429688,18156.449219,18234.849609,10200.0,-44.609375,44.609375,0.0,62.455960642089494,17838.919922,18295.429688,73.14414298860775,-26.855857011392242,145.23982755106772,149.72557497800014,0.002308182344112897,3405400.0
1741,BSESN,2010-08-06,18143.990234,18244.560547,18118.189453,18165.490234,9800.0,-28.839843999998266,28.839843999998266,0.0,59.46762722764235,17838.919922,18295.429688,66.82667813945525,-33.17332186054474,142.01293932431145,148.1830478472624,0.006877863692297703,3395600.0
1742,BSESN,2010-08-09,18287.5,18309.25,18139.900391,18141.109375,11000.0,143.50976599999922,0.0,143.50976599999922,68.20294191089761,17838.919922,18309.25,95.37558812047737,-4.624411879522628,149.31444196917073,148.40932667164407,0.011610529945970782,3406600.0
1743,BSESN,2010-08-10,18219.990234,18293.400391,18170.769531,18272.279297,17800.0,-67.50976599999922,67.50976599999922,0.0,61.06015812187471,17838.919922,18309.25,81.0218886320089,-18.978111367991097,147.9480089533863,148.31706312799253,0.014624697578911494,3388800.0
1744,BSESN,2010-08-11,18070.189453,18263.880859,18042.890625,18177.349609,20200.0,-149.8007810000017,149.8007810000017,0.0,48.149425491523736,17838.919922,18309.25,49.17175018519623,-50.82824981480377,133.2415047278737,145.30195144796878,0.004345789962205471,3368600.0
1745,BSESN,2010-08-12,18073.900391,18113.619141,17914.779297,17972.650391,19600.0,3.710938000000169,0.0,3.710938000000169,48.46091768843772,17838.919922,18309.25,49.96075734709842,-50.03924265290157,120.4969223434673,140.3409456270685,0.011507051809776181,3388200.0
1746,BSESN,2010-08-13,18167.029297,18260.390625,18050.419922,18080.289063,18600.0,93.12890600000172,0.0,93.12890600000172,56.097987155701965,17838.919922,18309.25,69.76151225437907,-30.238487745620922,116.56775289307916,135.58630708027061,0.004746272763161086,3406800.0
1747,BSESN,2010-08-16,18050.779297,18203.919922,17997.460938,18169.800781,16000.0,-116.25,116.25,0.0,46.23109078311048,17838.919922,18309.25,45.044828070723646,-54.95517192927635,102.88743206564686,129.04653207734586,-0.0035358201387594157,3390800.0
1748,BSESN,2010-08-17,18048.849609,18140.150391,18026.0,18049.189453,12800.0,-1.9296880000001693,1.9296880000001693,0.0,46.075870354862104,17838.919922,18309.25,44.634544295506494,-55.365455704493506,90.84279041377522,121.40578374463173,-0.009254310652984543,3378000.0
1749,BSESN,2010-08-18,18257.119141,18286.0,18067.669922,18067.669922,14800.0,208.26953199999843,0.0,208.26953199999843,61.97492670336934,17838.919922,18309.25,88.9161120161231,-11.083887983876908,96.9849536048896,116.52161771668331,0.004638191334988662,3392800.0
1750,BSESN,2010-08-19,18454.939453,18475.269531,18276.5,18276.5,14600.0,197.82031199999986,0.0,197.82031199999986,71.26133609905577,17911.310547,18475.269531,96.39511408155835,-3.604885918441661,116.4724857961628,116.51179133257922,0.017137863005311393,3407400.0
1751,BSESN,2010-08-20,18401.820313,18464.140625,18360.900391,18444.240234,14200.0,-53.119139999998886,53.119139999998886,0.0,66.24851749322286,17914.779297,18475.269531,86.89554009249669,-13.104459907503305,126.17574929877082,118.44458292581756,0.006251281640464734,3393200.0
1752,BSESN,2010-08-23,18409.349609,18454.380859,18371.019531,18400.330078,11400.0,7.529296000000612,0.0,7.529296000000612,66.63240517313825,17914.779297,18475.269531,88.23888125051597,-11.76111874948402,132.9407485979791,121.34381606024988,0.010392946020719496,3404600.0
1753,BSESN,2010-08-24,18311.589844,18451.730469,18260.710938,18407.009766,14400.0,-97.75976500000252,97.75976500000252,0.0,56.93139745857996,17914.779297,18475.269531,70.79704924885395,-29.202950751146044,128.92746766603886,122.86054638140767,0.013359040403415401,3390200.0
1754,BSESN,2010-08-25,18179.640625,18312.429688,18156.0,18308.509766,15800.0,-131.9492189999983,131.9492189999983,0.0,46.4087343476809,17914.779297,18475.269531,47.25529758293678,-52.74470241706323,113.7880367288708,121.04604445090031,0.005850438019048498,3374400.0
1755,BSESN,2010-08-26,18226.349609,18261.060547,18159.130859,18194.779297,12800.0,46.70898400000078,0.0,46.70898400000078,50.17058149160258,17914.779297,18475.269531,55.588892205390216,-44.411107794609784,104.35600224842347,117.70803601040495,0.0032652730961244547,3387200.0
1756,BSESN,2010-08-27,17998.410156,18248.359375,17944.160156,18205.900391,13600.0,-227.93945299999905,227.93945299999905,0.0,35.95807789488765,17914.779297,18475.269531,14.921019837073676,-85.07898016292631,77.59378522529732,109.68518585338342,-0.002901212193575642,3373600.0
1757,BSESN,2010-08-30,18032.109375,18216.5,17960.230469,18063.480469,11600.0,33.699218999998266,0.0,33.699218999998266,38.910226458687795,17914.779297,18475.269531,20.933474105812678,-79.06652589418732,58.4302334011918,99.43419536294509,-0.0009274958993316096,3385200.0
1758,BSESN,2010-08-31,17971.119141,18015.660156,17819.990234,18015.660156,16400.0,-60.99023400000078,60.99023400000078,0.0,35.49349398778418,17819.990234,18475.269531,23.063281213353857,-76.93671878664614,37.88486520394508,87.12432933114509,-0.01566512207053139,3368800.0
1759,BSESN,2010-09-01,18205.869141,18227.140625,18027.119141,18027.119141,14400.0,234.75,0.0,234.75,53.591716701800785,17819.990234,18475.269531,58.88770006417552,-41.11229993582448,40.08282612970288,77.71602869085666,-0.013496132709311714,3383200.0
1760,BSESN,2010-09-02,18238.310547,18355.839844,18215.279297,18215.279297,13400.0,32.441406000001734,0.0,32.441406000001734,55.579012840721724,17819.990234,18475.269531,63.83847542798221,-36.16152457201779,43.93600937205338,70.960024827096,-0.008885521280983633,3396600.0
1761,BSESN,2010-09-03,18221.429688,18316.320313,18206.5,18238.080078,9400.0,-16.880859000000786,16.880859000000786,0.0,54.18586915748436,17819.990234,18475.269531,61.26234352860973,-38.737656471390274,45.10756863746428,65.78953358916966,-0.010207852259382921,3387200.0
1762,BSESN,2010-09-06,18560.050781,18600.300781,18124.289063,18124.289063,18200.0,338.6210930000016,0.0,338.6210930000016,71.00676516889094,17819.990234,18600.300781,94.84179726203291,-5.158202737967087,72.52391942788381,67.1364107569125,0.013568507110343297,3405400.0
1763,BSESN,2010-09-07,18645.060547,18711.199219,18571.429688,18571.730469,14600.0,85.00976599999922,0.0,85.00976599999922,73.79388149355927,17819.990234,18711.199219,92.57876961372898,-7.4212303862710165,99.95888876593017,73.70090635871604,0.025601161849149623,3420000.0
1764,BSESN,2010-09-08,18666.710938,18721.210938,18540.650391,18627.669922,20200.0,21.650390999999214,0.0,21.650390999999214,74.51384030606181,17819.990234,18721.210938,93.95264669818326,-6.047353301816736,122.04148694512696,83.36902247599824,0.024160698024938254,3440200.0
1765,BSESN,2010-09-09,18799.660156,18823.169922,18669.119141,18669.119141,13200.0,132.94921800000157,0.0,132.94921800000157,78.66656940093986,17819.990234,18823.169922,97.65647507807203,-2.3435249219279664,148.55751730267366,96.40672144133333,0.04451782091058143,3453400.0
1766,BSESN,2010-09-13,19208.330078,19243.439453,18845.310547,18845.310547,15800.0,408.6699219999973,0.0,408.6699219999973,86.47998777415962,17819.990234,19243.439453,97.53349999906108,-2.4665000009389195,200.23967141980756,117.1733114370282,0.06522923516816781,3469200.0
1767,BSESN,2010-09-14,19346.960938,19487.019531,19218.130859,19218.130859,21000.0,138.63086000000112,0.0,138.63086000000112,88.17514967042183,17819.990234,19487.019531,91.5983124440553,-8.401687555944704,249.50832605380492,143.64031436038357,0.07655849289102434,3490200.0
1768,BSESN,2010-09-15,19502.109375,19554.5,19340.990234,19343.740234,17400.0,155.14843699999986,0.0,155.14843699999986,89.82290694314861,17819.990234,19554.5,96.9795139798596,-3.020486020140403,297.64223760974346,174.44069901025557,0.07119903059617405,3507600.0
1769,BSESN,2010-09-16,19417.490234,19636.660156,19383.460938,19476.929688,16200.0,-84.61914099999922,84.61914099999922,0.0,82.5810935675364,17819.990234,19636.660156,87.93562224233264,-12.064377757667351,325.21181247995264,204.594921704195,0.0646539976365279,3491400.0
1770,BSESN,2010-09-17,19594.75,19639.179688,19436.710938,19436.710938,16600.0,177.25976599999925,0.0,177.25976599999925,85.42194911143828,17819.990234,19639.179688,97.55772067047172,-2.442279329528269,357.2461694240774,235.12517124817148,0.07536841705151276,3508000.0
1771,BSESN,2010-09-20,19906.099609,19927.300781,19445.419922,19445.419922,19600.0,311.3496090000008,0.0,311.3496090000008,89.04344719817394,17819.990234,19927.300781,98.99392275001027,-1.0060772499897208,403.1101367572337,268.7221643499839,0.07252398411420047,3527600.0
1772,BSESN,2010-09-21,20001.550781,20088.960938,19860.880859,19925.789063,15800.0,95.45117200000095,0.0,95.45117200000095,89.9284899242338,18027.119141,20088.960938,95.76057886074571,-4.239421139254284,442.06393529167326,303.3905185383218,0.0727533295255649,3543400.0
1773,BSESN,2010-09-22,19941.720703,20105.539063,19804.019531,20039.429688,14400.0,-59.830078000002686,59.830078000002686,0.0,84.96468221758936,18124.289063,20105.539063,91.73156542586746,-8.268434574132549,462.77275771847053,335.26696637435157,0.06830393255859812,3529000.0
1774,BSESN,2010-09-23,19861.009766,19998.320313,19771.630859,19944.300781,11800.0,-80.71093699999983,80.71093699999983,0.0,78.24234587260224,18124.289063,20105.539063,87.65782728075705,-12.34217271924295,467.2853756685945,361.6706482332002,0.05645578702981302,3517200.0
1775,BSESN,2010-09-24,20045.179688,20071.75,19833.519531,19836.429688,17400.0,184.16992200000092,0.0,184.16992200000092,81.99336003270007,18124.289063,20105.539063,96.95347003154573,-3.0465299684542586,480.18733079568847,385.3739847456979,0.04356701527940077,3534600.0
1776,BSESN,2010-09-27,20117.380859,20267.980469,20082.259766,20082.259766,17400.0,72.20117100000061,0.0,72.20117100000061,83.2960171432129,18540.650391,20267.980469,91.28136469583333,-8.718635304166664,490.5831174759405,406.4158112917465,0.03982123722009456,3552000.0
1777,BSESN,2010-09-28,20104.859375,20157.509766,19981.960938,20114.369141,13400.0,-12.521484000000784,12.521484000000784,0.0,82.1074075217266,18540.650391,20267.980469,90.55646074380473,-9.443539256195269,492.13840897213595,423.5603308278245,0.030906913114366663,3538600.0
1778,BSESN,2010-09-29,19956.339844,20234.050781,19923.109375,20086.890625,18800.0,-148.5195310000017,148.5195310000017,0.0,68.69218167507532,18669.119141,20267.980469,80.50858948537905,-19.491410514620952,475.9008154039475,434.0284277430492,0.027750734183786152,3519800.0
1779,BSESN,2010-09-30,20069.119141,20114.730469,19864.460938,19931.490234,15800.0,112.77929700000095,0.0,112.77929700000095,72.61281924694852,18845.310547,20267.980469,86.02196300597691,-13.978036994023087,466.7523220225594,440.5732065989512,0.02420899174523794,3535600.0
1780,BSESN,2010-10-01,20445.039063,20475.470703,20094.099609,20094.099609,19200.0,375.9199220000009,0.0,375.9199220000009,81.5155645504878,19218.130859,20475.470703,97.57968061338245,-2.420319386617555,484.25349822776843,449.3092649247146,0.02707408606336581,3554800.0
1781,BSESN,2010-10-04,20475.730469,20706.740234,20437.359375,20501.210938,15000.0,30.691405999998093,0.0,30.691405999998093,82.0647921879738,19340.990234,20706.740234,83.08550137287186,-16.914498627128136,494.8950048702791,458.4264129138275,0.023707146170407478,3569800.0
1782,BSESN,2010-10-05,20407.710938,20560.539063,20383.160156,20461.980469,17800.0,-68.0195309999981,68.0195309999981,0.0,76.26966729999943,19383.460938,20706.740234,77.4024050021863,-22.59759499781371,492.1664790560644,465.1744261422749,0.023367604127054964,3552000.0
1783,BSESN,2010-10-06,20543.080078,20669.949219,20447.050781,20448.689453,16200.0,135.36913999999888,0.0,135.36913999999888,79.58081315839499,19436.710938,20706.740234,87.11367080149608,-12.88632919850391,495.218688186731,471.1832785511662,0.034342176960591164,3568200.0
1784,BSESN,2010-10-07,20315.320313,20581.289063,20272.769531,20544.300781,19200.0,-227.7597649999989,227.7597649999989,0.0,62.61858263330701,19445.419922,20706.740234,68.96744488484852,-31.03255511515148,473.79763217017535,471.7061492749681,0.013476587848285426,3549000.0
1785,BSESN,2010-10-08,20250.259766,20409.189453,20145.740234,20297.580078,15400.0,-65.06054700000095,65.06054700000095,0.0,58.508220471734994,19771.630859,20706.740234,51.18426996841931,-48.81573003158069,446.4253351638108,466.64998645273664,0.0066051792691765865,3533600.0
1786,BSESN,2010-10-11,20339.890625,20461.269531,20250.259766,20250.259766,11600.0,89.63085900000078,0.0,89.63085900000078,62.428549945335625,19771.630859,20706.740234,60.76933684896477,-39.23066315103522,427.0423751484086,458.72846419187107,0.01169027077564433,3545200.0
1787,BSESN,2010-10-12,20203.339844,20368.400391,20107.25,20357.789063,13400.0,-136.5507810000017,136.5507810000017,0.0,53.5366207195137,19771.630859,20706.740234,46.16668344277882,-53.83331655722118,396.0967757956205,446.20212651262096,0.012377019129300004,3531800.0
1788,BSESN,2010-10-13,20687.880859,20703.970703,20211.660156,20223.449219,14400.0,484.5410150000025,0.0,484.5410150000025,70.65172607378643,19833.519531,20706.740234,97.8402510459031,-2.1597489540968913,405.9905692281027,438.15981505571733,0.030831533444629855,3546200.0
1789,BSESN,2010-10-14,20497.640625,20854.550781,20442.820313,20700.419922,15200.0,-190.2402340000008,190.2402340000008,0.0,60.54786529285549,19864.460938,20854.550781,63.95174048866582,-36.04825951133418,393.9395845130566,429.31576894718523,0.002572827659458765,3531000.0
1790,BSESN,2010-10-15,20125.050781,20578.449219,20090.179688,20518.5,9400.0,-372.5898439999983,372.5898439999983,0.0,45.7594427182657,19864.460938,20854.550781,26.319817826875852,-73.68018217312414,350.2863230694966,413.5098797716475,-0.01712660207805139,3521600.0
1791,BSESN,2010-10-18,20168.890625,20229.390625,19870.509766,20160.550781,12600.0,43.839843999998266,0.0,43.839843999998266,47.50030994483734,19864.460938,20854.550781,30.74768306657594,-69.25231693342405,315.59037846192587,393.9259795097032,-0.0117024547106509,3534200.0
1792,BSESN,2010-10-19,19983.130859,20332.019531,19923.960938,20298.550781,12000.0,-185.7597659999992,185.7597659999992,0.0,41.057637850315125,19864.460938,20854.550781,11.985772992118294,-88.0142270078817,269.99203165586005,369.13918993893463,-0.027257315693358874,3522200.0
1793,BSESN,2010-10-20,19872.150391,20043.820313,19822.660156,19924.019531,10600.0,-110.98046800000157,110.98046800000157,0.0,37.546988174311046,19822.660156,20854.550781,4.796073711784859,-95.20392628821514,222.33685615075228,339.7787231812982,-0.021814567290696973,3511600.0
1794,BSESN,2010-10-21,20260.580078,20293.099609,19886.119141,19951.339844,12800.0,388.42968699999983,0.0,388.42968699999983,53.577182827952285,19822.660156,20854.550781,42.43859876137525,-57.561401238624754,213.4522708159784,314.51343270823423,0.0005096384994194292,3524400.0
1795,BSESN,2010-10-22,20165.859375,20351.740234,20088.669922,20334.140625,13200.0,-94.72070299999905,94.72070299999905,0.0,49.96839605410356,19822.660156,20854.550781,33.259263209218346,-66.74073679078165,196.50284137344715,290.91131444127683,-0.008556154662213156,3511200.0
1796,BSESN,2010-10-25,20303.119141,20452.300781,20199.730469,20199.730469,12200.0,137.25976599999922,0.0,137.25976599999922,55.03274868749149,19822.660156,20854.550781,46.561037900697805,-53.43896209930219,191.93352224470073,271.1157560019616,0.004938752590930351,3523400.0
1797,BSESN,2010-10-26,20221.390625,20344.679688,20189.300781,20325.439453,10200.0,-81.72851599999922,81.72851599999922,0.0,51.45441819010265,19822.660156,20854.550781,38.640768637664316,-61.359231362335684,179.6466410555695,252.82193301268316,-0.022548961741388762,3513200.0
1798,BSESN,2010-10-27,20005.369141,20220.580078,19923.710938,20220.580078,12000.0,-216.0214840000008,216.0214840000008,0.0,42.939385676256755,19822.660156,20854.550781,17.706235580926755,-82.29376441907324,150.74042896659012,232.40563220346456,-0.024016007159360586,3501200.0
1799,BSESN,2010-10-28,19941.039063,20185.460938,19869.320313,20116.490234,11600.0,-64.33007799999905,64.33007799999905,0.0,40.62909901916041,19822.660156,20854.550781,11.472040168985782,-88.52795983101421,121.24352804255614,210.17321137128292,-0.009143416332331733,3489600.0
1800,BSESN,2010-10-29,20032.339844,20080.330078,19768.960938,19986.320313,14400.0,91.3007809999981,0.0,91.3007809999981,45.43660414577498,19768.960938,20854.550781,24.26136424343809,-75.7386357565619,104.03498103891252,188.94556530480887,-0.0067703664786967765,3504000.0
1801,BSESN,2010-11-01,20355.630859,20609.650391,20267.099609,20272.490234,5400.0,323.2910150000025,0.0,323.2910150000025,59.00067083025815,19768.960938,20854.550781,54.04158161417136,-45.95841838582864,115.15651400142087,174.18775504413128,0.01864072264893535,3509400.0
1802,BSESN,2010-11-02,20345.689453,20418.349609,20281.730469,20407.179688,13200.0,-9.941406000001734,9.941406000001734,0.0,58.48480866053224,19768.960938,20854.550781,53.1258208354477,-46.874179164552295,121.76459417431397,163.70312287016782,0.023829281314943218,3496200.0
1803,BSESN,2010-11-03,20465.740234,20538.800781,20426.179688,20472.859375,10000.0,120.05078100000172,0.0,120.05078100000172,62.99321613037241,19768.960938,20609.650391,82.88188861101382,-17.118111388986176,135.13093474083507,157.98868524430128,0.010126075127669942,3506200.0
1804,BSESN,2010-11-04,20893.570313,20917.029297,20605.630859,20605.630859,12800.0,427.8300789999994,0.0,427.8300789999994,74.4172153298363,19768.960938,20917.029297,97.95665616806701,-2.0433438319329875,178.19208040701778,162.0293642768446,0.03608628447058182,3519000.0
1805,BSESN,2010-11-08,20852.380859,21075.710938,20822.369141,21041.970703,13800.0,-41.18945399999939,41.18945399999939,0.0,71.94987261873018,19768.960938,21075.710938,82.90950227664057,-17.090497723359434,206.61299785593656,170.94609099266302,0.027053070722065753,3505200.0
1806,BSESN,2010-11-09,20932.480469,20984.080078,20762.810547,20851.910156,11800.0,80.09960999999748,0.0,80.09960999999748,73.89218409725055,19768.960938,21075.710938,89.03918354696752,-10.960816453032479,232.91524682183444,183.33992215849733,0.03516522959211654,3517000.0
1807,BSESN,2010-11-10,20875.710938,20970.910156,20849.919922,20917.539063,15200.0,-56.7695309999981,56.7695309999981,0.0,69.93219482624811,19768.960938,21075.710938,84.69485364453797,-15.305146355462023,246.33949357492384,195.93983644178266,0.0435054105158339,3501800.0
1808,BSESN,2010-11-11,20589.089844,20937.380859,20544.220703,20930.449219,12600.0,-286.62109400000185,286.62109400000185,0.0,53.29375569760205,19768.960938,21075.710938,62.760964683374645,-37.23903531662536,231.18541736637417,202.98895262670098,0.03249834569565824,3489200.0
1809,BSESN,2010-11-12,20156.890625,20593.910156,20108.400391,20529.740234,14600.0,-432.1992189999983,432.1992189999983,0.0,37.69111407991143,19768.960938,21075.710938,29.686603175817854,-70.31339682418213,182.20054340963543,198.8312707832879,0.006217485424564906,3474600.0
1810,BSESN,2010-11-15,20309.689453,20335.509766,20046.599609,20167.619141,14200.0,152.79882799999902,0.0,152.79882799999902,44.338633608176465,19768.960938,21075.710938,41.379645303233126,-58.620354696766874,153.93480173515854,189.85197697366203,-0.0022569384519807167,3488800.0
1811,BSESN,2010-11-16,19865.140625,20380.099609,19832.220703,20371.730469,15200.0,-444.54882799999916,444.54882799999916,0.0,32.64650302805988,19768.960938,21075.710938,7.360220929787628,-92.63977907021237,94.57245030660852,170.79607164025134,-0.023619196051827163,3473600.0
1812,BSESN,2010-11-18,19930.640625,20056.439453,19615.509766,19997.830078,21800.0,65.5,0.0,65.5,35.53648460432525,19615.509766,21075.710938,21.581331739952923,-78.41866826004707,52.21080801578137,147.07901891535735,-0.026146115551248572,3495400.0
1813,BSESN,2010-11-19,19585.439453,19983.890625,19504.869141,19982.75,16400.0,-345.2011720000009,345.2011720000009,0.0,28.182894902930926,19504.869141,21075.710938,5.129116894767716,-94.87088310523228,-9.110923260686832,115.8410304801485,-0.06260925444542531,3479000.0
1814,BSESN,2010-11-22,19957.589844,19989.019531,19641.419922,19713.839844,11000.0,372.15039099999916,0.0,372.15039099999916,42.88472307123139,19504.869141,21075.710938,28.82026082222962,-71.17973917777037,-27.363975853237207,87.20002921347135,-0.04291073623920527,3490000.0
1815,BSESN,2010-11-23,19691.839844,19841.419922,19342.689453,19841.419922,14200.0,-265.75,265.75,0.0,36.695221697035215,19342.689453,21075.710938,20.146916470570993,-79.853083529429,-62.55239055277707,57.249545260221666,-0.059268686615393196,3475800.0
1816,BSESN,2010-11-24,19459.849609,19835.570313,19375.919922,19735.279297,12200.0,-231.99023499999748,231.99023499999748,0.0,32.037664085305224,19342.689453,21075.710938,6.7604560597817205,-93.23954394021828,-107.91515710594831,24.216604786987663,-0.06782338255233789,3463600.0
1817,BSESN,2010-11-25,19318.160156,19628.269531,19257.369141,19560.25,13800.0,-141.68945299999902,141.68945299999902,0.0,29.407279256187238,19257.369141,21075.710938,3.343211661322356,-96.65678833867764,-153.5288461592172,-11.33248540225332,-0.06172830842109156,3449800.0
1818,BSESN,2010-11-26,19136.609375,19417.609375,18954.820313,19391.960938,25200.0,-181.5507810000017,181.5507810000017,0.0,26.22405785153488,18954.820313,21075.710938,8.571354875973382,-91.42864512402662,-201.99913383161766,-49.465815088126206,-0.050616995893928984,3424600.0
1819,BSESN,2010-11-29,19405.099609,19450.089844,19167.189453,19230.339844,12400.0,268.4902340000008,0.0,268.4902340000008,37.726578180693565,18954.820313,20984.080078,22.18933740106954,-77.81066259893046,-216.2544216452443,-82.82353639954984,-0.044539816627593876,3437000.0
1820,BSESN,2010-11-30,19521.25,19610.460938,19218.019531,19373.230469,18800.0,116.15039099999922,0.0,116.15039099999922,42.223060285813425,18954.820313,20970.910156,28.095458591127848,-71.90454140887216,-215.69309832378713,-109.39744878439733,-0.01731126053883647,3455800.0
1821,BSESN,2010-12-01,19850.0,19887.259766,19525.150391,19529.990234,15000.0,328.75,0.0,328.75,53.24773506024775,18954.820313,20937.380859,45.1527035986925,-54.84729640130751,-186.57020286311308,-124.83199960014049,-0.004046062869592304,3470800.0
1822,BSESN,2010-12-02,19992.699219,20084.25,19917.769531,20038.660156,16600.0,142.6992189999983,0.0,142.6992189999983,57.326024947486324,18954.820313,20593.910156,63.32044033049365,-36.67955966950635,-150.2435498855084,-129.9143096572141,0.020794007046781804,3487400.0
1823,BSESN,2010-12-03,19966.929688,20067.810547,19877.119141,20007.890625,13800.0,-25.769530999998093,25.769530999998093,0.0,56.302644636802185,18954.820313,20380.099609,71.01130128252417,-28.988698717475824,-122.12600885877691,-128.35664949752666,0.0004679845649202541,3473600.0
1824,BSESN,2010-12-06,19981.310547,20217.859375,19944.710938,20038.25,14000.0,14.380859000000784,0.0,14.380859000000784,56.799240199079705,18954.820313,20380.099609,72.0202866119512,-27.9797133880488,-97.55765595340199,-122.19685078870172,0.014700033378963528,3487600.0
1825,BSESN,2010-12-07,19934.640625,20008.359375,19824.439453,19982.900391,13400.0,-46.66992200000095,46.66992200000095,0.0,54.48082349205029,18954.820313,20217.859375,77.57640610484935,-22.423593895150653,-80.92013499388122,-113.94150762973763,0.024398493592695303,3474200.0
1826,BSESN,2010-12-08,19696.480469,19875.509766,19611.349609,19874.300781,12600.0,-238.1601560000017,238.1601560000017,0.0,43.92404836848413,18954.820313,20217.859375,58.72028651478066,-41.27971348521934,-85.96140440743329,-108.34548698527678,0.0195836616916385,3461600.0
1827,BSESN,2010-12-09,19242.359375,19771.089844,19160.869141,19746.150391,17200.0,-454.1210939999983,454.1210939999983,0.0,30.79531700182254,18954.820313,20217.859375,22.76565077446511,-77.2343492255349,-125.15768390343874,-111.70792636890918,0.005526057303450571,3444400.0
1828,BSESN,2010-12-10,19508.890625,19537.400391,19074.570313,19201.890625,16000.0,266.53125,0.0,266.53125,42.445306054431576,18954.820313,20217.859375,43.86802662481708,-56.13197337518292,-133.17896916209065,-116.00213492754548,0.005348646391480694,3460400.0
1829,BSESN,2010-12-13,19691.779297,19710.570313,19321.410156,19600.279297,15400.0,182.88867200000092,0.0,182.88867200000092,49.214216490560126,18954.820313,20217.859375,58.3480753820107,-41.6519246179893,-123.3563331321202,-117.47297456846044,0.008735572619581244,3475800.0
1830,BSESN,2010-12-14,19799.189453,19836.820313,19621.410156,19746.75,13400.0,107.4101559999981,0.0,107.4101559999981,52.96294979778155,18954.820313,20217.859375,66.85217943006097,-33.147820569939036,-105.68643396183688,-115.11566644713575,-0.002559725289672632,3489200.0
1831,BSESN,2010-12-15,19647.769531,19817.609375,19571.429688,19791.220703,14000.0,-151.4199219999973,151.4199219999973,0.0,47.28546908967928,18954.820313,20217.859375,54.863641105662154,-45.136358894337846,-102.71717415649982,-112.63596798900858,-0.017252782339274852,3475200.0
1832,BSESN,2010-12-16,19864.849609,19897.220703,19554.349609,19698.580078,15400.0,217.08007799999905,0.0,217.08007799999905,55.22514146218171,19074.570313,20217.859375,69.12331467752647,-30.87668532247353,-81.90333561776788,-106.48944151476043,-0.005112457478194554,3490600.0
1833,BSESN,2010-12-20,19888.880859,20006.160156,19711.119141,19770.019531,11200.0,24.03125,0.0,24.03125,56.07029348774887,19074.570313,20217.859375,71.22525466792236,-28.774745332077643,-62.745803023401095,-97.74071381648858,-0.004625807090209988,3501800.0
1834,BSESN,2010-12-21,20060.320313,20090.839844,19925.759766,19925.759766,14200.0,171.43945399999942,0.0,171.43945399999942,61.97798799074412,19074.570313,20217.859375,86.22053973608296,-13.77946026391704,-33.34520647768659,-84.86161234872819,0.006304587595242994,3516000.0
1835,BSESN,2010-12-22,20015.800781,20151.25,19931.310547,20118.820313,12000.0,-44.519531999998435,44.519531999998435,0.0,59.57733960307724,19074.570313,20217.859375,82.32655233782003,-17.67344766217997,-13.481964369479101,-70.58568275287837,0.016212049279696217,3504000.0
1836,BSESN,2010-12-23,19982.880859,20076.080078,19939.300781,20038.830078,7600.0,-32.91992200000095,32.91992200000095,0.0,57.67140613435113,19074.570313,20217.859375,79.4471473741783,-20.552852625821696,-0.3920452206621121,-56.54695524643512,0.03848392338842288,3496400.0
1837,BSESN,2010-12-24,20073.660156,20086.419922,19880.359375,19911.460938,16400.0,90.77929700000095,0.0,90.77929700000095,61.58195580545745,19074.570313,20217.859375,87.38733503251181,-12.612664967488186,17.109710513832397,-41.81562209438161,0.028949341192997746,3512800.0
1838,BSESN,2010-12-27,20028.929688,20190.130859,20010.330078,20062.599609,9800.0,-44.73046800000157,44.73046800000157,0.0,58.50876564210347,19074.570313,20190.130859,85.54976046992607,-14.450239530073928,27.05868738258505,-28.040760198988277,0.017121377703606777,3503000.0
1839,BSESN,2010-12-28,20025.419922,20090.410156,19981.759766,20056.470703,10600.0,-3.509765999999217,3.509765999999217,0.0,58.24560451307795,19074.570313,20190.130859,85.23514141920901,-14.764858580790982,34.26512738650854,-15.579582681888912,0.011426249015750622,3492400.0
1840,BSESN,2010-12-29,20256.029297,20274.199219,20054.640625,20060.880859,10000.0,230.609375,0.0,230.609375,68.86311449087435,19074.570313,20274.199219,98.48537144202515,-1.5146285579748562,57.916902291159204,-0.8802856872792848,0.030958209533163306,3502400.0
1841,BSESN,2010-12-30,20389.070313,20410.910156,20274.119141,20274.119141,10600.0,133.04101599999922,0.0,133.04101599999922,73.37063568510911,19074.570313,20410.910156,98.36569693597008,-1.6343030640299139,86.40043202795277,16.575857855767133,0.02638936182846785,3513000.0
1842,BSESN,2010-12-31,20509.089844,20552.029297,20412.759766,20412.759766,12600.0,120.0195309999981,0.0,120.0195309999981,76.85786362396203,19321.410156,20552.029297,96.51074393616939,-3.489256063830614,117.30617509777585,36.72192130416888,0.0311837045732688,3525600.0
1843,BSESN,2011-01-03,20561.050781,20664.800781,20531.0,20621.609375,12000.0,51.96093700000347,0.0,51.96093700000347,78.27880513984601,19554.349609,20664.800781,90.6569507407391,-9.343049259260894,144.32828586646065,58.24319421662724,0.024961239909788713,3537600.0
1844,BSESN,2011-01-04,20498.720703,20651.210938,20449.009766,20617.380859,15200.0,-62.330078000002686,62.330078000002686,0.0,72.1473735959965,19554.349609,20664.800781,85.04390988206345,-14.956090117936544,158.88248852720426,78.37105307874265,0.02412693487928852,3522400.0
1845,BSESN,2011-01-05,20301.099609,20509.949219,20243.949219,20509.949219,14400.0,-197.6210939999983,197.6210939999983,0.0,56.07814955109244,19554.349609,20664.800781,67.24744129496936,-32.75255870503063,152.7100815346057,93.23885876991527,0.015924568246458826,3508000.0
1846,BSESN,2011-01-06,20184.740234,20425.849609,20107.169922,20395.5,16600.0,-116.359375,116.359375,0.0,48.70778826582022,19711.119141,20664.800781,49.66238974675032,-50.33761025324968,136.85163495596134,101.9614140071245,0.005533623521408293,3491400.0
1847,BSESN,2011-01-07,19691.810547,20210.619141,19629.220703,20163.849609,15800.0,-492.92968699999983,492.92968699999983,0.0,29.655908368804873,19629.220703,20664.800781,6.04394052470385,-93.95605947529614,83.54533699313833,98.27819860432729,-0.016831610388146623,3475600.0
1848,BSESN,2011-01-10,19224.119141,19720.429688,19158.429688,19714.419922,17200.0,-467.6914060000017,467.6914060000017,0.0,20.764318401419274,19158.429688,20664.800781,4.360774931572521,-95.63922506842748,3.5203436719166348,79.32662761784516,-0.040014181181773356,3458400.0
1849,BSESN,2011-01-11,19196.339844,19431.560547,19003.599609,19279.769531,20000.0,-27.77929700000095,27.77929700000095,0.0,20.346235853937216,19003.599609,20664.800781,11.602462016562878,-88.39753798343712,-61.43343084096705,51.174615926082716,-0.05231476699912485,3438400.0
1850,BSESN,2011-01-12,19534.099609,19574.630859,19048.560547,19353.339844,19400.0,337.7597650000025,0.0,337.7597650000025,37.89055682633737,19003.599609,20664.800781,31.93472343637377,-68.06527656362623,-84.67924522182511,24.003843696501146,-0.041932794917817984,3457800.0
1851,BSESN,2011-01-13,19182.820313,19522.380859,19136.269531,19492.300781,16800.0,-351.2792960000006,351.2792960000006,0.0,29.969223370504153,19003.599609,20664.800781,10.788621331408455,-89.21137866859155,-129.9490522356391,-6.786735489926912,-0.06466740070320587,3441000.0
1852,BSESN,2011-01-14,18860.439453,19447.820313,18811.960938,19198.039063,15800.0,-322.3808600000011,322.3808600000011,0.0,24.53724829765406,18811.960938,20664.800781,2.6164438973584203,-97.38355610264158,-189.65294055431877,-43.3599765028053,-0.082710331593145,3425200.0
1853,BSESN,2011-01-17,18882.25,19018.939453,18779.380859,18911.429688,17800.0,21.810547000000955,0.0,21.810547000000955,25.590078514172546,18779.380859,20664.800781,5.456033417260092,-94.5439665827399,-232.52833146434568,-81.1936474951134,-0.07885715047395259,3443000.0
1854,BSESN,2011-01-18,19092.050781,19120.619141,18933.470703,18983.199219,14400.0,209.8007810000017,0.0,209.8007810000017,35.56751624380108,18779.380859,20664.800781,16.58356943997544,-83.41643056002455,-246.73402179596815,-114.30172235528437,-0.05955582955043459,3457400.0
1855,BSESN,2011-01-19,18978.320313,19167.060547,18898.560547,19153.310547,16200.0,-113.73046800000157,113.73046800000157,0.0,32.81530212033191,18779.380859,20664.800781,10.551466635027912,-89.44853336497208,-264.1245683999914,-144.26629156422578,-0.05976890992968331,3441200.0
1856,BSESN,2011-01-20,19046.539063,19100.259766,18794.730469,18892.429688,12800.0,68.21875,0.0,68.21875,36.23050491261754,18779.380859,20664.800781,14.169692432050118,-85.83030756794989,-269.297722367246,-169.27257772482986,-0.03276851980979001,3454000.0
1857,BSESN,2011-01-21,19007.529297,19065.339844,18932.400391,19007.080078,11000.0,-39.00976599999922,39.00976599999922,0.0,35.05476651511525,18779.380859,20651.210938,12.188522909188716,-87.81147709081128,-273.39373347700166,-190.09680887526423,-0.01126656791977887,3443000.0
1858,BSESN,2011-01-24,19151.279297,19194.460938,18998.380859,19095.689453,11600.0,143.75,0.0,143.75,42.92941305534359,18779.380859,20509.949219,21.489959402701704,-78.51004059729829,-262.0200244208063,-204.48145198437268,-0.0023473509724345476,3454600.0
1859,BSESN,2011-01-25,18969.449219,19340.990234,18949.439453,19227.419922,13400.0,-181.83007800000266,181.83007800000266,0.0,36.47464502691416,18779.380859,20425.849609,11.544000455520184,-88.45599954447981,-264.627979109875,-216.51075740947317,-0.028905882600283705,3441200.0
1860,BSESN,2011-01-27,18684.429688,19086.689453,18656.050781,19086.689453,13800.0,-285.01953099999815,285.01953099999815,0.0,28.67625538308016,18656.050781,20210.619141,1.8255168270630748,-98.17448317293692,-286.3921457510587,-230.48703507779027,-0.0259810922934125,3427400.0
1861,BSESN,2011-01-28,18395.970703,18723.119141,18235.449219,18708.619141,18600.0,-288.4589850000011,288.4589850000011,0.0,22.947011109685434,18235.449219,19720.429688,10.809669712901831,-89.19033028709816,-323.1910882676457,-249.0278457157614,-0.024626613348933457,3408800.0
1862,BSESN,2011-01-31,18327.759766,18395.089844,18038.480469,18226.210938,19800.0,-68.21093699999983,68.21093699999983,0.0,21.76078543998699,18038.480469,19574.630859,18.831443775501725,-81.16855622449827,-353.78040756961127,-269.9783580865314,-0.029365686504521538,3389000.0
1863,BSESN,2011-02-01,18022.220703,18452.060547,17982.169922,18425.179688,20200.0,-305.53906300000017,305.53906300000017,0.0,17.17262570009146,17982.169922,19574.630859,2.515024392086429,-97.48497560791357,-398.0881994264855,-295.6003263545222,-0.05603536729876468,3368800.0
1864,BSESN,2011-02-02,18090.619141,18306.0,18042.609375,18216.910156,22800.0,68.39843800000017,0.0,68.39843800000017,21.450562745483026,17982.169922,19522.380859,7.04119263113623,-92.95880736886377,-422.8093780559284,-321.0421366948035,-0.04677448569523468,3391600.0
1865,BSESN,2011-02-03,18449.310547,18466.210938,18064.609375,18113.730469,21600.0,358.69140600000173,0.0,358.69140600000173,40.15389797201108,17982.169922,19447.820313,31.872582156599734,-68.12741784340027,-408.74592290741566,-338.582893937326,-0.03135627496547033,3413200.0
1866,BSESN,2011-02-04,18008.150391,18542.199219,17926.980469,18450.070313,23000.0,-441.1601560000017,441.1601560000017,0.0,30.012438140454336,17926.980469,19340.990234,5.740407457511498,-94.2595925424885,-428.26173632772407,-356.51866241540563,-0.052578054221793846,3390200.0
1867,BSESN,2011-02-07,18037.189453,18180.939453,17977.009766,18135.019531,13000.0,29.039061999999827,0.0,29.039061999999827,31.329711309493035,17926.980469,19340.990234,7.794075170336648,-92.20592482966336,-436.3549215393323,-372.485914240191,-0.058173129153545444,3403200.0
1868,BSESN,2011-02-08,17775.699219,18141.509766,17742.179688,18141.509766,14200.0,-261.4902340000008,261.4902340000008,0.0,26.205093399915526,17742.179688,19340.990234,2.096529265700633,-97.90347073429938,-458.5826503115095,-389.7052614544547,-0.0629301349880168,3389000.0
1869,BSESN,2011-02-09,17592.769531,17864.320313,17508.349609,17723.990234,30200.0,-182.92968799999653,182.92968799999653,0.0,23.14870573721737,17508.349609,19340.990234,4.606463528549192,-95.39353647145082,-485.364206081038,-408.8370503797714,-0.05842619631580792,3358800.0
1870,BSESN,2011-02-10,17463.039063,17636.880859,17362.589844,17603.289063,25200.0,-129.73046800000157,129.73046800000157,0.0,21.131887694840827,17362.589844,19340.990234,5.077294743153674,-94.92270525684633,-511.1645596887174,-429.3025522415607,-0.05071391203334852,3333600.0
1871,BSESN,2011-02-11,17728.609375,17752.560547,17295.619141,17519.130859,25400.0,265.57031199999983,0.0,265.57031199999983,34.59219626503095,17295.619141,19340.990234,21.16927512478541,-78.83072487521459,-504.36817868403887,-444.31567753005635,-0.0326908688595694,3359000.0
1872,BSESN,2011-02-14,18202.199219,18227.619141,17857.119141,17940.160156,21800.0,473.5898439999983,0.0,473.5898439999983,51.591929479354135,17295.619141,19340.990234,44.32350105575675,-55.67649894424325,-455.51634642471254,-446.5558113089876,0.009986478301757806,3380800.0
1873,BSESN,2011-02-15,18273.800781,18361.660156,18050.480469,18260.080078,23600.0,71.60156200000347,0.0,71.60156200000347,53.691549991907486,17295.619141,19086.689453,54.61436290056728,-45.38563709943272,-406.3392438805131,-438.5124978232927,0.010125780581209831,3404400.0
1874,BSESN,2011-02-16,18300.900391,18358.839844,18216.119141,18273.060547,18800.0,27.099609999997483,0.0,27.099609999997483,54.552390178866844,17295.619141,18723.119141,70.42250437828372,-29.577495621716288,-361.0177360310081,-423.0135454648358,-0.008044211496246678,3423200.0
1875,BSESN,2011-02-17,18506.820313,18532.609375,18233.789063,18345.119141,16600.0,205.91992200000092,0.0,205.91992200000092,60.92155885266174,17295.619141,18542.199219,97.16192271765168,-2.8380772823483325,-304.96860948189715,-399.4045582682481,0.027691345927965072,3439800.0
1876,BSESN,2011-02-18,18211.519531,18690.970703,18159.820313,18564.080078,22000.0,-295.30078199999843,295.30078199999843,0.0,49.453650863038085,17295.619141,18690.970703,65.63939977156829,-34.36060022843171,-281.13680793507956,-375.7510082016144,0.009665035589622173,3417800.0
1877,BSESN,2011-02-21,18438.310547,18457.490234,18082.660156,18238.539063,19200.0,226.7910159999992,0.0,226.7910159999992,56.679883866242115,17295.619141,18690.970703,81.89272417928478,-18.10727582071522,-241.16973925953425,-348.8347544131984,0.03727624549878494,3437000.0
1878,BSESN,2011-02-22,18296.160156,18457.900391,18187.330078,18390.720703,19800.0,-142.15039099999922,142.15039099999922,0.0,51.368705259355025,17295.619141,18690.970703,71.70529938461506,-28.294700615384937,-218.44776804924186,-322.7573571404071,0.03998180182833422,3417200.0
1879,BSESN,2011-02-23,18178.330078,18377.480469,18150.009766,18233.769531,22200.0,-117.83007800000269,117.83007800000269,0.0,47.14357162319841,17295.619141,18690.970703,63.26082695136582,-36.739173048634186,-207.55577098079084,-299.71703990848386,0.04096028259568696,3395000.0
1880,BSESN,2011-02-24,17632.410156,18135.119141,17559.699219,18135.119141,23000.0,-545.9199219999973,545.9199219999973,0.0,32.74527406503523,17295.619141,18690.970703,24.136642275103036,-75.86335772489696,-240.20601467951565,-287.81483486269025,-0.005426213470282271,3372000.0
1881,BSESN,2011-02-25,17700.910156,17812.439453,17469.970703,17775.080078,21800.0,68.5,0.0,68.5,35.593207720597164,17295.619141,18690.970703,29.045799355331397,-70.9542006446686,-257.58491199698256,-281.7688502895487,-0.027540027277403678,3393800.0
1882,BSESN,2011-02-28,17823.400391,18296.529297,17718.880859,17811.080078,30000.0,122.49023499999748,0.0,122.49023499999748,40.76832151063953,17295.619141,18690.970703,37.824249054733926,-62.175750945266074,-258.49411579845037,-277.1139033913291,-0.02464732955107518,3423800.0
1883,BSESN,2011-03-01,18446.5,18478.679688,17964.390625,17982.279297,24800.0,623.0996090000008,0.0,623.0996090000008,59.75069566950901,17295.619141,18690.970703,82.47963383152043,-17.52036616847956,-206.55470135460564,-263.0020629839844,0.007955871344538012,3448600.0
1884,BSESN,2011-03-03,18489.759766,18603.570313,18253.619141,18318.320313,28600.0,43.25976599999922,0.0,43.25976599999922,60.75813911923292,17295.619141,18690.970703,85.57991100740246,-14.42008899259754,-160.05660669512872,-242.41297172621324,-0.0009218518746851867,3477200.0
1885,BSESN,2011-03-04,18486.449219,18736.970703,18448.689453,18622.699219,19800.0,-3.310547000000952,3.310547000000952,0.0,60.6241494064795,17469.970703,18736.970703,80.22719147592733,-19.772808524072673,-122.0665578571352,-218.34368895239766,0.015096471633353037,3457400.0
1886,BSESN,2011-03-07,18222.669922,18363.449219,18058.710938,18361.650391,15200.0,-263.7792969999973,263.7792969999973,0.0,50.404712057703456,17469.970703,18736.970703,59.407988871349794,-40.592011128650206,-111.95342581759905,-197.06563632543794,-0.011695248566853444,3442200.0
1887,BSESN,2011-03-08,18439.650391,18466.810547,18266.619141,18277.339844,13800.0,216.9804689999983,0.0,216.9804689999983,57.245294623310684,17469.970703,18736.970703,76.53351917916339,-23.46648082083661,-85.44522597103787,-174.74155425455794,0.00784264205038343,3456000.0
1888,BSESN,2011-03-09,18469.949219,18583.300781,18303.800781,18522.800781,22600.0,30.29882799999905,0.0,30.29882799999905,58.17478301179451,17469.970703,18736.970703,78.92490260457768,-21.07509739542232,-61.28595803460121,-152.05043501056662,0.01604213036889046,3478600.0
1889,BSESN,2011-03-10,18327.980469,18430.839844,18261.259766,18430.839844,18600.0,-141.96875,141.96875,0.0,52.05624422476334,17469.970703,18736.970703,67.71979210734011,-32.28020789265989,-52.98448363386706,-132.2372447352267,0.039448396835489064,3460000.0
1890,BSESN,2011-03-11,18174.089844,18368.429688,18063.289063,18248.109375,20600.0,-153.890625,153.890625,0.0,46.00449990563235,17469.970703,18736.970703,55.573728571428504,-44.42627142857149,-58.15284290812269,-117.42036436980591,0.026731941116576063,3439400.0
1891,BSESN,2011-03-14,18439.480469,18463.839844,18155.429688,18167.099609,15400.0,265.390625,0.0,265.390625,56.14858098877802,17469.970703,18736.970703,76.52010781373316,-23.479892186266834,-40.36865467104508,-102.01002243005375,0.03456579914521196,3454800.0
1892,BSESN,2011-03-15,18167.640625,18326.330078,17920.550781,18113.789063,22400.0,-271.83984399999827,271.83984399999827,0.0,45.94661046540901,17469.970703,18736.970703,55.06471365430158,-44.93528634569843,-47.660361930644285,-91.14009033017187,-0.015117197029246743,3432400.0
1893,BSESN,2011-03-16,18358.689453,18444.470703,18263.679688,18263.679688,16200.0,191.04882799999905,0.0,191.04882799999905,52.888133404133335,17469.970703,18736.970703,70.14354775059195,-29.85645224940805,-37.589737613456236,-80.43001978682875,-0.007088805623154726,3448600.0
1894,BSESN,2011-03-17,18149.869141,18354.269531,18104.019531,18227.160156,18200.0,-208.82031199999986,208.82031199999986,0.0,45.51630673396122,17469.970703,18736.970703,53.66207087608525,-46.33792912391475,-45.92930484513636,-73.52987679849028,-0.01820685378856146,3430400.0
1895,BSESN,2011-03-18,17878.810547,18259.609375,17849.529297,18251.179688,16400.0,-271.05859399999827,271.05859399999827,0.0,37.655252573856274,17718.880859,18736.970703,15.708799075300513,-84.29120092469948,-73.56265071787493,-73.53643158236721,-0.018869867943163587,3414000.0
1896,BSESN,2011-03-21,17839.050781,18007.730469,17792.169922,17984.720703,12400.0,-39.75976599999922,39.75976599999922,0.0,36.585815924583144,17792.169922,18736.970703,4.961983514702543,-95.03801648529746,-97.54610644474815,-78.3383665548434,-0.03257109529002444,3401600.0
1897,BSESN,2011-03-22,17988.300781,18041.380859,17878.800781,17929.089844,11800.0,149.25,0.0,149.25,43.53205758117622,17792.169922,18736.970703,20.758964529264205,-79.2410354707358,-103.31894376415221,-83.33448199670516,-0.0260774099749298,3413400.0
1898,BSESN,2011-03-23,18206.160156,18218.279297,17950.169922,17972.039063,13400.0,217.859375,0.0,217.859375,52.32721852674244,17792.169922,18736.970703,43.81772775016383,-56.18227224983616,-89.28530270369447,-84.52464613810304,-0.0066466850074422545,3426800.0
1899,BSESN,2011-03-24,18350.740234,18373.970703,18269.320313,18286.419922,11200.0,144.58007799999902,0.0,144.58007799999902,57.40715818351116,17792.169922,18583.300781,70.60403543176658,-29.395964568233424,-65.73933493605728,-80.7675838976939,0.009719902978157835,3438000.0
1900,BSESN,2011-03-25,18815.640625,18858.300781,18480.689453,18480.689453,15200.0,464.90039099999916,0.0,464.90039099999916,69.47526862641985,17792.169922,18858.300781,95.99860039319978,-4.00139960680021,-9.456402104591689,-66.50534753907345,0.020399715525195594,3453200.0
1901,BSESN,2011-03-28,18943.140625,19024.179688,18799.570313,18799.710938,12800.0,127.5,0.0,127.5,71.98693243353202,17792.169922,19024.179688,93.4222061191031,-6.5777938808969,44.91861822894134,-44.220554385470486,0.042685784907747104,3466000.0
1902,BSESN,2011-03-29,19120.800781,19226.210938,18944.820313,18949.570313,17200.0,177.6601560000017,0.0,177.6601560000017,75.25988114363622,17792.169922,19226.210938,92.64943221121938,-7.350567788780631,101.18055693779388,-15.140332120817606,0.04151229476107643,3483200.0
1903,BSESN,2011-03-30,19290.179688,19357.099609,19178.769531,19178.769531,12200.0,169.37890699999843,0.0,169.37890699999843,78.07752045575168,17792.169922,19357.099609,95.72377458515166,-4.2762254148483425,157.61907634857198,19.411549573060324,0.06282748036039965,3495400.0
1904,BSESN,2011-03-31,19445.220703,19575.160156,19284.349609,19339.75,16200.0,155.04101499999888,0.0,155.04101499999888,80.43137252501342,17792.169922,19575.160156,92.71227343133039,-7.28772656866962,212.40900498837073,58.01104065612242,0.08761266035468096,3511600.0
1905,BSESN,2011-04-01,19420.390625,19562.550781,19382.349609,19463.109375,12400.0,-24.83007799999905,24.83007799999905,0.0,78.86656189250623,17792.169922,19575.160156,91.31966468190977,-8.680335318090233,250.9342248515968,96.5956774952173,0.08864484234128933,3499200.0
1906,BSESN,2011-04-04,19701.730469,19729.599609,19449.359375,19473.929688,10600.0,281.33984399999827,0.0,281.33984399999827,83.15192527111441,17792.169922,19729.599609,98.56154057166553,-1.4384594283344705,300.70121686008497,137.41678536819086,0.0952524481806416,3509800.0
1907,BSESN,2011-04-05,19686.820313,19770.210938,19523.539063,19731.380859,12600.0,-14.910155999998095,14.910155999998095,0.0,82.13348259947384,17792.169922,19770.210938,95.78418120122541,-4.215818798774597,335.0762412671902,176.94867654799074,0.08132742677823979,3497200.0
1908,BSESN,2011-04-06,19612.199219,19811.140625,19550.550781,19698.609375,14400.0,-74.6210940000019,74.6210940000019,0.0,76.7080712389398,17792.169922,19811.140625,90.1463946106601,-9.853605389339908,352.2370279192837,212.00634682224936,0.06874158583874368,3482800.0
1909,BSESN,2011-04-07,19591.179688,19665.089844,19537.019531,19620.880859,9600.0,-21.019530999998093,21.019530999998093,0.0,75.09580257178334,17792.169922,19811.140625,89.10529327279694,-10.894706727203062,359.99121979862684,241.60332141752488,0.041217786758190655,3473200.0
1910,BSESN,2011-04-08,19451.449219,19697.210938,19388.419922,19602.810547,10400.0,-139.7304690000019,139.7304690000019,0.0,64.66988180325609,17878.800781,19811.140625,81.38570670594721,-18.614293294052786,350.8173871935651,263.44613457273294,0.02683338544872349,3462800.0
1911,BSESN,2011-04-11,19262.539063,19426.300781,19242.589844,19382.910156,9400.0,-188.9101559999981,188.9101559999981,0.0,53.15727737131876,17950.169922,19811.140625,70.5206771328737,-29.4793228671263,324.56223652927656,275.6693549640417,0.007412779601827291,3453400.0
1912,BSESN,2011-04-13,19696.859375,19737.330078,19101.630859,19187.009766,17800.0,434.32031199999983,0.0,434.32031199999983,68.1829557408261,18269.320313,19811.140625,92.58790086558413,-7.412099134415867,334.9398814215929,287.5234602555519,0.021082213518881066,3471200.0
1913,BSESN,2011-04-15,19386.820313,19700.960938,19337.119141,19670.070313,17000.0,-310.03906199999983,310.03906199999983,0.0,53.93333215449336,18480.689453,19811.140625,68.10703609948044,-31.89296390051957,314.52107539224744,292.92298328289104,-0.003003328730076582,3454200.0
1914,BSESN,2011-04-18,19091.169922,19649.220703,19071.470703,19389.740234,13800.0,-295.6503909999992,295.6503909999992,0.0,43.849942564193384,18799.570313,19811.140625,28.82643010978369,-71.1735698902163,271.3545030058158,288.609287227476,-0.01695232136969438,3440400.0
1915,BSESN,2011-04-19,19121.830078,19201.919922,18976.189453,19091.779297,11400.0,30.660155999998093,0.0,30.660155999998093,45.07861076289322,18944.820313,19811.140625,20.432369245891458,-79.56763075410855,236.88800428703325,278.2650306393875,-0.029433982558661698,3451800.0
1916,BSESN,2011-04-20,19470.980469,19484.769531,19171.029297,19274.210938,15400.0,349.15039099999916,0.0,349.15039099999916,57.34332628082466,18976.189453,19811.140625,59.259874420536605,-40.74012557946339,235.03721164654053,269.61946684081806,-0.010963672170943406,3467200.0
1917,BSESN,2011-04-21,19602.230469,19695.980469,19530.5,19582.5,15200.0,131.25,0.0,131.25,61.11024190732646,18976.189453,19811.140625,74.97935651738908,-25.02064348261092,241.37875916015037,263.9713253046845,-0.0005082933274684898,3482400.0
1918,BSESN,2011-04-25,19584.310547,19697.490234,19531.339844,19538.519531,11400.0,-17.919921999997314,17.919921999997314,0.0,60.27175277741065,18976.189453,19811.140625,72.83313257029612,-27.166867429703878,242.16694352939157,259.61044894962595,-0.0003506241640061081,3471000.0
1919,BSESN,2011-04-26,19545.349609,19626.130859,19306.919922,19596.320313,11600.0,-38.96093800000017,38.96093800000017,0.0,58.26616772345756,18976.189453,19811.140625,68.16687910463835,-31.83312089536164,236.9167345932765,255.07170607835604,0.004827423856330615,3459400.0
1920,BSESN,2011-04-27,19448.689453,19633.630859,19412.789063,19610.710938,13400.0,-96.66015600000172,96.66015600000172,0.0,53.19866499405059,18976.189453,19811.140625,56.59013554866888,-43.40986445133112,222.3926355510921,248.5358919729033,0.00966385528881597,3446000.0
1921,BSESN,2011-04-28,19292.019531,19542.050781,19265.919922,19532.849609,14000.0,-156.6699219999973,156.6699219999973,0.0,45.75624822901452,18976.189453,19811.140625,37.82617338490331,-62.17382661509669,195.98108114994466,238.02492980831155,-0.02055352258410481,3432000.0
1922,BSESN,2011-04-29,19135.960938,19356.5,19015.050781,19292.570313,10600.0,-156.05859300000157,156.05859300000157,0.0,39.41814382613636,18976.189453,19737.330078,20.991059963459595,-79.00894003654041,160.60574670859205,222.54109318836765,-0.012939686392604788,3421400.0
1923,BSESN,2011-05-02,18998.019531,19253.869141,18954.759766,19224.050781,9400.0,-137.94140699999843,137.94140699999843,0.0,34.53870475462678,18954.759766,19737.330078,5.527907759424757,-94.47209224057525,120.05589099859571,202.04405275041327,-0.004879239532232904,3412000.0
1924,BSESN,2011-05-03,18534.689453,19024.949219,18502.419922,18979.310547,13400.0,-463.3300780000027,463.3300780000027,0.0,23.34086190577844,18502.419922,19737.330078,2.613107588694748,-97.38689241130525,49.95709878138223,171.62666195660708,-0.030705252719273712,3398600.0
1925,BSESN,2011-05-04,18469.359375,18604.359375,18339.529297,18558.330078,13000.0,-65.33007799999905,65.33007799999905,0.0,22.171384785103584,18339.529297,19737.330078,9.288167510331304,-90.7118324896687,-10.744435232460091,135.15244251879363,-0.05144173893013204,3385600.0
1926,BSESN,2011-05-05,18210.580078,18569.210938,18160.650391,18484.710938,14800.0,-258.7792970000009,258.7792970000009,0.0,18.040154904586927,18160.650391,19700.960938,3.24153379961241,-96.75846620038759,-78.8235361694351,92.35724678114788,-0.07099449183606066,3370800.0
1927,BSESN,2011-05-06,18518.810547,18568.480469,18271.679688,18289.779297,30200.0,308.23046900000185,0.0,308.23046900000185,34.749650185659775,18160.650391,19697.490234,23.30497596293782,-76.69502403706218,-106.67540363664375,52.55071669758955,-0.05440579577427185,3401000.0
1928,BSESN,2011-05-09,18528.960938,18643.580078,18367.210938,18628.630859,9200.0,10.150390999999217,0.0,10.150390999999217,35.251240070495086,18160.650391,19697.490234,23.96544758242584,-76.03455241757416,-126.47127540568908,16.746318276933817,-0.05200156003001277,3410200.0
1929,BSESN,2011-05-10,18512.769531,18689.369141,18429.060547,18564.949219,13200.0,-16.191406999998435,16.191406999998435,0.0,34.759440184858946,18160.650391,19697.490234,22.91189557609629,-77.08810442390372,-141.83121566456248,-14.969188511365454,-0.04812251870552797,3397000.0
1930,BSESN,2011-05-11,18584.960938,18622.439453,18454.929688,18572.609375,10000.0,72.19140699999843,0.0,72.19140699999843,39.12839544351824,18160.650391,19697.490234,27.60928856267299,-72.39071143732701,-146.49018806494132,-41.273388422080636,-0.03665031501050686,3407000.0
1931,BSESN,2011-05-12,18335.789063,18610.019531,18314.339844,18525.320313,10200.0,-249.171875,249.171875,0.0,30.890050721615154,18160.650391,19697.490234,11.396026254636917,-88.60397374536308,-168.34793495338818,-66.68829772834215,-0.041815087185458566,3396800.0
1932,BSESN,2011-05-13,18531.279297,18724.539063,18280.699219,18362.449219,12600.0,195.4902340000008,0.0,195.4902340000008,41.95365755934285,18160.650391,19633.630859,25.161834393041072,-74.83816560695892,-167.95979279529274,-86.94259674173227,-0.024567836307273883,3409400.0
1933,BSESN,2011-05-16,18345.029297,18492.679688,18319.880859,18492.679688,9400.0,-186.25,186.25,0.0,35.67533847981774,18160.650391,19633.630859,12.517403319702508,-87.48259668029749,-180.5991709586633,-105.67391158511849,-0.01023271290738026,3400000.0
1934,BSESN,2011-05-17,18137.349609,18435.800781,18084.669922,18374.449219,14200.0,-207.67968800000014,207.67968800000014,0.0,29.91544257127306,18084.669922,19542.050781,3.6146822345496306,-96.38531776545037,-205.0107480956758,-125.54127888722996,-0.01797624699692646,3385800.0
1935,BSESN,2011-05-18,18086.199219,18218.199219,18020.789063,18177.320313,12400.0,-51.150390000002524,51.150390000002524,0.0,28.603055928772292,18020.789063,19356.5,4.897029303878352,-95.10297069612164,-225.88069578883005,-145.60916226754998,-0.0068301426130991105,3373400.0
1936,BSESN,2011-05-19,18141.400391,18198.449219,18057.820313,18166.640625,13400.0,55.20117200000095,0.0,55.20117200000095,32.301286956573605,18020.789063,19253.869141,9.781305379260141,-90.21869462073985,-235.25414312917565,-163.53815843987513,-0.02037982704354313,3386800.0
1937,BSESN,2011-05-20,18326.089844,18429.470703,18161.380859,18199.960938,17000.0,184.68945299999905,0.0,184.68945299999905,43.582806409080334,18020.789063,19024.949219,30.40359440431718,-69.59640559568282,-225.18399145418516,-175.86732504273715,-0.010948865113312722,3403800.0
1938,BSESN,2011-05-23,17993.330078,18269.060547,17971.019531,18269.060547,10400.0,-332.7597659999992,332.7597659999992,0.0,32.36899934780213,17971.019531,18724.539063,2.960845214029218,-97.03915478597078,-241.27301074638308,-188.94846218346635,-0.02805844107388633,3393400.0
1939,BSESN,2011-05-24,18011.970703,18110.390625,17933.939453,18016.429688,12600.0,18.640625,0.0,18.640625,33.47536316991983,17933.939453,18724.539063,9.86988217714905,-90.13011782285095,-249.64181633717453,-201.087133014208,-0.0308308549537184,3406000.0
1940,BSESN,2011-05-25,17847.240234,17976.359375,17786.130859,17976.359375,10200.0,-164.7304689999983,164.7304689999983,0.0,28.68972452238772,17786.130859,18724.539063,6.512024803227321,-93.48797519677268,-266.4945439842413,-214.1686152082147,-0.02664454893767554,3395800.0
1941,BSESN,2011-05-26,18044.640625,18072.609375,17862.880859,17917.109375,12600.0,197.4003909999992,0.0,197.4003909999992,40.459067478122385,17786.130859,18724.539063,27.547688191353387,-72.45231180864661,-260.9142333831187,-223.51773884319553,-0.026260392723063797,3408400.0
1942,BSESN,2011-05-27,18266.099609,18298.640625,18087.160156,18105.609375,12800.0,221.4589840000008,0.0,221.4589840000008,50.940416089574306,17786.130859,18724.539063,51.147117848513645,-48.85288215148636,-235.90256984795633,-225.9947050441477,-0.004302510872136178,3421200.0
1943,BSESN,2011-05-30,18232.060547,18380.169922,18199.519531,18319.740234,11600.0,-34.03906199999983,34.03906199999983,0.0,49.398201323516446,17786.130859,18724.539063,47.51979853748172,-52.48020146251828,-216.33355555860908,-224.06247514704,0.00522187309842681,3409600.0
1944,BSESN,2011-05-31,18503.279297,18526.800781,18266.609375,18266.609375,14600.0,271.21875,0.0,271.21875,60.41594537250944,17786.130859,18724.539063,76.42179969688337,-23.578200303116635,-176.90068333124145,-214.63011678388028,0.02306068140407569,3424200.0
1945,BSESN,2011-06-01,18608.810547,18636.119141,18514.660156,18527.119141,12600.0,105.53125,0.0,105.53125,63.94088044723757,17786.130859,18724.539063,87.66757201112456,-12.332427988875436,-135.57157337155513,-198.81840810141526,0.025764833250242702,3436800.0
1946,BSESN,2011-06-02,18494.179688,18540.669922,18390.570313,18425.849609,15400.0,-114.63085900000078,114.63085900000078,0.0,57.52101724460579,17786.130859,18636.119141,83.3010106132264,-16.698989386773604,-110.79058339890616,-181.21284316091345,0.009172160860874357,3421400.0
1947,BSESN,2011-06-03,18376.480469,18672.650391,18345.849609,18554.400391,14400.0,-117.6992190000019,117.6992190000019,0.0,51.40621103825042,17786.130859,18672.650391,66.59183342166888,-33.40816657833112,-99.50181860097291,-164.87063824892536,0.021294023359715197,3407000.0
1948,BSESN,2011-06-06,18420.109375,18458.630859,18258.419922,18344.269531,8800.0,43.62890600000173,0.0,43.62890600000173,53.51957770803112,17786.130859,18672.650391,71.51320338873259,-28.48679661126741,-86.04305232793558,-149.1051210647274,0.022659301346299898,3415800.0
1949,BSESN,2011-06-07,18495.619141,18545.949219,18351.240234,18355.300781,10000.0,75.50976599999922,0.0,75.50976599999922,57.23382808440359,17786.130859,18672.650391,80.03075582546778,-19.96924417453222,-68.49431619575262,-132.98296009093244,0.03632936512866558,3425800.0
1950,BSESN,2011-06-08,18394.289063,18505.099609,18365.939453,18448.400391,10800.0,-101.33007799999905,101.33007799999905,0.0,50.93189089547969,17786.130859,18672.650391,68.60065481332231,-31.399345186677685,-62.04805546317584,-118.79597916538111,0.019376857941719283,3415000.0
1951,BSESN,2011-06-09,18384.900391,18449.640625,18327.009766,18394.570313,10000.0,-9.388672000000954,9.388672000000954,0.0,50.33931730286305,17786.130859,18672.650391,67.5416062914223,-32.4583937085777,-57.03941982980905,-106.44466729826671,0.006503894347617889,3405000.0
1952,BSESN,2011-06-10,18268.539063,18399.019531,18182.900391,18390.410156,9600.0,-116.36132799999905,116.36132799999905,0.0,43.15853732100597,17786.130859,18672.650391,54.41597016048602,-45.58402983951399,-61.747638364013255,-97.50526151141602,0.002000789538075587,3395400.0
1953,BSESN,2011-06-13,18266.029297,18313.210938,18120.759766,18242.25,10400.0,-2.509765999999217,2.509765999999217,0.0,43.005863547195155,17786.130859,18672.650391,54.13286686615282,-45.86713313384718,-64.9329460319641,-90.99079841552565,-0.012822051496486186,3385000.0
1954,BSESN,2011-06-14,18308.660156,18380.189453,18261.109375,18276.779297,26800.0,42.63085900000078,0.0,42.63085900000078,46.70119941802144,17862.880859,18672.650391,55.05014444035686,-44.94985555964313,-63.28782857486294,-85.45020444739312,-0.016129477498946776,3411800.0
1955,BSESN,2011-06-15,18132.240234,18308.689453,18111.210938,18298.589844,9600.0,-176.41992200000095,176.41992200000095,0.0,35.66077117417042,18087.160156,18672.650391,7.699543955673188,-92.30045604432682,-75.35107416175379,-83.43037839026526,-0.01957045189924511,3402200.0
1956,BSESN,2011-06-16,17985.880859,18155.099609,17958.939453,18060.109375,10600.0,-146.359375,146.359375,0.0,29.080045416815665,17958.939453,18672.650391,3.774834399413636,-96.22516560058637,-95.61902498724521,-85.86810770966126,-0.02125540908983714,3391600.0
1957,BSESN,2011-06-17,17870.529297,18064.759766,17844.089844,18060.169922,10800.0,-115.35156199999984,115.35156199999984,0.0,24.9012175293135,17844.089844,18672.650391,3.1910103728367187,-96.80898962716327,-119.61063214696333,-92.61661259712169,-0.029835874848055832,3380800.0
1958,BSESN,2011-06-20,17506.630859,17925.169922,17314.380859,17925.169922,12800.0,-363.89843800000017,363.89843800000017,0.0,16.34930412277214,17314.380859,18672.650391,14.154039052684887,-85.84596094731512,-166.07332646130817,-107.307955369959,-0.05347148827300774,3368000.0
1959,BSESN,2011-06-21,17560.300781,17714.880859,17504.269531,17574.369141,11400.0,53.66992200000095,0.0,53.66992200000095,20.968251177819695,17314.380859,18672.650391,18.10538455043555,-81.89461544956445,-196.30178747156242,-125.10672179027969,-0.045339522454149184,3379400.0
1960,BSESN,2011-06-22,17550.630859,17678.859375,17492.189453,17659.369141,9600.0,-9.669922000000954,9.669922000000954,0.0,20.730283170421373,17314.380859,18672.650391,17.3934550127272,-82.6065449872728,-218.5193870269286,-143.7892548376095,-0.04537797400351429,3369800.0
1961,BSESN,2011-06-23,17727.490234,17754.550781,17482.210938,17526.919922,11400.0,176.859375,0.0,176.859375,36.04713156683978,17314.380859,18545.949219,33.54335726845084,-66.45664273154915,-219.32764864977435,-158.89693360004247,-0.02961642565583189,3381200.0
1962,BSESN,2011-06-24,18240.679688,18268.949219,17804.939453,17804.939453,14800.0,513.1894539999994,0.0,513.1894539999994,61.1685184361074,17314.380859,18545.949219,75.21294465538246,-24.78705534461755,-176.52325161183398,-162.42219720240078,-0.0013878007413556936,3396000.0
1963,BSESN,2011-06-27,18412.410156,18494.109375,18132.699219,18132.699219,13400.0,171.73046800000157,0.0,171.73046800000157,66.28247268612948,17314.380859,18505.099609,92.2156720048291,-7.784327995170905,-127.27608552670063,-155.39297486726076,0.005666717231954221,3409400.0
1964,BSESN,2011-06-28,18492.449219,18527.449219,18323.439453,18493.589844,11400.0,80.03906299999653,0.0,80.03906299999653,68.51251642294426,17314.380859,18527.449219,97.11475452216064,-2.885245477839359,-80.85680125456929,-140.48574014472248,0.01986566361086295,3420800.0
1965,BSESN,2011-06-29,18693.859375,18715.390625,18552.189453,18552.189453,13800.0,201.4101560000017,0.0,201.4101560000017,73.5851460443217,17314.380859,18715.390625,98.46316203337587,-1.5368379666241394,-27.500064081195887,-117.88860493201716,0.03936301599850367,3434600.0
1966,BSESN,2011-06-30,18845.869141,18873.390625,18723.140625,18741.099609,11400.0,152.00976599999922,0.0,152.00976599999922,76.83501109423062,17314.380859,18873.390625,98.23468174477101,-1.765318255228992,26.743173602575553,-88.96224922509862,0.054578117289661554,3446000.0
1967,BSESN,2011-07-01,18762.800781,19031.380859,18713.070313,18974.960938,14000.0,-83.06835999999748,83.06835999999748,0.0,71.30354460203233,17314.380859,19031.380859,84.35759592312178,-15.642404076878222,62.31013539353444,-58.707772301372,0.07175395038127608,3432000.0
1968,BSESN,2011-07-04,18814.480469,18942.419922,18781.880859,18896.240234,12200.0,51.67968799999653,0.0,51.67968799999653,72.71367207914389,17314.380859,19031.380859,87.3674787419917,-12.6325212580083,93.58849782925972,-28.24851827524565,0.07142131012681752,3444200.0
1969,BSESN,2011-07-05,18744.560547,18837.880859,18694.050781,18837.880859,12200.0,-69.91992199999731,69.91992199999731,0.0,67.53312167672647,17314.380859,19031.380859,83.29526429819454,-16.704735701805465,111.45014416118647,-0.30878578795921796,0.06802773630144188,3432000.0
1970,BSESN,2011-07-06,18726.970703,18823.449219,18682.599609,18730.289063,8400.0,-17.589844000001904,17.589844000001904,0.0,66.16477659371029,17314.380859,19031.380859,82.27081211415249,-17.72918788584751,122.7710459635673,24.307180562346097,0.05638025776954425,3423600.0
1971,BSESN,2011-07-07,19078.300781,19097.779297,18767.25,18776.619141,11400.0,351.3300780000027,0.0,351.3300780000027,76.93514891675727,17314.380859,19097.779297,98.90778664010475,-1.0922133598952504,158.2679291424829,51.09933027837347,0.04592049788314889,3435000.0
1972,BSESN,2011-07-08,18858.039063,19131.699219,18817.710938,19084.060547,12200.0,-220.2617180000016,220.2617180000016,0.0,62.53528470635801,17482.210938,19131.699219,83.40939070909359,-16.590609290906407,166.70451903887442,74.22036803047368,0.02420263850437765,3422800.0
1973,BSESN,2011-07-11,18721.390625,18843.970703,18679.490234,18823.189453,9200.0,-136.64843800000014,136.64843800000014,0.0,55.146618583897364,17482.210938,19131.699219,75.12509796363939,-24.874902036360616,160.51388622221202,91.47907166882136,0.012380264143960762,3413600.0
1974,BSESN,2011-07-12,18411.619141,18589.189453,18326.419922,18534.109375,10600.0,-309.7714840000008,309.7714840000008,0.0,42.12727817097306,17482.210938,19131.699219,56.34524438309726,-43.65475561690273,129.12334171659677,99.00792567837645,-0.01509801846361647,3403000.0
1975,BSESN,2011-07-13,18596.019531,18626.410156,18465.400391,18468.820313,9800.0,184.4003900000025,0.0,184.4003900000025,50.202363671185154,17804.939453,19131.699219,59.62496740348118,-40.37503259651882,117.76812181371861,102.75996490544489,-0.013257526523753671,3412800.0
1976,BSESN,2011-07-14,18618.199219,18803.050781,18449.230469,18563.689453,11800.0,22.179687999996535,0.0,22.179687999996535,51.148369449892755,18132.699219,19131.699219,48.5985985985986,-51.4014014014014,109.29881498594841,104.06773492154561,-0.007706821795306462,3424600.0
1977,BSESN,2011-07-15,18561.919922,18936.429688,18513.220703,18694.189453,6800.0,-56.279296999997314,56.279296999997314,0.0,48.45341993494147,18323.439453,19131.699219,29.505423755065664,-70.49457624493434,96.9282310726121,102.63983415175893,-0.013423732184161707,3417800.0
1978,BSESN,2011-07-18,18507.039063,18622.560547,18469.529297,18592.189453,9000.0,-54.88085900000078,54.88085900000078,0.0,45.74166197402567,18326.419922,19131.699219,22.429378437131213,-77.5706215628688,81.75362266105367,98.4625918536179,-0.012671488531536435,3408800.0
1979,BSESN,2011-07-19,18653.869141,18690.419922,18481.830078,18521.380859,8400.0,146.83007799999902,0.0,146.83007799999902,53.73488875260246,18326.419922,19131.699219,40.66281353809588,-59.33718646190411,80.64595992651448,94.89926546819723,-0.0039035444204699177,3417200.0
1980,BSESN,2011-07-20,18502.380859,18765.599609,18473.900391,18756.310547,9800.0,-151.48828199999843,151.48828199999843,0.0,45.717231472907756,18326.419922,19131.699219,21.850920252827564,-78.14907974717244,66.77455540314259,89.2743234551863,-0.030187170682074438,3407400.0
1981,BSESN,2011-07-21,18436.189453,18566.990234,18415.359375,18514.650391,8000.0,-66.19140600000172,66.19140600000172,0.0,42.51876194908093,18326.419922,19131.699219,13.63123718800863,-86.36876281199137,49.86545616228614,81.39254999660628,-0.02236974950527504,3399400.0
1982,BSESN,2011-07-22,18722.300781,18747.060547,18533.429688,18565.039063,14800.0,286.1113280000027,0.0,286.1113280000027,57.387666289768944,18326.419922,19131.699219,49.16069002081922,-50.83930997918079,58.87301476090579,76.88864294946619,4.86158329919828e-05,3414200.0
1983,BSESN,2011-07-25,18871.289063,18932.269531,18670.839844,18753.349609,22800.0,148.98828199999843,0.0,148.98828199999843,63.119740312814386,18326.419922,19131.699219,67.66213201182062,-32.33786798817938,77.14440636083964,76.93979563174088,0.024966295385525417,3437000.0
1984,BSESN,2011-07-26,18518.220703,18944.599609,18481.630859,18898.189453,15600.0,-353.0683600000011,353.0683600000011,0.0,46.14635505874174,18326.419922,19131.699219,23.817920281141753,-76.18207971885825,62.4154632968457,74.03492916476185,-0.004183628000084094,3421400.0
1985,BSESN,2011-07-27,18432.25,18578.550781,18358.759766,18571.150391,14200.0,-85.97070299999905,85.97070299999905,0.0,42.904832414303996,18326.419922,19131.699219,13.142033874987277,-86.85796612501272,43.30634398122129,67.88921212805374,-0.009987497545425161,3407200.0
1986,BSESN,2011-07-28,18209.519531,18327.849609,18188.880859,18300.550781,12200.0,-222.7304689999983,222.7304689999983,0.0,35.45897246593594,18188.880859,18944.599609,2.730999065459333,-97.26900093454067,10.073619423608761,56.32609358716474,-0.018985126133548635,3395000.0
1987,BSESN,2011-07-29,18197.199219,18334.269531,18131.859375,18194.150391,16200.0,-12.320312000003467,12.320312000003467,0.0,35.07051738404688,18131.859375,18944.599609,8.039449908665185,-91.96055009133481,-17.061031479635858,41.64866857380462,-0.016741729616783774,3378800.0
1988,BSESN,2011-08-01,18314.330078,18440.070313,18219.25,18352.230469,9600.0,117.13085900000078,0.0,117.13085900000078,42.036276701549546,18131.859375,18944.599609,22.451294443975918,-77.54870555602407,-28.782173418308957,27.562500175381903,-0.01820207166853738,3388400.0
1989,BSESN,2011-08-02,18109.890625,18283.550781,18037.869141,18283.550781,11000.0,-204.43945299999905,204.43945299999905,0.0,34.5676936395208,18037.869141,18944.599609,7.942987088418943,-92.05701291158105,-53.94596265893779,11.26080760851796,-0.021212958320933284,3377400.0
1990,BSESN,2011-08-03,17940.550781,18005.759766,17859.5,17970.189453,13400.0,-169.3398439999983,169.3398439999983,0.0,29.549904504226504,17859.5,18944.599609,7.469432329322835,-92.53056767067717,-86.5550048883888,-8.302354890863397,-0.026884008393575298,3364000.0
1991,BSESN,2011-08-04,17693.179688,18032.550781,17664.730469,17983.859375,11000.0,-247.3710930000016,247.3710930000016,0.0,23.741166854095553,17664.730469,18944.599609,2.222822483242455,-97.77717751675755,-130.850324539515,-32.81194882059372,-0.054967661562428605,3353000.0
1992,BSESN,2011-08-05,17305.869141,17358.179688,16990.910156,17350.369141,20400.0,-387.3105470000009,387.3105470000009,0.0,17.519511443255183,16990.910156,18944.599609,16.121240994384262,-83.87875900561575,-194.96003086971905,-65.24156523041879,-0.08295246375454246,3332600.0
1993,BSESN,2011-08-08,16990.179688,17247.869141,16759.449219,16907.570313,20000.0,-315.68945299999905,315.68945299999905,0.0,14.055375018572178,16759.449219,18944.599609,10.559020104790209,-89.4409798952098,-268.14987075954195,-105.82322633624344,-0.08251554182807919,3312600.0
1994,BSESN,2011-08-09,16857.910156,17135.039063,16432.0,16517.869141,23800.0,-132.26953199999843,132.26953199999843,0.0,12.829025369832308,16432.0,18944.599609,16.950975972232655,-83.04902402776735,-332.98791458479536,-151.25616398595386,-0.08541224451708274,3288800.0
1995,BSESN,2011-08-10,17130.509766,17256.460938,17022.25,17244.710938,15600.0,272.5996099999975,0.0,272.5996099999975,27.807776681852957,16432.0,18944.599609,27.80028156885696,-72.19971843114304,-358.2463798657227,-192.65420716190766,-0.05925525729347714,3304400.0
1996,BSESN,2011-08-11,17059.400391,17207.820313,17012.949219,17056.609375,9400.0,-71.109375,71.109375,0.0,26.440300910929764,16432.0,18944.599609,24.970169889093498,-75.0298301109065,-379.62573864860315,-230.0485134592468,-0.06252604119495508,3295000.0
1997,BSESN,2011-08-12,16839.630859,17246.880859,16784.560547,17246.880859,13400.0,-219.76953199999843,219.76953199999843,0.0,22.49540368869411,16432.0,18944.599609,16.223470605499113,-83.77652939450088,-409.5812019155492,-265.9550511505073,-0.08052160317736512,3281600.0
1998,BSESN,2011-08-16,16730.939453,17035.490234,16673.519531,17015.990234,12600.0,-108.69140600000172,108.69140600000172,0.0,20.730373805169464,16432.0,18578.550781,13.926502724558596,-86.0734972754414,-437.05352943334947,-300.17474680707573,-0.07614353949197306,3269000.0
1999,BSESN,2011-08-17,16840.800781,17000.380859,16708.980469,16782.240234,15000.0,109.86132800000269,0.0,109.86132800000269,27.376001012555307,16432.0,18440.070313,20.357891770695264,-79.64210822930472,-444.8328991360904,-329.1063772728787,-0.061299678779354605,3284000.0
2000,BSESN,2011-08-18,16469.789063,16916.810547,16433.310547,16910.269531,14600.0,-371.0117180000016,371.0117180000016,0.0,20.63500076134349,16432.0,18440.070313,1.8818595521958779,-98.11814044780412,-475.45490248568603,-358.3760823154402,-0.06914475784303131,3269400.0
2001,BSESN,2011-08-19,16141.669922,16287.719727000003,15987.769531,16237.780272999997,16400.0,-328.1191410000011,328.1191410000011,0.0,16.49120324828388,15987.769531,18440.070313,6.275755083945457,-93.72424491605454,-520.2029573551954,-390.7414573233913,-0.06727193008999766,3253000.0
2002,BSESN,2011-08-22,16341.700195,16370.459961000002,16046.480469,16155.990234,11600.0,200.0302730000003,0.0,200.0302730000003,26.827271203722603,15987.769531,18283.550781,15.416567410331417,-84.58343258966859,-533.3769049782568,-419.26854685436444,-0.038167900805546884,3264600.0
2003,BSESN,2011-08-23,16498.470703,16549.210938,16213.179688,16446.849609,11400.0,156.7705079999996,0.0,156.7705079999996,34.19293964435897,15987.769531,18032.550781,24.97583406537979,-75.02416593462021,-525.1140951561138,-440.4376565147144,-0.02132170889949092,3276000.0
2004,BSESN,2011-08-24,16284.980469,16533.220703,16253.780272999997,16490.779297,13600.0,-213.49023399999896,213.49023399999896,0.0,29.523244288731547,15987.769531,18032.550781,14.535096993871587,-85.46490300612841,-529.6867375216025,-458.28747271609205,-0.04935809316534023,3262400.0
2005,BSESN,2011-08-25,16146.330078,16373.839844,16104.339844,16338.139647999997,12200.0,-138.65039099999922,138.65039099999922,0.0,26.78235288255182,15987.769531,17358.179688,11.570298584703274,-88.42970141529672,-538.2934060356274,-474.28865937999916,-0.05352300151661282,3250200.0
2006,BSESN,2011-08-26,15848.830078,16256.379883,15765.530272999997,16155.549805,14200.0,-297.5,297.5,0.0,21.77695429343477,15765.530272999997,17256.460938,5.587101194944166,-94.41289880505583,-562.634318335382,-491.95779117107577,-0.05883744063608509,3236000.0
2007,BSESN,2011-08-29,16416.330078,16462.029297,16068.730469,16080.740234,11200.0,567.4999999999983,0.0,567.4999999999983,44.57592330944609,15765.530272999997,17256.460938,43.65057479047832,-56.34942520952168,-530.0223912957554,-499.5707111960117,-0.018804047189566964,3247200.0
2008,BSESN,2011-08-30,16676.75,16714.699219,16443.349609,16585.099609,15200.0,260.4199220000009,0.0,260.4199220000009,51.98573272311018,15765.530272999997,17256.460938,61.11751192668648,-38.88248807331351,-477.65735620435953,-495.1880401976813,-0.009741269618549597,3262400.0
2009,BSESN,2011-09-02,16821.460938,16989.859375,16688.060547,16963.669922,12800.0,144.71093800000014,0.0,144.71093800000014,55.776577338337596,15765.530272999997,17246.880859,71.28161793564786,-28.71838206435215,-419.64333814466954,-480.07909978707903,0.02135254274689191,3275200.0
2010,BSESN,2011-09-05,16713.330078,16760.070313,16561.460938,16678.339844,12200.0,-108.13086000000112,108.13086000000112,0.0,52.22178990607803,15765.530272999997,17246.880859,63.98213994428459,-36.01786005571542,-378.03432321876244,-459.6701444734157,0.035415180632634824,3263000.0
2011,BSESN,2011-09-06,16862.810547,16894.730469,16488.300781,16663.730469,14600.0,149.4804690000019,0.0,149.4804690000019,56.63065988140602,15765.530272999997,17035.490234,86.40274557443317,-13.59725442556683,-329.20221629710795,-433.5765588381542,0.03188838038770547,3277600.0
2012,BSESN,2011-09-07,17065.0,17157.210938,16922.310547,16922.310547,17400.0,202.18945299999905,0.0,202.18945299999905,62.09036262143153,15765.530272999997,17157.210938,93.37413098284297,-6.625869017157031,-271.06277768559085,-401.07380260764154,0.034338291542196364,3295000.0
2013,BSESN,2011-09-08,17165.539063,17209.660156,16987.369141,17118.080078,12200.0,100.53906300000016,0.0,100.53906300000016,64.64407855677376,15765.530272999997,17209.660156,96.94479745074277,-3.0552025492572272,-214.4026908112064,-363.73958024835457,0.054071823768915506,3307200.0
2014,BSESN,2011-09-09,16866.970703,17211.800781,16830.949219,17189.75,11800.0,-298.5683600000011,298.5683600000011,0.0,52.52100273661559,15765.530272999997,17211.800781,76.15729034834185,-23.842709651658158,-191.3849683790104,-329.26865787448577,0.04463185265745917,3295400.0
2015,BSESN,2011-09-12,16501.740234,16668.25,16393.039063,16668.25,13400.0,-365.2304689999983,365.2304689999983,0.0,41.528402744386504,15765.530272999997,17211.800781,50.90402915137101,-49.095970848628994,-200.30530909020672,-303.47598811763,0.04119611055117023,3282000.0
2016,BSESN,2011-09-13,16467.439453,16766.189453,16374.679688,16618.169922,14600.0,-34.300781000001734,34.300781000001734,0.0,40.60740707251316,15765.530272999997,17211.800781,48.53235795913775,-51.46764204086225,-207.74774307088592,-284.3303391082812,0.0031133252534008005,3267400.0
2017,BSESN,2011-09-14,16709.599609,16754.220703,16387.380859,16522.710938,16000.0,242.1601560000017,0.0,242.1601560000017,49.69537637438253,15765.530272999997,17211.800781,65.27612440258658,-34.723875597413425,-191.89359493528173,-265.84299027368127,0.0019697848201838397,3283400.0
2018,BSESN,2011-09-15,16876.539063,16922.400391,16545.470703,16837.759766,15400.0,166.93945399999942,0.0,166.93945399999942,55.153768454984004,15765.530272999997,17211.800781,76.81887889260615,-23.18112110739386,-163.96832476709824,-245.46805717236467,0.0032742771393641235,3298800.0
2019,BSESN,2011-09-16,16933.830078,17122.539063,16889.580078,17047.730469,20400.0,57.291014999998886,0.0,57.291014999998886,57.00128255043251,15765.530272999997,17211.800781,80.78017207276125,-19.219827927238747,-135.65074352687225,-223.5045944432662,0.013193062003259648,3319200.0
2020,BSESN,2011-09-19,16745.349609,16865.929688,16709.410156,16865.929688,11600.0,-188.4804689999983,188.4804689999983,0.0,49.292736389530674,16068.730469,17211.800781,59.193133869091305,-40.80686613090869,-126.95420596798431,-204.19451674820982,-0.00696567975264939,3307600.0
2021,BSESN,2011-09-20,17099.279297,17135.439453,16758.689453,16768.630859,14200.0,353.92968800000017,0.0,353.92968800000017,60.78362966832535,16374.679688,17211.800781,86.55851764566627,-13.44148235433372,-90.46020050768493,-181.44765350010485,0.002008748725461418,3321800.0
2022,BSESN,2011-09-21,17065.150391,17191.119141,17000.609375,17128.830078,13400.0,-34.128906000001734,34.128906000001734,0.0,59.2887400749596,16374.679688,17211.800781,82.48157987819306,-17.518420121806948,-63.559679323599994,-157.87005866480388,-0.005848267953109998,3308400.0
2023,BSESN,2011-09-22,16361.150391,16833.609375,16316.030272999997,16827.849609,18400.0,-704.0,704.0,0.0,37.39772593078506,16316.030272999997,17211.800781,5.03701758397278,-94.96298241602722,-97.91898974263677,-145.87984488037046,-0.029988805986959632,3290000.0
2024,BSESN,2011-09-23,16162.05957,16368.410156,16052.469727000003,16222.370117,22000.0,-199.09082099999972,199.09082099999972,0.0,33.37647964118479,16052.469727000003,17211.800781,9.45285150620974,-90.54714849379026,-139.60468032459175,-144.62481196921473,-0.020584535884289767,3268000.0
2025,BSESN,2011-09-26,16051.099609,16209.19043,15801.009766,16209.19043,18800.0,-110.95996099999867,110.95996099999867,0.0,31.217834674514265,15801.009766,17211.800781,17.726923430966217,-82.27307656903379,-179.52497974549988,-151.60484552447176,-0.025282609672759415,3249200.0
2026,BSESN,2011-09-27,16524.029297,16551.650391,16282.740234,16289.320313,16200.0,472.92968800000017,0.0,472.92968800000017,47.81588865783181,15801.009766,17211.800781,51.2492299222646,-48.7507700777354,-171.0291140981135,-155.48969923920012,-0.011105610926790188,3265400.0
2027,BSESN,2011-09-28,16446.019531,16663.259766,16363.629883,16663.259766,19600.0,-78.00976599999922,78.00976599999922,0.0,45.716214536576764,15801.009766,17211.800781,45.7197244766973,-54.28027552330269,-168.64676064676314,-158.12111152071273,-0.025509941961018856,3245800.0
2028,BSESN,2011-09-29,16698.070313,16756.080078,16316.660156,16387.910156,19200.0,252.05078199999843,0.0,252.05078199999843,53.35269435949097,15801.009766,17191.119141,64.53165219463403,-35.468347805365966,-144.75172891540205,-155.44723499965062,-0.013922412349365199,3265000.0
2029,BSESN,2011-09-30,16453.759766,16745.160156,16404.779297,16599.740234,20000.0,-244.31054700000092,244.31054700000092,0.0,46.09961462658614,15801.009766,17191.119141,46.9567367675655,-53.0432632324345,-143.8701183006233,-153.13181165984517,-0.01741318334991837,3245000.0
2030,BSESN,2011-10-03,16151.450195,16255.969727000003,16056.330078,16255.969727000003,17000.0,-302.30957099999983,302.30957099999983,0.0,38.6061859077528,15801.009766,17191.119141,25.209557988917254,-74.79044201108275,-165.65571543946498,-155.63659241576914,-0.05543093866922766,3228000.0
2031,BSESN,2011-10-04,15864.860352000003,16202.379883,15745.429688,16081.769531,19600.0,-286.58984299999787,286.58984299999787,0.0,32.77812368827372,15745.429688,17191.119141,8.261156208352254,-91.73884379164775,-203.69825662301082,-165.24892525721748,-0.07033574340094995,3208400.0
2032,BSESN,2011-10-05,15792.410156,16044.910156,15760.530272999997,15967.719727000003,18800.0,-72.4501960000016,72.4501960000016,0.0,31.395629988336765,15745.429688,17191.119141,3.2496929338807163,-96.75030706611928,-236.96182154319104,-179.5915045144122,-0.03476162870019539,3189600.0
2033,BSESN,2011-10-07,16232.540038999998,16347.480469,16148.969727000003,16222.490234,16800.0,440.1298829999978,0.0,440.1298829999978,47.04996214456813,15745.429688,17191.119141,33.693982479375386,-66.30601752062462,-225.21252337474652,-188.7157082864791,0.004360859375300397,3206400.0
2034,BSESN,2011-10-10,16557.230469,16595.929688,16230.769531,16270.070313,17200.0,324.69043000000056,0.0,324.69043000000056,55.66182517889247,15745.429688,17191.119141,56.15319246574033,-43.84680753425967,-187.53947742084165,-188.48046211335162,0.03153247268593384,3223600.0
2035,BSESN,2011-10-11,16536.470703,16774.119141,16510.710938,16668.150391,20000.0,-20.759765999999214,20.759765999999214,0.0,55.00187792012504,15745.429688,17191.119141,54.71721560660783,-45.28278439339217,-157.5424059136967,-182.29285087342066,0.0007529281010325573,3203600.0
2036,BSESN,2011-10-12,16958.390625,16987.060547,16608.570313,16660.429688,21200.0,421.9199220000009,0.0,421.9199220000009,64.79130365833754,15745.429688,16987.060547,97.69094640390209,-2.3090535960979155,-98.58764208429784,-165.55180911559611,0.031154717591949987,3224800.0
2037,BSESN,2011-10-13,16883.919922,17084.070313,16854.029297,17048.0,18000.0,-74.47070299999905,74.47070299999905,0.0,62.04242894199941,15745.429688,17084.070313,85.04823570553157,-14.951764294468445,-57.21518927112993,-143.88448514670287,0.011130005175227442,3206800.0
2038,BSESN,2011-10-14,17082.689453,17112.449219,16828.449219,16836.830078,15400.0,198.7695309999981,0.0,198.7695309999981,66.42890712811311,15745.429688,17112.449219,97.82301822869864,-2.176981771301354,-8.292590556869982,-116.76610622873629,0.03822407133350869,3222200.0
2039,BSESN,2011-10-17,17025.089844,17188.550781,16928.380859,17176.050781,18400.0,-57.59960900000078,57.59960900000078,0.0,63.95759657009088,15745.429688,17188.550781,88.67309626386263,-11.326903736137359,25.53674265295922,-88.30553645239719,0.05409047722974436,3203800.0
2040,BSESN,2011-10-18,16748.289063,16824.759766,16669.039063,16817.380859,14000.0,-276.8007809999981,276.8007809999981,0.0,53.02033983576717,15745.429688,17188.550781,69.4923925555843,-30.50760744441569,29.669215000794793,-64.7105861617588,0.055684619429292814,3189800.0
2041,BSESN,2011-10-19,17085.339844,17106.990234,16874.339844,16883.359375,11400.0,337.05078099999815,0.0,337.05078099999815,62.121300961035324,15745.429688,17188.550781,92.84807508526913,-7.151924914730863,59.45603808812302,-39.877261311782426,0.08187032094710234,3201200.0
2042,BSESN,2011-10-20,16936.890625,16962.060547,16744.990234,16911.849609,12000.0,-148.4492189999983,148.4492189999983,0.0,56.55369069840633,15745.429688,17188.550781,82.56139715366204,-17.438602846337957,70.27362801594063,-17.84708344623781,0.043391273596599333,3189200.0
2043,BSESN,2011-10-21,16785.640625,17032.320313,16752.210938,16975.789063,13800.0,-151.25,151.25,0.0,51.162941098625424,15745.429688,17188.550781,72.08064119121005,-27.91935880878995,65.88258162871716,-1.101150431246811,0.013795190954649872,3175400.0
2044,BSESN,2011-10-24,16939.279297,17104.880859,16898.599609,17011.060547,12600.0,153.63867200000098,0.0,153.63867200000098,56.070825422591206,15745.429688,17188.550781,82.72691839866272,-17.273081601337285,73.94758086802904,13.908595828608362,0.024358800691790083,3188000.0
2045,BSESN,2011-10-25,17254.859375,17322.130859,16900.259766,17012.789063,17600.0,315.58007799999905,0.0,315.58007799999905,64.52111702266308,15760.530272999997,17322.130859,95.69214531531941,-4.307854684680594,104.59808414819781,32.04649349252626,0.017482127670944703,3205600.0
2046,BSESN,2011-10-28,17804.800781,17908.130859,17671.859375,17671.859375,23800.0,549.9414060000017,0.0,549.9414060000017,74.41651234595278,16148.969727000003,17908.130859,94.1261732015121,-5.873826798487905,171.2899799700026,59.895190788021544,0.05454188738481758,3229400.0
2047,BSESN,2011-10-31,17705.009766,17813.109375,17668.269531,17806.210938,15800.0,-99.79101500000252,99.79101500000252,0.0,70.31062439971257,16230.769531,17908.130859,87.89043901219586,-12.10956098780414,213.62890592759868,90.64193381593698,0.03642987918923457,3213600.0
2048,BSESN,2011-11-01,17480.830078,17661.779297,17422.470703,17540.550781,17600.0,-224.17968800000014,224.17968800000014,0.0,61.51314178951141,16510.710938,17908.130859,69.4221633326779,-30.5778366673221,226.48263171286453,117.81007339532252,0.02676874179084665,3196000.0
2049,BSESN,2011-11-02,17464.849609,17615.919922,17337.650391,17347.699219,15400.0,-15.980468999998267,15.980468999998267,0.0,60.8865281553417,16608.570313,17908.130859,65.8899116809599,-34.1100883190401,232.6974206931991,140.78754285489785,0.04278410429295798,3180600.0
2050,BSESN,2011-11-03,17481.929688,17527.099609,17278.029297,17430.689453,17000.0,17.080078999999387,0.0,17.080078999999387,61.371799524170605,16669.039063,17908.130859,65.60374522889664,-34.396254771103365,236.27724832516105,159.8854839489505,0.023212288875791742,3197600.0
2051,BSESN,2011-11-04,17562.609375,17702.259766,17474.390625,17674.699219,18400.0,80.67968699999983,0.0,80.67968699999983,63.81842770260445,16669.039063,17908.130859,72.11494054634184,-27.885059453658158,242.8253247966386,176.47345211848815,0.03694413359890247,3216000.0
2052,BSESN,2011-11-08,17569.529297,17632.230469,17455.220703,17593.669922,11000.0,6.919922000000953,0.0,6.919922000000953,64.04381116713995,16669.039063,17908.130859,72.67340780618004,-27.32659219381997,245.7403605415675,190.32683380310405,0.04669995560565621,3227000.0
2053,BSESN,2011-11-09,17362.099609,17658.339844,17331.230469,17641.980469,15000.0,-207.42968800000014,207.42968800000014,0.0,52.69131693750626,16669.039063,17908.130859,55.93294606883188,-44.067053931168125,228.6766628882615,197.99679962013556,0.02496093869087357,3212000.0
2054,BSESN,2011-11-11,17192.820313,17279.230469,17096.839844,17187.890625,18200.0,-169.27929600000058,169.27929600000058,0.0,45.15438058982012,16744.990234,17908.130859,38.50180015851474,-61.49819984148526,199.1979056397904,198.23702082406655,-0.003595454512361096,3193800.0
2055,BSESN,2011-11-14,17118.740234,17391.990234,17094.429688,17348.519531,15000.0,-74.08007899999939,74.08007899999939,0.0,42.11269494569859,16744.990234,17908.130859,32.13283002646391,-67.8671699735361,167.92242963441095,192.17410258613546,-0.03853233492688757,3178800.0
2056,BSESN,2011-11-15,16882.669922,17172.089844,16837.560547,17081.619141,18000.0,-236.07031199999986,236.07031199999986,0.0,33.75262614040581,16752.210938,17908.130859,11.286161059248732,-88.71383894075126,122.67338588507482,178.27395924592335,-0.046446732019272186,3160800.0
2057,BSESN,2011-11-16,16775.869141,16878.300781,16641.650391,16872.300781,19600.0,-106.80078100000172,106.80078100000172,0.0,30.583331799816136,16641.650391,17908.130859,10.597774967027746,-89.40222503297225,77.30414815685072,158.07999702810883,-0.040327658003335265,3141200.0
2058,BSESN,2011-11-17,16461.710938,16807.150391,16408.5,16754.679688,17000.0,-314.15820299999905,314.15820299999905,0.0,23.19209818348537,16408.5,17908.130859,3.548269074396271,-96.45173092560373,15.816436897905078,129.62728500206808,-0.05743757853391773,3124200.0
2059,BSESN,2011-11-18,16371.509766,16396.689453,16164.990234,16387.699219,21600.0,-90.20117200000095,90.20117200000095,0.0,21.47286857471967,16164.990234,17908.130859,11.84755429585599,-88.15244570414401,-39.733475238281244,95.7551329539982,-0.06351815513605563,3102600.0
2060,BSESN,2011-11-21,15946.099609,16297.030272999997,15900.299805,16297.030272999997,21400.0,-425.4101569999984,425.4101569999984,0.0,15.300589179087936,15900.299805,17813.109375,2.394373424219131,-97.60562657578087,-116.73853601462906,53.25639916027274,-0.09204268747792488,3081200.0
2061,BSESN,2011-11-22,16065.419922,16212.950195,15970.110352000003,15995.69043,19400.0,119.32031299999836,0.0,119.32031299999836,22.509329256671236,15900.299805,17702.259766,9.163362148644252,-90.83663785135575,-166.22135312413593,9.360848703391,-0.0856089738987389,3100600.0
2062,BSESN,2011-11-23,15699.969727000003,15969.599609,15478.69043,15969.599609,17400.0,-365.4501949999976,365.4501949999976,0.0,17.304562041257697,15478.69043,17702.259766,9.95153573209749,-90.0484642679025,-232.24840370139646,-38.96100177756651,-0.09573323039446213,3083200.0
2063,BSESN,2011-11-24,15858.490234,15901.299805,15479.969727000003,15715.80957,18600.0,158.52050699999927,0.0,158.52050699999927,25.882177448609824,15478.69043,17702.259766,17.08063687742816,-82.91936312257184,-268.6867828978102,-84.90615800161527,-0.07760972631064333,3101800.0
2064,BSESN,2011-11-25,15695.429688,15891.049805,15645.780272999997,15781.25,19200.0,-163.06054600000058,163.06054600000058,0.0,23.045078071432513,15478.69043,17702.259766,9.747357750035087,-90.25264224996491,-307.18109183063643,-129.36114476741952,-0.08314341631127298,3082600.0
2065,BSESN,2011-11-28,16167.129883,16186.679688,15888.280272999997,15890.799805,20200.0,471.7001950000012,0.0,471.7001950000012,43.659094955569245,15478.69043,17658.339844,31.584870877771344,-68.41512912222866,-296.2113058739542,-162.73117698872647,-0.042383108969486716,3102800.0
2066,BSESN,2011-11-29,16008.339844,16210.370117,15952.540038999998,16210.370117,14800.0,-158.79003900000134,158.79003900000134,0.0,39.54458297003285,15478.69043,17658.339844,24.29975254726906,-75.70024745273093,-296.90812846773224,-189.56656728452765,-0.045751984028306936,3088000.0
2067,BSESN,2011-11-30,16123.459961000002,16179.55957,15849.570313,15868.959961000002,16800.0,115.12011700000221,0.0,115.12011700000221,43.96231776716776,15478.69043,17391.990234,33.69934652436737,-66.30065347563263,-284.8871325230557,-208.63068033223328,-0.020547741256905616,3104800.0
2068,BSESN,2011-12-01,16483.449219,16718.109375,16430.609375,16555.929688,19800.0,359.989257999996,0.0,359.989257999996,55.6545985610779,15478.69043,17391.990234,52.514445822835484,-47.485554177164516,-243.505304492066,-215.60560516419986,0.006837454492588879,3124600.0
2069,BSESN,2011-12-02,16846.830078,16888.839844,16428.660156,16493.980469,28600.0,363.38085900000084,0.0,363.38085900000084,64.32442600762947,15478.69043,17172.089844,80.79249565631422,-19.207504343685784,-179.32100825704765,-208.34868578276945,0.05648594271238738,3153200.0
2070,BSESN,2011-12-05,16805.330078,16863.099609,16691.210938,16812.300781,13400.0,-41.5,41.5,0.0,62.70885993356306,15478.69043,16888.839844,94.077949104477,-5.922050895523001,-130.30116353437552,-192.7391813330907,0.04605607320520555,3139800.0
2071,BSESN,2011-12-07,16877.060547,17003.710938,16781.619141,16830.039063,14000.0,71.7304690000019,0.0,71.7304690000019,64.4876773128435,15478.69043,17003.710938,91.69516801016034,-8.304831989839657,-84.68830004471238,-171.12900507541505,0.07497408214588441,3153800.0
2072,BSESN,2011-12-08,16488.240234,16847.820313,16421.550781,16819.740234,16000.0,-388.82031300000017,388.82031300000017,0.0,49.66913507653909,15478.69043,17003.710938,66.19909691076761,-33.80090308923239,-79.00362227879668,-152.7039285160914,0.03971058976659969,3137800.0
2073,BSESN,2011-12-09,16213.459961000002,16382.570313,16142.320313,16258.44043,18400.0,-274.7802729999985,274.7802729999985,0.0,41.83101880938704,15478.69043,17003.710938,48.18096065892393,-51.81903934107607,-95.56928259007327,-141.27699933088778,0.033005166682124276,3119400.0
2074,BSESN,2011-12-12,15870.349609,16360.320313,15839.959961000002,16354.959961000002,21200.0,-343.1103520000015,343.1103520000015,0.0,34.08200525637332,15478.69043,17003.710938,25.682223743577374,-74.31777625642262,-134.82959401810876,-139.98751826833197,-0.018357016746186283,3098200.0
2075,BSESN,2011-12-13,16002.509766,16079.379883,15771.589844,15778.620117,23600.0,132.16015699999843,0.0,132.16015699999843,39.096261902883604,15478.69043,17003.710938,34.34834700596687,-65.65165299403313,-153.50988709684862,-142.6919920340353,-0.0003641900444901758,3121800.0
2076,BSESN,2011-12-14,15881.139647999997,16133.410156,15855.120117,15963.75,19000.0,-121.37011800000073,121.37011800000073,0.0,36.17997673109195,15479.969727000003,17003.710938,26.327956355312764,-73.67204364468724,-176.07799066455846,-149.36919176013996,-0.015029051679114724,3102800.0
2077,BSESN,2011-12-15,15836.469727000003,15908.019531,15596.219727000003,15739.049805,19800.0,-44.669920999996975,44.669920999996975,0.0,35.06908804502204,15596.219727000003,17003.710938,17.06937834654802,-82.93062165345198,-195.3163790020535,-158.5586292085227,-0.03925024935037502,3083000.0
2078,BSESN,2011-12-16,15491.349609,16068.900391,15425.200195,15868.780272999997,20400.0,-345.1201180000008,345.1201180000008,0.0,27.53282520684877,15425.200195,17003.710938,4.190621716915443,-95.80937828308456,-235.69431228069698,-173.98576582295757,-0.08045908118762934,3062600.0
2079,BSESN,2011-12-19,15379.339844,15440.099609,15190.740234,15440.099609,18000.0,-112.00976500000071,112.00976500000071,0.0,25.48213134812501,15190.740234,17003.710938,10.402794131415781,-89.59720586858421,-273.5787220314214,-193.90435706465036,-0.08485344991032195,3044600.0
2080,BSESN,2011-12-20,15175.080078,15448.129883,15135.860352000003,15436.120117,20800.0,-204.2597659999992,204.2597659999992,0.0,22.029642026561035,15135.860352000003,17003.710938,2.099725015156946,-97.90027498484305,-316.43675975599035,-218.41083760291838,-0.10084578794158183,3023800.0
2081,BSESN,2011-12-21,15685.209961000002,15727.30957,15377.040038999998,15487.75,22000.0,510.12988300000137,0.0,510.12988300000137,43.923537656335746,15135.860352000003,17003.710938,29.410789766457256,-70.58921023354274,-305.7147557993867,-235.87162124221203,-0.048703212811279206,3045800.0
2082,BSESN,2011-12-22,15813.360352000003,15834.629883,15472.700195,15546.660156,18800.0,128.15039099999922,0.0,128.15039099999922,48.144175931055464,15135.860352000003,17003.710938,36.271637842878356,-63.728362157121644,-283.60757329436274,-245.4188116526422,-0.024677003549051335,3064600.0
2083,BSESN,2011-12-23,15738.700195,15911.230469,15671.280272999997,15863.429688,17000.0,-74.66015700000206,74.66015700000206,0.0,45.82559373955182,15135.860352000003,17003.710938,32.274521715946136,-67.72547828405386,-269.0109320235406,-250.13723572682193,-0.008295306483062204,3047600.0
2084,BSESN,2011-12-26,15970.75,15998.44043,15761.179688,15782.169922,11800.0,232.04980500000056,0.0,232.04980500000056,53.80411247781497,15135.860352000003,17003.710938,44.69788184652999,-55.302118153470005,-235.9980698652198,-247.3094025545015,-0.0019846740582829536,3059400.0
2085,BSESN,2011-12-27,15873.950195,16049.120117,15799.629883,15983.980469,10800.0,-96.79980500000055,96.79980500000055,0.0,50.242546962649236,15135.860352000003,16847.820313,43.11373278665116,-56.88626721334884,-215.16577689371297,-240.88067742234378,-0.00045270384615647696,3048600.0
2086,BSESN,2011-12-28,15727.849609,15887.799805,15666.459961000002,15854.360352000003,11800.0,-146.10058599999866,146.10058599999866,0.0,45.049300866581596,15135.860352000003,16382.570313,47.48412024599192,-52.515879754008076,-208.04689579189107,-234.31392109625327,-0.0068588593210779925,3036800.0
2087,BSESN,2011-12-29,15543.929688,15724.599609,15515.44043,15658.94043,12800.0,-183.9199210000006,183.9199210000006,0.0,39.16858896927765,15135.860352000003,16360.320313,33.32647444565955,-66.67352555434046,-214.7701946575071,-230.40517580850405,0.003394157405721021,3024000.0
2088,BSESN,2011-12-30,15454.919922,15694.049805,15406.929688,15583.549805,12800.0,-89.00976600000105,89.00976600000105,0.0,36.50737811463343,15135.860352000003,16133.410156,31.984324864846236,-68.01567513515377,-224.69070707179344,-229.26228206116193,0.004914390264253443,3011200.0
2089,BSESN,2012-01-02,15517.919922,15542.849609,15358.019531,15534.669922,14200.0,63.0,0.0,63.0,39.84519479964621,15135.860352000003,16133.410156,38.29979901434547,-61.70020098565454,-224.8769694240491,-228.38521953373936,0.02259229224740822,3025400.0
2090,BSESN,2012-01-03,15939.360352000003,15970.30957,15640.55957,15640.55957,16200.0,421.4404300000024,0.0,421.4404300000024,57.20872425175388,15135.860352000003,16068.900391,86.11634725356127,-13.883652746438727,-188.84102135901776,-220.47637989879502,0.01620318705531676,3041600.0
2091,BSESN,2012-01-04,15882.639647999997,16004.69043,15822.320313,15967.490234,17800.0,-56.72070400000303,56.72070400000303,0.0,54.75435623276726,15135.860352000003,16068.900391,80.03721863858799,-19.962781361412013,-162.98042280824848,-208.9771884806857,0.004381060979947282,3023800.0
2092,BSESN,2012-01-05,15857.080078,15980.169922,15809.30957,15893.070313,21200.0,-25.55956999999762,25.55956999999762,0.0,53.559612707618875,15135.860352000003,16049.120117,78.97202456959218,-21.027975430407814,-142.9008833988628,-195.76192746432113,0.007521579389231148,3002600.0
2093,BSESN,2012-01-06,15867.730469,16001.30957,15664.910156,15789.080078,17200.0,10.650390999999217,0.0,10.650390999999217,54.04175953907408,15135.860352000003,16049.120117,80.138219710139,-19.861780289861,-124.69094659209259,-181.54773128987543,-0.006450513031635907,3019800.0
2094,BSESN,2012-01-09,15814.719727000003,15871.509766,15678.299805,15840.219727000003,11200.0,-53.01074199999857,53.01074199999857,0.0,51.0008259775955,15358.019531,16049.120117,66.0830283249106,-33.91697167508941,-113.23169977661928,-167.8845249872242,-0.0037312998511644935,3008600.0
2095,BSESN,2012-01-10,16165.089844,16180.969727000003,15898.320313,15898.320313,19600.0,350.37011699999863,0.0,350.37011699999863,65.71397586579522,15358.019531,16180.969727000003,98.07037132050174,-1.9296286794982644,-75.01351473570685,-149.31032293692076,0.027800382497922493,3028200.0
2096,BSESN,2012-01-11,16175.860352000003,16244.700195,16127.769531,16222.370117,18600.0,10.770508000001428,0.0,10.770508000001428,66.07529422228757,15358.019531,16244.700195,92.23623049481587,-7.763769505184129,-43.35645157561157,-128.1195486646589,0.04065449835943724,3046800.0
2097,BSESN,2012-01-12,16037.509766,16178.580078,15962.589844,16117.19043,14400.0,-138.3505860000023,138.3505860000023,0.0,57.14894561122411,15358.019531,16244.700195,76.63302726538306,-23.36697273461693,-29.096332580369562,-108.31490544780104,0.03769607652063511,3032400.0
2098,BSESN,2012-01-13,16154.620117,16257.339844,16049.780272999997,16144.570313,19600.0,117.11035099999935,0.0,117.11035099999935,62.14391288298412,15358.019531,16257.339844,88.5780710704352,-11.421928929564796,-8.25015627834,-88.30195561390883,0.04102999617218939,3052000.0
2099,BSESN,2012-01-16,16189.360352000003,16214.360352000003,16037.599609,16086.740234,13400.0,34.74023500000294,0.0,34.74023500000294,63.59636319176079,15358.019531,16257.339844,92.44101450647464,-7.558985493525347,10.947637705054149,-68.45203695011624,0.015684443696552197,3065400.0
2100,BSESN,2012-01-17,16466.050781,16501.380859,16270.870117,16270.870117,18800.0,276.69042900000017,0.0,276.69042900000017,73.0860566913011,15358.019531,16501.380859,96.90998137379727,-3.090018626202742,47.93605595751433,-45.17441836859012,0.03673263046507946,3084200.0
2101,BSESN,2012-01-18,16451.470703,16517.960938,16384.480469,16502.419922,16200.0,-14.580078000002684,14.580078000002684,0.0,71.94573836433494,15358.019531,16517.960938,94.2677936489941,-5.7322063510058925,75.20622294211717,-21.09829010644866,0.03748424187027033,3068000.0
2102,BSESN,2012-01-19,16643.740234,16662.060547,16572.099609,16573.869141,16800.0,192.2695310000017,0.0,192.2695310000017,77.3281515130645,15358.019531,16662.060547,98.59511221079566,-1.4048877892043354,111.05242777686726,5.331853470214534,0.04890489957061295,3084800.0
2103,BSESN,2012-01-20,16739.009766,16788.480469,16611.710938,16745.009766,18000.0,95.26953199999843,0.0,95.26953199999843,79.56921757245398,15640.55957,16788.480469,95.69040836846031,-4.309591631539683,145.47135516845992,33.35975380986362,0.05844492061544293,3102800.0
2104,BSESN,2012-01-23,16751.730469,16784.0,16659.320313,16667.019531,15000.0,12.720702999999046,0.0,12.720702999999046,79.8756916028453,15664.910156,16788.480469,96.7291766634635,-3.270823336536487,171.79471498616476,61.04674604512386,0.0362905885869691,3117800.0
2105,BSESN,2012-01-24,16995.769531,17050.320313,16770.009766,16806.720703,18200.0,244.03906200000347,0.0,244.03906200000347,84.89223906585859,15664.910156,17050.320313,96.06248144461969,-3.937518555380306,209.92815893466468,90.82302862303204,0.050687206810525076,3136000.0
2106,BSESN,2012-01-25,17077.179688,17130.240234,17016.689453,17068.849609,14000.0,81.41015699999843,0.0,81.41015699999843,86.21493475868445,15664.910156,17130.240234,96.37893558614303,-3.6210644138569696,243.90670265574772,121.43976342957521,0.06482739135748705,3150000.0
2107,BSESN,2012-01-27,17233.980469,17258.970703,17106.570313,17201.330078,17200.0,156.8007809999981,0.0,156.8007809999981,88.46023462402482,15678.299805,17258.970703,98.41901093822753,-1.580989061772478,280.2568296662139,153.20317667690298,0.06681434439081335,3167200.0
2108,BSESN,2012-01-30,16863.300781,17138.039063,16828.330078,17138.039063,14400.0,-370.6796879999965,370.6796879999965,0.0,61.2483599303835,15898.320313,17258.970703,70.92052999742296,-29.07947000257705,275.97257423947303,177.757056189417,0.041628601399112064,3152800.0
2109,BSESN,2012-01-31,17193.550781,17238.990234,16965.580078,16965.580078,18600.0,330.25,0.0,330.25,70.55859833654777,15962.589844,17258.970703,94.95364949691862,-5.046350503081392,295.8157066061103,201.3687862727557,0.0441818144299333,3171400.0
2110,BSESN,2012-02-01,17300.580078,17327.210938,17061.550781,17179.640625,47400.0,107.02929699999731,0.0,107.02929699999731,72.98561907419571,15962.589844,17327.210938,98.04847952907278,-1.9515204709272302,316.5291507383008,224.40085916586474,0.051612976756245876,3218800.0
2111,BSESN,2012-02-02,17431.849609,17504.25,17308.279297,17438.070313,27000.0,131.2695310000017,0.0,131.2695310000017,75.80788545534375,16037.599609,17504.25,95.06355492459012,-4.93644507540988,339.6221062978475,247.44510859226128,0.04735169883209567,3245800.0
2112,BSESN,2012-02-03,17604.960938,17630.529297,17382.699219,17444.25,16600.0,173.1113289999994,0.0,173.1113289999994,79.12617635904556,16037.599609,17630.529297,98.39488464603211,-1.6051153539678884,367.6539911003674,271.4868850938825,0.051732520866252685,3262400.0
2113,BSESN,2012-02-06,17707.310547,17829.720703,17595.099609,17741.910156,17600.0,102.34960900000078,0.0,102.34960900000078,80.9122673278364,16270.870117,17829.720703,92.14740930918198,-7.852590690818023,393.5911461097421,295.90773729705444,0.0570436636243854,3280000.0
2114,BSESN,2012-02-07,17622.449219,17832.039063,17582.490234,17813.740234,16800.0,-84.86132800000269,84.86132800000269,0.0,74.78994329908053,16384.480469,17832.039063,85.52114955009542,-14.478850449904595,402.6573451386248,317.2576588653685,0.03687268686816103,3263200.0
2115,BSESN,2012-02-08,17707.320313,17809.210938,17579.589844,17631.689453,20800.0,84.8710940000019,0.0,84.8710940000019,76.81444145696994,16572.099609,17832.039063,90.10121084754918,-9.898789152450819,411.9421485129533,336.1945567948855,0.036899572207628406,3284000.0
2116,BSESN,2012-02-09,17830.75,17879.460938,17609.429688,17647.800781,21400.0,123.42968699999984,0.0,123.42968699999984,79.5678204460364,16611.710938,17879.460938,96.157685821337,-3.842314178662999,424.3683125297284,353.8293079418541,0.03462749259078324,3305400.0
2117,BSESN,2012-02-10,17748.689453,17890.109375,17627.140625,17817.589844,19600.0,-82.06054700000095,82.06054700000095,0.0,72.92450873880779,16659.320313,17890.109375,88.50981647739074,-11.490183522609252,422.72166449125143,367.6077792517336,0.05250387711743665,3285800.0
2118,BSESN,2012-02-13,17772.839844,17849.640625,17665.890625,17761.699219,16800.0,24.150390999999214,0.0,24.150390999999214,73.67099075766956,16770.009766,17890.109375,89.5304372881,-10.469562711899997,418.54074164069607,377.7943717295261,0.03369222974233743,3302600.0
2119,BSESN,2012-02-14,17848.570313,17890.330078,17742.580078,17767.460938,17400.0,75.7304690000019,0.0,75.7304690000019,76.05921838244218,16828.330078,17890.330078,96.06781873822986,-3.9321812617701393,416.53657178751746,385.5428117411244,0.03167467405886826,3320000.0
2120,BSESN,2012-02-15,18202.410156,18231.349609,18000.300781,18000.300781,25600.0,353.8398430000016,0.0,353.8398430000016,83.92176905102214,16828.330078,18231.349609,97.93734496487212,-2.062655035127876,438.44603790496694,396.123456973893,0.044204175935648404,3345600.0
2121,BSESN,2012-02-16,18153.990234,18182.779297,18043.320313,18163.050781,20000.0,-48.41992200000095,48.41992200000095,0.0,79.78454388976294,16828.330078,18231.349609,94.48622251574345,-5.513777484256554,446.75248011203075,406.2492616015206,0.031186055903988485,3325600.0
2122,BSESN,2012-02-17,18289.349609,18423.060547,18234.560547,18331.199219,27800.0,135.359375,0.0,135.359375,82.55811942199088,16965.580078,18423.060547,90.8258847480995,-9.174115251900504,458.9670789339507,416.7928250680066,0.03286998669024932,3353400.0
2123,BSESN,2012-02-21,18428.609375,18470.859375,18293.800781,18303.730469,20600.0,139.25976599999922,0.0,139.25976599999922,85.00100845897322,17061.550781,18470.859375,97.00207604069999,-2.997923959300006,474.4155684162615,428.3173737376577,0.04574620394597728,3374000.0
2124,BSESN,2012-02-22,18145.25,18523.779297,18095.810547,18490.869141,21600.0,-283.359375,283.359375,0.0,63.96684683192825,17308.279297,18523.779297,68.85814092965849,-31.141859070341503,458.50847392615105,434.35559377535645,0.024731561820705794,3352400.0
2125,BSESN,2012-02-23,18078.5,18249.529297,18005.279297,18127.349609,19600.0,-66.75,66.75,0.0,59.93552880366871,17382.699219,18523.779297,60.97738400792587,-39.02261599207413,435.4956964888697,434.5836143180591,0.013894536124391843,3332800.0
2126,BSESN,2012-02-24,17923.570313,18198.150391,17848.929688,18079.009766,19600.0,-154.92968699999986,154.92968699999986,0.0,51.280378404473204,17579.589844,18523.779297,36.43129754384165,-63.56870245615834,400.1437653857138,427.69564453159006,0.009853170312270176,3313200.0
2127,BSESN,2012-02-27,17445.75,17975.189453,17381.640625,17975.189453,20800.0,-477.82031300000017,477.82031300000017,0.0,33.87330602934361,17381.640625,18523.779297,5.6130990545778445,-94.38690094542216,329.7696204315507,408.1104397115822,-0.01840391557404497,3292400.0
2128,BSESN,2012-02-28,17731.119141,17776.820313,17530.439453,17545.109375,16000.0,285.3691409999992,0.0,285.3691409999992,46.4091941536978,17381.640625,18523.779297,30.598606331053197,-69.4013936689468,293.6396136049989,385.2162744902656,-0.006580424646922878,3308400.0
2129,BSESN,2012-02-29,17752.679688,18001.349609,17677.970703,17919.929688,18400.0,21.560547000000955,0.0,21.560547000000955,47.28045978885151,17381.640625,18523.779297,32.48634094056837,-67.51365905943163,263.7062374918314,360.9142670905788,-0.024707193396131588,3326800.0
2130,BSESN,2012-03-01,17583.970703,17717.529297,17463.269531,17714.619141,18800.0,-168.70898500000112,168.70898500000112,0.0,41.22864408828767,17381.640625,18523.779297,17.715018584012967,-82.28498141598703,223.7906962921479,333.4895529308926,-0.031399131741980946,3308000.0
2131,BSESN,2012-03-02,17636.800781,17731.880859,17504.380859,17661.390625,17000.0,52.830078000002686,0.0,52.830078000002686,43.826565025739015,17381.640625,18523.779297,22.340558310068456,-77.65944168993154,194.1818802491798,305.62801839455005,-0.03567917077154492,3325000.0
2132,BSESN,2012-03-05,17362.869141,17598.419922,17312.300781,17598.419922,12000.0,-273.9316400000025,273.9316400000025,0.0,34.660150114281805,17312.300781,18523.779297,4.174102910793798,-95.82589708920621,146.9190943437352,273.88623358438707,-0.05783074633106988,3313000.0
2133,BSESN,2012-03-06,17173.289063,17691.960938,17128.279297,17336.640625,18600.0,-189.58007799999905,189.58007799999905,0.0,29.699783574845753,17128.279297,18523.779297,3.2253504836975435,-96.77464951630246,93.09235734837057,237.72745833718378,-0.053565585318471776,3294400.0
2134,BSESN,2012-03-07,17145.519531,17239.349609,17008.769531,17127.179688,20400.0,-27.769531999998435,27.769531999998435,0.0,28.998359718681584,17008.769531,18523.779297,9.026344454600702,-90.9736555453993,47.64429752181968,199.71082617411096,-0.05160718361589722,3274000.0
2135,BSESN,2012-03-09,17503.240234,17531.619141,17325.820313,17325.820313,12800.0,357.7207029999991,0.0,357.7207029999991,47.44649126355833,17008.769531,18523.779297,32.63811983902415,-67.36188016097586,40.03001274008784,167.77466348730636,-0.02345124724927894,3286800.0
2136,BSESN,2012-03-12,17587.669922,17772.099609,17494.650391,17772.099609,12200.0,84.42968800000017,0.0,84.42968800000017,50.91939636188588,17008.769531,18523.779297,38.21100061476432,-61.78899938523568,40.34335433001252,142.2884016558476,0.008134928105699046,3299000.0
2137,BSESN,2012-03-13,17813.619141,17842.919922,17680.230469,17680.230469,12800.0,225.9492189999983,0.0,225.9492189999983,59.23736082012012,17008.769531,18523.779297,53.12504434377342,-46.87495565622658,58.153535674482555,125.46142845957459,0.0046528365944613626,3311800.0
2138,BSESN,2012-03-14,17919.300781,18040.689453,17837.220703,18003.150391,14200.0,105.68164000000252,0.0,105.68164000000252,62.65319821016573,17008.769531,18249.529297,73.38497547638893,-26.61502452361108,79.87510731844668,116.34416423134903,0.009385686889435085,3326000.0
2139,BSESN,2012-03-15,17675.849609,17918.25,17622.130859,17916.849609,13800.0,-243.45117200000092,243.45117200000092,0.0,51.240066905567765,17008.769531,18198.150391,56.086330328201214,-43.913669671798786,76.5625687338761,108.38784513185446,0.005225151221636581,3312200.0
2140,BSESN,2012-03-16,17466.199219,17871.0,17426.580078,17656.810547,24800.0,-209.6503900000025,209.6503900000025,0.0,43.38679169430558,17008.769531,18040.689453,44.32802180167597,-55.67197819832403,56.37051942991093,97.98437999146576,-0.009673044681878573,3287400.0
2141,BSESN,2012-03-19,17273.369141,17561.460938,17226.429688,17531.470703,13800.0,-192.83007799999905,192.83007799999905,0.0,37.31698709425281,17008.769531,18040.689453,25.64148674319306,-74.35851325680693,24.525682335006422,83.2926404601739,-0.005154678024305248,3273600.0
2142,BSESN,2012-03-20,17316.179688,17410.130859,17211.730469,17308.890625,14200.0,42.81054700000095,0.0,42.81054700000095,39.48568568459504,17008.769531,18040.689453,29.79011747386337,-70.20988252613664,2.711615057403833,67.17643537961989,0.008320515917236815,3287800.0
2143,BSESN,2012-03-21,17601.710938,17622.869141,17275.880859,17301.160156,14200.0,285.53125,0.0,285.53125,52.210063690523825,17008.769531,18040.689453,57.460021301924236,-42.539978698075764,8.367341662615218,55.41461663621895,0.026607033177103778,3302000.0
2144,BSESN,2012-03-22,17196.470703,17687.009766,17136.5,17586.060547,17600.0,-405.2402350000011,405.2402350000011,0.0,38.836999395614065,17008.769531,18040.689453,18.189509476298085,-81.81049052370192,-19.623744178457855,40.40694447328359,-0.017526442355747518,3284400.0
2145,BSESN,2012-03-23,17361.740234,17458.349609,17179.330078,17257.720703,12600.0,165.2695310000017,0.0,165.2695310000017,45.416139039349005,17008.769531,18040.689453,34.20524165440039,-65.79475834559962,-28.146555465016718,26.696244485623524,-0.012845913586164714,3297000.0
2146,BSESN,2012-03-26,17052.779297,17377.589844,17021.849609,17377.589844,17000.0,-308.96093699999983,308.96093699999983,0.0,36.862933643876914,17008.769531,18040.689453,4.264843139640377,-95.73515686035962,-59.14966976115102,9.527061636268611,-0.042711132307125754,3280000.0
2147,BSESN,2012-03-27,17257.359375,17366.839844,17061.160156,17209.130859,19000.0,204.58007799999905,0.0,204.58007799999905,44.804881536296534,17008.769531,18040.689453,24.090032443428193,-75.90996755657181,-66.44601041184069,-5.667552773353254,-0.036940135895361714,3299000.0
2148,BSESN,2012-03-28,17121.619141,17245.820313,17040.119141,17234.480469,13200.0,-135.74023400000078,135.74023400000078,0.0,40.86910095035688,17021.849609,18040.689453,9.792464692811778,-90.20753530718822,-82.23357790269802,-20.98075779922221,-0.03135523781090577,3285800.0
2149,BSESN,2012-03-29,17058.609375,17109.349609,16920.609375,17039.849609,11200.0,-63.00976599999922,63.00976599999922,0.0,39.03264422560817,16920.609375,18040.689453,12.32054767427085,-87.67945232572914,-98.69204000063473,-36.523014239504725,-0.02333592093445358,3274600.0
2150,BSESN,2012-03-30,17404.199219,17439.509766,17105.220703,17117.410156,25000.0,345.58984399999827,0.0,345.58984399999827,52.53138328141043,16920.609375,18040.689453,43.17457773764624,-56.825422262353754,-82.89373027109104,-45.797157445821995,0.007574091477583256,3299600.0
2151,BSESN,2012-04-02,17478.150391,17529.980469,17382.380859,17429.960938,10000.0,73.95117200000095,0.0,73.95117200000095,54.9918580928202,16920.609375,18040.689453,49.77688889847389,-50.22311110152611,-63.67224049129436,-49.37217405491647,0.009353720388582287,3309600.0
2152,BSESN,2012-04-03,17597.419922,17664.099609,17478.150391,17576.210938,10800.0,119.26953100000172,0.0,119.26953100000172,58.95138428570687,16920.609375,17918.25,67.84111733621523,-32.15888266378477,-38.37268060693896,-47.17227536532097,-0.00024378402844549285,3320400.0
2153,BSESN,2012-04-04,17486.019531,17597.419922,17436.599609,17553.259766,9800.0,-111.40039099999922,111.40039099999922,0.0,53.84619052208515,16920.609375,17871.0,59.4923961923553,-40.5076038076447,-27.000433476951002,-43.13790698764698,0.016837689139870493,3310600.0
2154,BSESN,2012-04-09,17222.140625,17486.019531,17199.630859,17407.660156,9800.0,-263.87890600000173,263.87890600000173,0.0,43.54049224037826,16920.609375,17687.009766,39.34382778779145,-60.656172212208546,-38.833025138901576,-42.276930617897904,-0.008040646105660465,3300800.0
2155,BSESN,2012-04-10,17243.839844,17274.689453,17135.759766,17259.259766,10000.0,21.699218999998266,0.0,21.699218999998266,44.54749564629924,16920.609375,17687.009766,42.175144062524176,-57.82485593747582,-45.93004073571501,-43.00755264146133,0.011204070824607948,3310800.0
2156,BSESN,2012-04-11,17199.400391,17319.150391,17075.890625,17125.960938,11800.0,-44.43945299999905,44.43945299999905,0.0,42.74588605936619,16920.609375,17687.009766,36.37667977129196,-63.62332022870804,-54.51198891286913,-45.30843989574289,-0.00335850825961026,3299000.0
2157,BSESN,2012-04-12,17332.619141,17395.150391,17199.400391,17276.869141,10200.0,133.21875,0.0,133.21875,49.77217945394179,16920.609375,17687.009766,53.759075652663604,-46.240924347336396,-49.98738148570919,-46.24422821373616,0.012323600838353599,3309200.0
2158,BSESN,2012-04-13,17094.509766,17398.220703,17027.300781,17232.560547,18400.0,-238.109375,238.109375,0.0,39.719489502127395,16920.609375,17664.099609,23.389734396968425,-76.61026560303158,-64.86728442470485,-49.9688394559299,0.002104532099352241,3290800.0
2159,BSESN,2012-04-16,17150.949219,17173.060547,17010.160156,17047.869141,9800.0,56.43945299999905,0.0,56.43945299999905,42.87504421358778,16920.609375,17664.099609,30.980883603643676,-69.01911639635631,-71.28380717833352,-54.23183300041064,-0.014551086023166682,3300600.0
2160,BSESN,2012-04-17,17357.939453,17381.919922,17103.359375,17200.970703,12400.0,206.9902340000008,0.0,206.9902340000008,53.23454686547021,16920.609375,17664.099609,58.82122696449549,-41.17877303550451,-58.986604832280136,-55.18278736678454,-0.006877783707702867,3313000.0
2161,BSESN,2012-04-18,17392.390625,17522.800781,17357.939453,17447.259766,9800.0,34.45117200000095,0.0,34.45117200000095,54.80843010117486,16920.609375,17664.099609,63.454935710695494,-36.5450642893045,-45.93159092773931,-53.332548078975485,-0.011651099871957782,3322800.0
2162,BSESN,2012-04-19,17503.710938,17530.300781,17361.710938,17432.890625,11800.0,111.32031300000016,0.0,111.32031300000016,59.84675671450958,16920.609375,17664.099609,78.4276021842137,-21.5723978157863,-26.299613858052908,-47.925961234790975,0.0010117458103391375,3334600.0
2163,BSESN,2012-04-20,17373.839844,17519.880859,17231.339844,17459.720703,11200.0,-129.8710940000019,129.8710940000019,0.0,52.03716227159725,17010.160156,17664.099609,55.613663670480065,-44.386336329519935,-20.978811813623906,-42.53653135055757,0.008808383481655468,3323400.0
2164,BSESN,2012-04-23,17096.679688,17444.179688,17056.769531,17347.759766,13000.0,-277.1601559999981,277.1601559999981,0.0,39.38235028285934,17010.160156,17664.099609,13.230511112777066,-86.76948888722293,-38.68065955871498,-41.765356992189055,-0.008534071142582644,3310400.0
2165,BSESN,2012-04-24,17207.289063,17247.529297,17046.720703,17154.75,12400.0,110.609375,0.0,110.609375,45.48687958116242,17010.160156,17664.099609,30.144825502675204,-69.8551744973248,-43.285283466590045,-42.069342287069254,0.0004586597102611556,3322800.0
2166,BSESN,2012-04-25,17151.289063,17249.609375,17019.240234,17225.539063,11400.0,-56.0,56.0,0.0,42.959577881539786,17010.160156,17597.419922,24.031768421880724,-75.96823157811929,-50.86685167399628,-43.828844164454665,-0.010461781714863005,3311400.0
2167,BSESN,2012-04-26,17130.669922,17193.25,17084.050781,17191.019531,10800.0,-20.619140999999214,20.619140999999214,0.0,41.96890777225716,17010.160156,17530.300781,23.16868942894034,-76.83131057105966,-57.87197930459661,-46.63747119248306,0.0021153081600457924,3300600.0
2168,BSESN,2012-04-27,17134.25,17242.150391,17022.089844,17145.390625,11000.0,3.580077999999048,0.0,3.580077999999048,42.23577658305086,17010.160156,17530.300781,23.856979831175128,-76.14302016882488,-62.41522715985775,-49.793022385958004,-0.000973661503323564,3311600.0
2169,BSESN,2012-04-30,17318.810547,17359.179688,17187.339844,17195.509766,8400.0,184.56054700000092,0.0,184.56054700000092,54.6430242581027,17010.160156,17530.300781,59.33979700201253,-40.66020299798747,-50.54068851472039,-49.94255561171049,-0.0022542368065027185,3320000.0
2170,BSESN,2012-05-02,17301.910156,17432.330078,17265.480469,17370.929688,9400.0,-16.900390999999214,16.900390999999214,0.0,53.43044238097517,17010.160156,17530.300781,56.09060049866322,-43.90939950133678,-42.00949212306659,-48.355942913981714,-0.005202302026838135,3310600.0
2171,BSESN,2012-05-03,17151.189453,17301.910156,17120.859375,17271.769531,8600.0,-150.7207030000027,150.7207030000027,0.0,43.49774593429027,17010.160156,17530.300781,27.113686226680972,-72.88631377331903,-46.870069638174755,-48.05876825882033,-0.020139814137051792,3302000.0
2172,BSESN,2012-05-04,16831.080078,17151.189453,16776.720703,17066.839844,11000.0,-320.109375,320.109375,0.0,29.88372285795853,16776.720703,17530.300781,7.213483554962,-92.786516445038,-75.67987316552899,-53.58298924016207,-0.03124005809155883,3291000.0
2173,BSESN,2012-05-07,16912.710938,16944.130859,16513.769531,16620.439453,11400.0,81.63086000000112,0.0,81.63086000000112,35.796385419693465,16513.769531,17530.300781,39.2453657474867,-60.7546342525133,-90.87734438308325,-61.04186026874631,-0.010760495801364622,3302400.0
2174,BSESN,2012-05-08,16546.179688,16918.310547,16502.910156,16915.710938,12800.0,-366.53125,366.53125,0.0,24.912462696790797,16502.910156,17530.300781,4.211594981217435,-95.78840501878257,-130.98751591383552,-75.03099139776417,-0.038420309705934574,3289600.0
2175,BSESN,2012-05-09,16479.580078,16615.740234,16422.929688,16436.410156,12400.0,-66.59961000000112,66.59961000000112,0.0,23.419553253386923,16422.929688,17530.300781,5.115754814090925,-94.88424518590908,-166.23291815686025,-93.2713767495834,-0.03916376095888097,3277200.0
2176,BSESN,2012-05-10,16420.050781,16671.810547,16377.019531,16515.619141,10800.0,-59.529296999997314,59.529296999997314,0.0,22.05635943251454,16377.019531,17519.880859,3.7652205867623674,-96.23477941323763,-196.70122089248252,-113.95734557816324,-0.04148227385359804,3266400.0
2177,BSESN,2012-05-11,16292.980469,16447.240234,16233.759766,16355.589844,11200.0,-127.07031200000164,127.07031200000164,0.0,19.290758261228603,16233.759766,17444.179688,4.892575041407888,-95.10742495859212,-228.46745196008123,-136.85936685454686,-0.04909870761778312,3255200.0
2178,BSESN,2012-05-14,16215.839844,16390.330078,16124.820313,16318.360352000003,11000.0,-77.140625,77.140625,0.0,17.733247819033764,16124.820313,17432.330078,6.961288813013186,-93.03871118698682,-256.90557513885506,-160.86860851140852,-0.06368628492163164,3244200.0
2179,BSESN,2012-05-15,16328.25,16370.120117,16123.040038999998,16146.900391,11400.0,112.41015599999993,0.0,112.41015599999993,27.566385691654176,16123.040038999998,17432.330078,15.673376783400556,-84.32662321659944,-267.2912651833176,-182.15313984579035,-0.056274720376024656,3255600.0
2180,BSESN,2012-05-16,16030.089844,16328.25,15974.599609,16132.679688,12800.0,-298.16015599999986,298.16015599999986,0.0,20.183125664323356,15974.599609,17432.330078,3.8066183138825074,-96.19338168611749,-296.16700327304716,-204.95591253124175,-0.06536570609707204,3242800.0
2181,BSESN,2012-05-17,16070.480469,16240.179688,16007.919922,16119.080078,12800.0,40.390625,0.0,40.390625,23.390359558520245,15974.599609,17432.330078,6.577406594634294,-93.4225934053657,-312.19327809237075,-226.40338564346757,-0.04519018419941945,3255600.0
2182,BSESN,2012-05-18,16152.75,16206.349609,15809.709961000002,15868.070313,14000.0,82.26953099999993,0.0,82.26953099999993,30.000868857766193,15809.709961000002,17432.330078,21.141118331149002,-78.858881668851,-314.6289065679957,-244.0484898283732,-0.044934306557117165,3269600.0
2183,BSESN,2012-05-21,16183.259766,16298.389647999997,16149.610352000003,16187.660156,10400.0,30.509765999999214,0.0,30.509765999999214,32.493427123339856,15809.709961000002,17432.330078,23.021396141115243,-76.97860385888475,-310.5178204042495,-257.3423559435485,-0.021933759263064623,3280000.0
2184,BSESN,2012-05-22,16026.410156,16366.719727000003,16000.839844,16344.339844,11600.0,-156.8496099999993,156.8496099999993,0.0,26.82691442038005,15809.709961000002,17301.910156,14.522193183334739,-85.47780681666526,-316.27043893232076,-269.12797254130294,-0.02749887556934627,3268400.0
2185,BSESN,2012-05-23,15948.099609,16026.410156,15847.030272999997,15995.139647999997,11400.0,-78.31054699999912,78.31054699999912,0.0,24.37784866822581,15809.709961000002,17151.189453,10.316195575504096,-89.6838044244959,-323.420249916624,-279.98642801636714,-0.028742369819349523,3257000.0
2186,BSESN,2012-05-24,16222.299805,16252.370117,15934.769531,16033.900391,11000.0,274.20019599999983,0.0,274.20019599999983,44.75413069726993,15809.709961000002,16944.130859,36.37008492415826,-63.62991507584174,-303.46273291666876,-284.68168899642745,-0.00433810524320466,3268000.0
2187,BSESN,2012-05-25,16217.820313,16273.480469,16118.349609,16213.240234,9400.0,-4.479492000000391,4.479492000000391,0.0,44.52796969534088,15809.709961000002,16918.310547,36.81310989312416,-63.18689010687585,-284.72557527948084,-284.69046625303815,0.00012213175629827155,3258600.0
2188,BSESN,2012-05-28,16416.839844,16439.970703,16217.820313,16289.820313,8000.0,199.0195309999981,0.0,199.0195309999981,55.94169087740384,15809.709961000002,16671.810547,70.42448327485499,-29.575516725145,-250.924528215819,-277.93727864559435,0.00542555656607413,3266600.0
2189,BSESN,2012-05-29,16438.580078,16544.380859,16410.210938,16500.039063,8600.0,21.740234000000786,0.0,21.740234000000786,57.05541601029622,15809.709961000002,16671.810547,72.9462579207663,-27.053742079233693,-219.84842392131577,-266.31950770073865,0.02548271643985167,3275200.0
2190,BSESN,2012-05-30,16312.150391,16438.580078,16295.30957,16391.900391,13800.0,-126.42968699999984,126.42968699999984,0.0,48.781060322673405,15809.709961000002,16544.380859,68.38986427362174,-31.610135726378267,-203.0812126943256,-253.67184869945604,0.015038126735923196,3261400.0
2191,BSESN,2012-05-31,16218.530272999997,16312.150391,16086.05957,16224.860352000003,16000.0,-93.62011800000073,93.62011800000073,0.0,43.40300641907909,15809.709961000002,16544.380859,55.64672741399309,-44.35327258600691,-195.0984644487471,-241.95717184931428,0.004072388478741695,3245400.0
2192,BSESN,2012-06-01,15965.160156,16226.19043,15933.480469,16217.480469,12200.0,-253.37011699999854,253.37011699999854,0.0,32.287248776493186,15809.709961000002,16544.380859,21.159160574235507,-78.8408394257645,-206.8326913737328,-234.932275754198,-0.013476865177571518,3233200.0
2193,BSESN,2012-06-04,15988.400391,16012.839844,15748.980469,15808.879883,12200.0,23.240234999999302,0.0,23.240234999999302,34.074179956424175,15748.980469,16544.380859,30.100553760100485,-69.8994462398995,-211.81518441896333,-230.30885748715107,-0.002371695509475691,3245400.0
2194,BSESN,2012-06-05,16020.639647999997,16138.290038999998,15979.769531,16065.370117,10800.0,32.23925699999927,0.0,32.23925699999927,36.74606241352113,15748.980469,16544.380859,34.15376487305926,-65.84623512694074,-210.73320622455503,-226.39372723463188,0.004548506767480864,3256200.0
2195,BSESN,2012-06-06,16454.300781,16494.5,16100.360352000003,16100.360352000003,13600.0,433.6611330000033,0.0,433.6611330000033,61.170928663626334,15748.980469,16544.380859,88.67487630977917,-11.325123690220842,-172.88993399560786,-215.69296858682708,0.014301361631135379,3269800.0
2196,BSESN,2012-06-07,16649.050781,16680.589844,16519.890625,16578.009766,11400.0,194.75,0.0,194.75,67.64479411617222,15748.980469,16680.589844,96.61456144105499,-3.385438558945008,-125.73477844306399,-197.70133055807446,0.02658991527081689,3281200.0
2197,BSESN,2012-06-08,16718.869141,16767.769531,16485.019531,16611.519531,11800.0,69.81835999999747,0.0,69.81835999999747,69.73229308220138,15748.980469,16767.769531,95.20014575892625,-4.799854241073747,-81.78742525012422,-174.51854949648444,0.01839752960192187,3293000.0
2198,BSESN,2012-06-11,16668.009766,16893.810547,16627.480469,16804.890625,8800.0,-50.859375,50.859375,0.0,66.1453012909799,15748.980469,16893.810547,80.27648073376339,-19.723519266236604,-50.48084596505578,-149.71100879019872,0.013956782575585747,3284200.0
2199,BSESN,2012-06-12,16862.800781,16897.419922,16553.470703,16570.509766,9800.0,194.7910150000025,0.0,194.7910150000025,72.4158065249342,15748.980469,16897.419922,96.9855493113228,-3.014450688677202,-9.838734548378852,-121.73655394183474,0.03375706922759969,3294000.0
2200,BSESN,2012-06-13,16880.509766,16944.109375,16792.869141,16865.720703,9800.0,17.708984999997483,0.0,17.708984999997483,72.94153249836546,15748.980469,16944.109375,94.67843103110413,-5.321568968895878,23.528180431050714,-92.68360706725765,0.04081624425007502,3303800.0
2201,BSESN,2012-06-14,16677.880859,16921.490234,16658.980469,16857.230469,9200.0,-202.62890699999843,202.62890699999843,0.0,58.27743847560373,15748.980469,16944.109375,77.72386604796928,-22.276133952030712,33.23809354108016,-67.4992669455901,0.04464225200598104,3294600.0
2202,BSESN,2012-06-15,16949.830078,16967.759766,16701.279297,16701.279297,10400.0,271.94921899999827,0.0,271.94921899999827,68.18290959010886,15748.980469,16967.759766,98.52888147639743,-1.4711185236025701,62.16074842168746,-41.567263872134575,0.06013295035700983,3305000.0
2203,BSESN,2012-06-18,16705.830078,17109.949219,16636.089844,17039.539063,11400.0,-244.0,244.0,0.0,54.730912162988155,15748.980469,17109.949219,70.30650843379028,-29.693491566209712,64.648176052684,-20.324175887170856,0.04276923050856718,3293600.0
2204,BSESN,2012-06-19,16859.800781,16890.0,16681.890625,16681.890625,9800.0,153.9707030000027,0.0,153.9707030000027,60.4170293152407,15748.980469,17109.949219,81.61982499598194,-18.38017500401805,78.14284721596778,-0.6307712665431242,0.02464401285700557,3303400.0
2205,BSESN,2012-06-20,16896.630859,16962.490234,16840.099609,16903.960938,9200.0,36.83007799999905,0.0,36.83007799999905,61.74330545261404,15748.980469,17109.949219,84.32599132052093,-15.674008679479067,90.7630904212092,17.648001071007346,0.014870522125053354,3312600.0
2206,BSESN,2012-06-21,17032.560547,17050.439453,16799.630859,16855.599609,10800.0,135.92968800000014,0.0,135.92968800000014,66.52041523829043,15748.980469,17109.949219,94.31370690914119,-5.686293090858803,110.4598020558442,36.210361267974726,0.018762716745639896,3323400.0
2207,BSESN,2012-06-22,16972.509766,17016.060547,16807.800781,16882.740234,11800.0,-60.05078100000173,60.05078100000173,0.0,62.539659430468234,15979.769531,17109.949219,87.83915031748481,-12.160849682515197,119.84252178034876,52.93679337044954,0.018268527813148472,3311600.0
2208,BSESN,2012-06-25,16882.160156,17131.150391,16853.050781,17038.769531,10600.0,-90.34960999999748,90.34960999999748,0.0,56.65398079091799,16100.360352000003,17131.150391,75.8447185576656,-24.155281442334395,118.62055242740462,66.07354518184056,0.0011480521682858402,3301000.0
2209,BSESN,2012-06-26,16906.580078,16946.660156,16815.869141,16873.089844,7400.0,24.419921999997314,0.0,24.419921999997314,57.88990862939163,16485.019531,17131.150391,65.24383419792066,-34.75616580207932,118.25939582977298,76.51071531142705,0.0015444031229738808,3308400.0
2210,BSESN,2012-06-27,16967.759766,17029.269531,16930.800781,16975.759766,6800.0,61.17968800000017,0.0,61.17968800000017,61.09649892938896,16485.019531,17131.150391,74.71245608049108,-25.28754391950891,121.50918391049345,85.51040903124034,0.017381039560764533,3315200.0
2211,BSESN,2012-06-28,16990.759766,17033.849609,16918.869141,16985.580078,8800.0,23.0,0.0,23.0,62.340443355673344,16553.470703,17131.150391,75.69749674148142,-24.30250325851858,124.50535196335841,93.30939761766396,0.002414755063127494,3324000.0
2212,BSESN,2012-06-29,17429.980469,17448.480469,17134.609375,17134.609375,13000.0,439.22070299999916,0.0,439.22070299999916,77.90652270596952,16553.470703,17448.480469,97.93298344858508,-2.067016551414928,160.4714616234305,106.74181041881728,0.043347166086265654,3337000.0
2213,BSESN,2012-07-02,17398.980469,17486.570313,17363.039063,17438.679688,8600.0,-31.0,31.0,0.0,75.36948804684536,16636.089844,17486.570313,89.70113398335997,-10.298866016640025,184.34836848959822,122.26312203297347,0.03198019330143098,3328400.0
2214,BSESN,2012-07-03,17425.710938,17526.820313,17351.5,17457.949219,9400.0,26.730469000001907,0.0,26.730469000001907,76.14247257842236,16636.089844,17526.820313,88.64871265563502,-11.351287344364975,203.08685580081874,138.42786878654255,0.03131275598165684,3337800.0
2215,BSESN,2012-07-04,17462.810547,17523.769531,17372.449219,17473.259766,10200.0,37.09960900000078,0.0,37.09960900000078,77.28413399282678,16636.089844,17526.820313,92.81378955500857,-7.186210444991422,218.41313967370297,154.42492296397464,0.02526044154152629,3348000.0
2216,BSESN,2012-07-05,17538.669922,17562.890625,17423.449219,17478.160156,8200.0,75.859375,0.0,75.859375,79.58861055264738,16636.089844,17562.890625,97.38663329848887,-2.6133667015111204,233.98333342398473,170.33660505597666,0.033357480054844624,3356200.0
2217,BSESN,2012-07-06,17521.119141,17554.550781,17425.470703,17546.039063,8000.0,-17.550781000001734,17.550781000001734,0.0,77.49003811386712,16681.890625,17562.890625,95.2586283768444,-4.741371623155595,242.1156641351845,184.69241687181824,0.0378481769569583,3348200.0
2218,BSESN,2012-07-09,17391.980469,17485.789063,17343.550781,17449.929688,7200.0,-129.13867200000095,129.13867200000095,0.0,63.31598155228548,16799.630859,17562.890625,77.60786515766614,-22.392134842333864,235.42633499854492,194.8392004971636,0.02871073799435253,3341000.0
2219,BSESN,2012-07-10,17618.349609,17631.189453,17424.289063,17431.679688,8800.0,226.3691400000025,0.0,226.3691400000025,73.22260113616238,16799.630859,17631.189453,98.45593033459788,-1.5440696654021102,245.56042350974167,204.98344509967927,0.03834270710878718,3349800.0
2220,BSESN,2012-07-11,17489.140625,17582.990234,17466.990234,17553.970703,7800.0,-129.20898400000078,129.20898400000078,0.0,62.16592949810971,16807.800781,17631.189453,82.74826545099718,-17.25173454900282,240.39455768221887,212.06566761618723,0.029332464578617934,3342000.0
2221,BSESN,2012-07-12,17232.550781,17329.460938,17181.169922,17297.060547,11800.0,-256.58984399999827,256.58984399999827,0.0,46.18574276601075,16815.869141,17631.189453,51.106495676266505,-48.893504323733495,213.13898228250764,212.28033054945135,-0.011327017167410691,3330200.0
2222,BSESN,2012-07-13,17213.699219,17342.880859,17182.289063,17269.199219,7600.0,-18.85156200000347,18.85156200000347,0.0,45.2007548764346,16815.869141,17631.189453,48.79432931385121,-51.2056706861488,187.8521364134176,207.3946917222446,-0.010648971664179885,3322600.0
2223,BSESN,2012-07-16,17103.310547,17282.300781,17079.630859,17241.980469,7600.0,-110.38867199999731,110.38867199999731,0.0,39.50787861803172,16918.869141,17631.189453,25.893043184763453,-74.10695681523654,157.093805998451,197.3345145774859,-0.018501419663569996,3315000.0
2224,BSESN,2012-07-17,17105.300781,17236.080078,17074.630859,17176.929688,9200.0,1.9902340000007823,0.0,1.9902340000007823,39.66595828584816,16918.869141,17631.189453,26.17244473578939,-73.82755526421062,131.3639212801936,184.14039591802745,-0.020472636122220167,3324200.0
2225,BSESN,2012-07-18,17185.009766,17205.259766,17038.589844,17113.369141,17600.0,79.70898499999748,0.0,79.70898499999748,46.16691818377086,17038.589844,17631.189453,24.70806928932698,-75.29193071067301,116.06670645785198,170.52565802599239,-0.02016459387016467,3341800.0
2226,BSESN,2012-07-19,17278.849609,17318.929688,17244.759766,17288.339844,8000.0,93.83984300000157,0.0,93.83984300000157,53.04026979685387,17038.589844,17631.189453,40.5433553028217,-59.4566446971783,110.2448110220248,158.4694886251989,-0.013827286376535186,3349800.0
2227,BSESN,2012-07-20,17158.439453,17275.199219,17129.689453,17275.199219,6400.0,-120.41015600000172,120.41015600000172,0.0,44.60781498604383,17038.589844,17631.189453,20.224382058274465,-79.77561794172554,94.82177724156645,145.73994634847242,-0.013428086376722326,3343400.0
2228,BSESN,2012-07-23,16877.349609,17047.730469,16849.279297,17047.730469,8000.0,-281.08984399999827,281.08984399999827,0.0,31.232910336311065,16849.279297,17631.189453,3.5899664155276554,-96.41003358447234,59.23449225412696,128.43885552960333,-0.04205842297631979,3335400.0
2229,BSESN,2012-07-24,16918.080078,16962.740234,16839.699219,16907.740234,12400.0,40.730468999998266,0.0,40.730468999998266,34.515671489104946,16839.699219,17631.189453,9.902947077929543,-90.09705292207045,33.92683354027031,109.53645113173673,-0.03265229317120899,3347800.0
2230,BSESN,2012-07-25,16846.050781,16899.009766,16736.599609,16899.009766,10800.0,-72.02929699999731,72.02929699999731,0.0,31.45198467017491,16736.599609,17631.189453,12.234788124869565,-87.76521187513043,7.966338393631304,89.22242858411563,-0.022428484611003774,3337000.0
2231,BSESN,2012-07-26,16639.820313,16899.769531,16598.480469,16887.839844,12800.0,-206.2304680000016,206.2304680000016,0.0,24.320345780952167,16598.480469,17631.189453,4.003048742723233,-95.99695125727676,-28.9152987086527,65.59488312556196,-0.03333849968556246,3324200.0
2232,BSESN,2012-07-27,16839.189453,16975.029297,16760.720703,16860.160156,11400.0,199.3691399999989,0.0,199.3691399999989,39.597689665438246,16598.480469,17631.189453,23.3085010132923,-76.6914989867077,-41.5775582194583,44.16039485655791,-0.015442688318977549,3335600.0
2233,BSESN,2012-07-30,17143.679688,17163.949219,16919.140625,16919.140625,8000.0,304.4902350000011,0.0,304.4902350000011,55.4469633823021,16598.480469,17582.990234,55.37773604510673,-44.62226395489328,-26.734494266733236,29.981417031899678,0.0022436850126967833,3343600.0
2234,BSESN,2012-07-31,17236.179688,17253.669922,17004.089844,17186.609375,10400.0,92.5,0.0,92.5,59.19959995534913,16598.480469,17342.880859,85.66615863809525,-14.333841361904748,-7.421729126945138,22.500787800130713,0.0029775905103783806,3354000.0
2235,BSESN,2012-08-01,17257.380859,17291.990234,17189.160156,17244.439453,9200.0,21.201171000000613,0.0,21.201171000000613,60.088640848473695,16598.480469,17342.880859,88.514245673622,-11.485754326378,9.48519428601503,19.897669097307578,-0.0012424872306786572,3363200.0
2236,BSESN,2012-08-02,17224.359375,17246.009766,17157.279297,17245.679688,15200.0,-33.02148400000078,33.02148400000078,0.0,57.82424709778876,16598.480469,17318.929688,86.8734241767566,-13.126575823243403,19.989073515134805,19.915949980873023,0.0038418366763812717,3348000.0
2237,BSESN,2012-08-03,17197.929688,17208.359375,17026.970703,17164.480469,7600.0,-26.429686999999827,26.429686999999827,0.0,55.879533379931296,16598.480469,17318.929688,83.20492314948298,-16.79507685051702,25.882461714412784,21.10925232758098,0.018994693268014506,3340400.0
2238,BSESN,2012-08-06,17412.960938,17451.529297,17313.050781,17313.050781,6600.0,215.03125,0.0,215.03125,66.46669450773871,16598.480469,17451.529297,95.47876302808768,-4.521236971912311,47.35832185100662,26.359066232266112,0.029251596973083105,3347000.0
2239,BSESN,2012-08-07,17601.779297,17641.550781,17417.919922,17456.369141,12000.0,188.8183590000008,0.0,188.8183590000008,73.02499735958861,16598.480469,17641.550781,96.18707545000086,-3.8129245499991424,78.70687541841107,36.82862806949511,0.04486087130001737,3359000.0
2240,BSESN,2012-08-08,17600.560547,17726.640625,17582.660156,17638.529297,14400.0,-1.21875,1.21875,0.0,72.91878554080203,16598.480469,17726.640625,88.824274875384,-11.175725124615981,102.27354131403263,49.91761071840262,0.057737416386006046,3344600.0
2241,BSESN,2012-08-09,17560.869141,17702.980469,17516.990234,17612.080078,14600.0,-39.69140600000173,39.69140600000173,0.0,69.13993245152265,16598.480469,17726.640625,85.30603273672071,-14.693967263279287,116.40567689249292,63.2152239532207,0.042857151171930674,3330000.0
2242,BSESN,2012-08-10,17557.740234,17590.609375,17471.369141,17515.419922,13600.0,-3.128906999998435,3.128906999998435,0.0,68.81555453986685,16598.480469,17726.640625,85.0286867425941,-14.971313257405889,125.90170304778076,75.75251977213273,0.0241523729756703,3316400.0
2243,BSESN,2012-08-13,17633.449219,17642.380859,17522.099609,17551.689453,9000.0,75.70898499999748,0.0,75.70898499999748,72.42720557390034,16598.480469,17726.640625,91.73952337313341,-8.260476626866584,137.94629552787956,88.19127492328211,0.023048583746001494,3325400.0
2244,BSESN,2012-08-14,17728.199219,17753.429688,17572.339844,17631.640625,10000.0,94.75,0.0,94.75,76.37784171488606,16598.480469,17753.429688,97.81544776298932,-2.1845522370106787,153.36930906039925,101.22688175070554,0.027282144599275027,3335400.0
2245,BSESN,2012-08-16,17657.210938,17763.589844,17640.619141,17752.220703,8800.0,-70.9882809999981,70.9882809999981,0.0,67.96009981634131,16760.720703,17763.589844,89.39254368781118,-10.607456312188807,158.04218546268385,112.5899424931012,0.025130198086104505,3326600.0
2246,BSESN,2012-08-17,17691.080078,17801.390625,17622.619141,17701.199219,9800.0,33.86913999999888,0.0,33.86913999999888,69.79285047842693,16919.140625,17801.390625,87.49667928591658,-12.503320714083419,162.60403215435872,122.59276042535271,0.028674985823677224,3336400.0
2247,BSESN,2012-08-21,17885.259766,17898.349609,17705.140625,17705.140625,9200.0,194.17968800000014,0.0,194.17968800000014,78.08547260652183,17004.089844,17898.349609,98.53623706306394,-1.4637629369360623,179.81520872300098,134.03725008488237,0.027123407080602124,3345600.0
2248,BSESN,2012-08-22,17846.859375,17912.080078,17800.289063,17827.25,8800.0,-38.40039099999922,38.40039099999922,0.0,73.48242601028753,17026.970703,17912.080078,92.63133971437156,-7.368660285628434,188.1872935477404,144.867258777454,0.013923596806021177,3336800.0
2249,BSESN,2012-08-23,17850.220703,17972.539063,17792.869141,17856.289063,9200.0,3.361327999999048,0.0,3.361327999999048,73.63937336904382,17026.970703,17972.539063,87.06403839485482,-12.935961605145183,192.870174848631,154.4678419916894,0.01418478436145909,3346000.0
2250,BSESN,2012-08-24,17783.210938,17822.5,17725.419922,17790.25,8200.0,-67.00976499999888,67.00976499999888,0.0,64.81523283610838,17026.970703,17972.539063,79.97732020136547,-20.022679798634524,188.99563991515606,161.37340157638275,0.01266120686936234,3337800.0
2251,BSESN,2012-08-27,17678.810547,17820.070313,17662.210938,17769.439453,7400.0,-104.40039099999922,104.40039099999922,0.0,53.32769224749571,17313.050781,17972.539063,55.461147071601815,-44.53885292839819,175.47800283719334,164.19432182854487,0.0068955521260960495,3330400.0
2252,BSESN,2012-08-28,17631.710938,17712.349609,17570.710938,17676.130859,9600.0,-47.09960900000078,47.09960900000078,0.0,48.823262161741575,17417.919922,17972.539063,38.547356229813126,-61.452643770186874,159.13027845032775,163.18151315290146,-9.85786149044765e-05,3320800.0
2253,BSESN,2012-08-29,17490.810547,17653.900391,17471.130859,17651.140625,9600.0,-140.90039099999922,140.90039099999922,0.0,37.801738503376654,17471.130859,17972.539063,3.9248835266365516,-96.07511647336345,133.26886458084118,157.19898343848942,-0.013390456022492003,3311200.0
2254,BSESN,2012-08-30,17541.640625,17605.509766,17367.550781,17433.5,10000.0,50.83007799999905,0.0,50.83007799999905,43.14425287290655,17367.550781,17972.539063,28.77573817206574,-71.22426182793427,115.54316062519501,148.86781887583055,-0.0065452190272746735,3321200.0
2255,BSESN,2012-08-31,17380.75,17557.619141,17337.609375,17557.619141,10600.0,-160.890625,160.890625,0.0,32.841589847147546,17337.609375,17972.539063,6.794551556707172,-93.20544844329282,87.50418988359161,136.59509307738276,-0.01754161287110534,3310600.0
2256,BSESN,2012-09-03,17384.400391,17509.990234,17349.570313,17465.599609,12600.0,3.6503909999992175,0.0,3.6503909999992175,33.258821231141965,17337.609375,17972.539063,7.36947994153318,-92.63052005846681,64.83033585090016,122.24214163208623,-0.02800403133937912,3323200.0
2257,BSESN,2012-09-04,17440.869141,17452.699219,17308.269531,17378.679688,6600.0,56.46875,0.0,56.46875,39.92099545909328,17308.269531,17972.539063,19.961717888936352,-80.03828211106364,50.831742681682954,107.96006184200559,-0.022748553427204943,3329800.0
2258,BSESN,2012-09-05,17313.339844,17411.669922,17250.800781,17359.960938,11400.0,-127.52929700000095,127.52929700000095,0.0,31.680341677088805,17250.800781,17972.539063,8.665061083734598,-91.3349389162654,29.111627558431792,92.19037498529083,-0.030076987166313907,3318400.0
2259,BSESN,2012-09-06,17346.269531,17418.400391,17294.740234,17320.730469,10000.0,32.92968700000347,0.0,32.92968700000347,35.63866180967425,17250.800781,17972.539063,13.227613441183687,-86.77238655881632,14.389556523878127,76.6302112930083,-0.02457044504073902,3328400.0
2260,BSESN,2012-09-07,17683.730469,17701.199219,17575.789063,17575.789063,9600.0,337.4609379999965,0.0,337.4609379999965,61.805450770150756,17250.800781,17972.539063,59.984304393597,-40.01569560640301,29.611147701663867,67.22639857473942,0.00027829485399588627,3338000.0
2261,BSESN,2012-09-10,17766.779297,17810.900391,17728.119141,17780.929688,8200.0,83.04882800000269,0.0,83.04882800000269,65.75853125583671,17250.800781,17972.539063,71.49108324560235,-28.50891675439764,47.82442453096519,63.34600376598458,0.007660536148474506,3346200.0
2262,BSESN,2012-09-11,17852.949219,17867.849609,17677.380859,17711.800781,8200.0,86.16992199999731,0.0,86.16992199999731,69.53360496269667,17250.800781,17972.539063,83.43030334089966,-16.569696659100337,68.4230320692368,64.36140942663503,0.02070451057867695,3354400.0
2263,BSESN,2012-09-12,18000.029297,18012.890625,17884.960938,17916.130859,11400.0,147.0800780000027,0.0,147.0800780000027,74.96865241186973,17250.800781,18012.890625,98.31236066177007,-1.6876393382299262,95.51467631068226,70.59206280344448,0.026131459525325917,3365800.0
2264,BSESN,2012-09-13,18021.160156,18062.679688,17976.279297,18023.949219,8000.0,21.130859000000786,0.0,21.130859000000786,75.68763871827078,17250.800781,18062.679688,94.88599449474323,-5.114005505256773,117.33748973847469,79.94114819045052,0.0368459448527827,3373800.0
2265,BSESN,2012-09-14,18464.269531,18498.539063,18284.75,18284.75,16800.0,443.109375,0.0,443.109375,85.6563329756169,17250.800781,18498.539063,97.25346793519329,-2.746532064806719,168.44571262648242,97.6420610776569,0.062117134655909956,3390600.0
2266,BSESN,2012-09-17,18542.310547,18715.029297,18480.539063,18619.900391,20200.0,78.04101599999922,0.0,78.04101599999922,86.75958003572379,17250.800781,18715.029297,88.2041123968931,-11.795887603106896,212.7936524888646,120.67237935989847,0.0631528966300614,3410800.0
2267,BSESN,2012-09-18,18496.009766,18580.480469,18469.509766,18514.720703,9600.0,-46.30078100000173,46.30078100000173,0.0,82.41989747750958,17250.800781,18715.029297,85.04198432097726,-14.95801567902273,241.4206809338757,144.82203967469394,0.06830975032294884,3401200.0
2268,BSESN,2012-09-20,18349.25,18443.919922,18291.929688,18292.220703,8800.0,-146.75976599999922,146.75976599999922,0.0,69.67381527799985,17250.800781,18715.029297,75.01897463387462,-24.981025366125376,249.39069988157644,165.73577171607045,0.05782110483222591,3392400.0
2269,BSESN,2012-09-21,18752.830078,18866.869141,18411.199219,18411.199219,15000.0,403.58007799999916,0.0,403.58007799999916,79.65640099209146,17250.800781,18866.869141,92.94342579666616,-7.056574203333846,284.9873796396714,189.58609330079065,0.060456678576624956,3407400.0
2270,BSESN,2012-09-24,18673.339844,18811.130859,18650.429688,18756.310547,15000.0,-79.49023400000078,79.49023400000078,0.0,74.11210529681713,17250.800781,18866.869141,88.02468374543257,-11.975316254567428,303.2876954884414,212.32641373832084,0.05102559849736377,3392400.0
2271,BSESN,2012-09-25,18694.410156,18790.009766,18636.160156,18708.009766,10600.0,21.07031200000347,0.0,21.07031200000347,74.651714553396,17250.800781,18866.869141,89.32848453267177,-10.671515467328236,315.85010236153903,233.0311514629645,0.04713288133394111,3403000.0
2272,BSESN,2012-09-26,18632.169922,18670.480469,18573.179688,18644.539063,10400.0,-62.24023400000078,62.24023400000078,0.0,69.69991492830192,17294.740234,18866.869141,85.07124842276063,-14.928751577239366,317.12797965115533,249.8505171006027,0.03511886645125384,3392600.0
2273,BSESN,2012-09-27,18579.5,18735.949219,18552.679688,18659.75,10400.0,-52.66992200000095,52.66992200000095,0.0,65.46016962853368,17575.789063,18866.869141,77.74195838842466,-22.258041611575347,310.3135822723525,261.94313013495264,0.03098245835266633,3382200.0
2274,BSESN,2012-09-28,18762.740234,18869.939453,18698.509766,18704.980469,11400.0,183.2402340000008,0.0,183.2402340000008,72.2389238264459,17677.380859,18869.939453,91.0109893518575,-8.989010648142495,316.0557843912684,272.7656609862158,0.016164771777128273,3393600.0
2275,BSESN,2012-10-01,18823.910156,18838.539063,18745.279297,18784.640625,8200.0,61.16992200000095,0.0,61.16992200000095,74.19003533982487,17677.380859,18869.939453,96.14029052898701,-3.8597094710129927,321.8325372720028,282.5790362433732,0.015186867261564707,3401800.0
2276,BSESN,2012-10-03,18869.689453,18905.619141,18816.570313,18841.490234,8400.0,45.779296999997314,0.0,45.779296999997314,75.6668411246926,17884.960938,18905.619141,96.47975317355088,-3.5202468264491285,326.34278573101255,291.3317861409011,0.02020325960721059,3410200.0
2277,BSESN,2012-10-04,19058.150391,19107.039063,18939.75,18939.75,11600.0,188.46093800000014,0.0,188.46093800000014,80.867024195796,17976.279297,19107.039063,95.6764758112201,-4.323524188779899,341.1913710509689,301.30370312291467,0.03863375293268123,3421800.0
2278,BSESN,2012-10-05,18938.460938,19137.289063,18757.339844,19115.890625,39400.0,-119.68945299999905,119.68945299999905,0.0,69.91764767294976,18284.75,19137.289063,76.67812143406736,-23.32187856593264,339.38878072271837,308.92071864287544,0.009898818430492451,3382400.0
2279,BSESN,2012-10-08,18708.980469,18969.189453,18684.400391,18969.189453,9400.0,-229.4804690000019,229.4804690000019,0.0,53.80181902447553,18291.929688,19137.289063,49.33414040626191,-50.66585959373809,315.8026821610074,310.2971113465019,0.0019086368746965565,3373000.0
2280,BSESN,2012-10-09,18793.359375,18885.839844,18722.050781,18796.25,8200.0,84.37890600000173,0.0,84.37890600000173,57.91716964620777,18291.929688,19137.289063,59.315564696966874,-40.684435303033126,300.4557349669485,308.32883607059125,0.005292984275742985,3381200.0
2281,BSESN,2012-10-10,18631.099609,18740.630859,18614.369141,18699.189453,7200.0,-162.25976599999922,162.25976599999922,0.0,48.35882715959624,18291.929688,19137.289063,40.12138872890605,-59.87861127109395,272.0639775132913,301.0758643591313,-5.744435588983521e-05,3374000.0
2282,BSESN,2012-10-11,18804.75,18847.810547,18581.490234,18627.369141,9400.0,173.65039099999925,0.0,173.65039099999925,57.101265288880306,18411.199219,19137.289063,54.20138902259603,-45.79861097740396,260.57173175315256,292.97503783793553,0.012123577060739077,3383400.0
2283,BSESN,2012-10-12,18675.179688,18844.349609,18638.339844,18727.099609,9000.0,-129.57031199999986,129.57031199999986,0.0,49.83737500940311,18552.679688,19137.289063,20.95416276894294,-79.04583723105706,238.26226381283777,282.032483032916,-0.004666724844451631,3374400.0
2284,BSESN,2012-10-15,18713.550781,18726.380859,18596.650391,18690.990234,6000.0,38.37109300000157,0.0,38.37109300000157,51.92701377775282,18552.679688,19137.289063,27.5177066737942,-72.4822933262058,221.129038357456,269.851794097824,-0.005862723211352727,3380400.0
2285,BSESN,2012-10-16,18577.699219,18801.099609,18549.279297,18784.75,7600.0,-135.8515620000035,135.8515620000035,0.0,44.375372576751424,18549.279297,19137.289063,4.833239793503251,-95.16676020649675,194.34842043819663,254.75111936589852,-0.015474034945157977,3372800.0
2286,BSESN,2012-10-17,18610.769531,18705.189453,18535.369141,18667.720703,7000.0,33.07031200000347,0.0,33.07031200000347,46.55835085195729,18535.369141,19137.289063,12.526648021462627,-87.47335197853737,173.78974558478149,238.55884460967513,-0.023474516194985418,3379800.0
2287,BSESN,2012-10-18,18791.929688,18806.560547,18576.410156,18653.599609,8200.0,181.16015699999843,0.0,181.16015699999843,57.18018249451886,18535.369141,19137.289063,42.62370086497994,-57.37629913502007,170.1535342713105,224.8777825420022,-0.007737231155145463,3388000.0
2288,BSESN,2012-10-19,18682.310547,18769.589844,18611.759766,18768.0,8000.0,-109.61914099999922,109.61914099999922,0.0,50.212293355224695,18535.369141,19137.289063,24.412118726982673,-75.58788127301732,156.62103228758133,211.22643249111806,-0.001425514449821974,3380000.0
2289,BSESN,2012-10-22,18793.439453,18809.279297,18600.880859,18655.929688,7000.0,111.1289059999981,0.0,111.1289059999981,56.42375803719466,18535.369141,19137.289063,42.87452575792955,-57.12547424207045,153.09877357910227,199.60090070871493,4.260973166081428e-06,3387000.0
2290,BSESN,2012-10-23,18710.019531,18812.929688,18689.380859,18803.619141,6000.0,-83.41992199999731,83.41992199999731,0.0,50.921239527374674,18535.369141,19137.289063,29.01555233787431,-70.98444766212569,141.93987313708203,188.06869519438837,0.0042359240010652055,3381000.0
2291,BSESN,2012-10-25,18758.630859,18789.919922,18699.070313,18712.410156,8600.0,48.61132799999905,0.0,48.61132799999905,53.941372787797434,18535.369141,19137.289063,37.091598041508455,-62.908401958491545,135.4574231937695,177.5464407942646,-0.0024525261436604273,3389600.0
2292,BSESN,2012-10-29,18635.820313,18743.410156,18572.019531,18656.0,7600.0,-122.81054600000058,122.81054600000058,0.0,45.73698569408453,18535.369141,18969.189453,23.155018154152494,-76.8449818458475,119.03805363483116,165.84476336237793,-0.00210757677610407,3382000.0
2293,BSESN,2012-10-30,18430.849609,18718.279297,18393.419922,18642.009766,9000.0,-204.9707039999994,204.9707039999994,0.0,35.375338710168194,18393.419922,18885.839844,7.601172358741415,-92.39882764125859,88.46637683925655,150.36908605775366,-0.015106762757553738,3373000.0
2294,BSESN,2012-10-31,18505.380859,18521.619141,18398.480469,18436.789063,7000.0,74.53125,0.0,74.53125,40.98478230758522,18393.419922,18847.810547,24.639799071558713,-75.36020092844129,69.45155739156326,134.18558032451557,-0.003892751150047391,3380000.0
2295,BSESN,2012-11-01,18561.699219,18589.130859,18445.179688,18487.900391,9000.0,56.318359999997476,0.0,56.318359999997476,45.13682618860224,18393.419922,18847.810547,37.034060066709635,-62.96593993329037,58.25506879418026,118.9994780184485,-0.0026366621712372584,3389000.0
2296,BSESN,2012-11-02,18755.449219,18793.75,18687.929688,18692.150391,9200.0,193.75,0.0,193.75,57.11397259589079,18393.419922,18844.349609,80.28508821598109,-19.714911784018902,64.2748561461558,108.05455364398996,-0.0019412838173451519,3398200.0
2297,BSESN,2012-11-05,18762.869141,18794.630859,18683.25,18749.369141,5600.0,7.419922000000953,0.0,7.419922000000953,57.523727690894205,18393.419922,18812.929688,88.06689353687155,-11.933106463128453,68.85063937467203,100.21377079012638,0.004312025206803627,3403800.0
2298,BSESN,2012-11-06,18817.380859,18829.070313,18726.939453,18739.970703,7600.0,54.51171800000157,0.0,54.51171800000157,60.706243228079224,18393.419922,18829.070313,97.31678101489426,-2.6832189851057446,75.9995451705181,95.37092566620473,0.0012739235976404473,3411400.0
2299,BSESN,2012-11-07,18902.410156,18973.429688,18786.140625,18802.820313,8800.0,85.02929700000095,0.0,85.02929700000095,65.37537224957396,18393.419922,18973.429688,87.75545927618079,-12.244540723819213,87.5174119203075,93.8002229170253,0.010282759175169964,3420200.0
2300,BSESN,2012-11-08,18846.259766,18865.210938,18736.449219,18779.740234,9800.0,-56.150390000002524,56.150390000002524,0.0,59.94766185940292,18393.419922,18973.429688,78.07452055902088,-21.925479440979124,91.06479878216123,93.25313809005249,0.0046713914069029805,3410400.0
2301,BSESN,2012-11-09,18683.679688,18894.419922,18656.410156,18832.75,9600.0,-162.58007799999902,162.58007799999902,0.0,46.930410238576194,18393.419922,18973.429688,50.04394460489129,-49.956055395108706,79.83696404677903,90.5699032813978,0.002568138895748806,3400800.0
2302,BSESN,2012-11-12,18670.339844,18750.919922,18607.660156,18691.019531,19400.0,-13.339844000001905,13.339844000001905,0.0,45.985054880713086,18393.419922,18973.429688,47.74401022757912,-52.25598977242088,69.06625737892682,86.26917410090361,0.012993987802008444,3381400.0
2303,BSESN,2012-11-15,18471.369141,18593.539063,18408.689453,18590.070313,6200.0,-198.97070299999905,198.97070299999905,0.0,34.14701548040638,18393.419922,18973.429688,13.439294227331747,-86.56070577266826,43.96828288555116,77.80899585783312,-0.0018379366660513652,3375200.0
2304,BSESN,2012-11-16,18309.369141,18563.320313,18266.759766,18491.490234,7000.0,-162.0,162.0,0.0,27.49700596481628,18266.759766,18973.429688,6.029600761754219,-93.97039923824579,10.880487679791258,64.42329422222475,-0.013594126002306473,3368200.0
2305,BSESN,2012-11-19,18339.0,18386.779297,18256.070313,18349.529297,7200.0,29.630859000000786,0.0,29.630859000000786,30.35927171344835,18256.070313,18973.429688,11.560410289473086,-88.43958971052692,-12.803277506256563,48.97797987652849,-0.022204171925571337,3375400.0
2306,BSESN,2012-11-20,18329.320313,18467.910156,18255.689453,18422.689453,6600.0,-9.679686999999829,9.679686999999829,0.0,29.914132954089908,18255.689453,18973.429688,10.258705923042061,-89.74129407695793,-31.985196458215796,32.78534460957963,-0.023106744749001207,3368800.0
2307,BSESN,2012-11-21,18460.380859,18478.5,18309.810547,18379.900391,6800.0,131.06054600000058,0.0,131.06054600000058,42.97636820353417,18255.689453,18973.429688,28.518870200999867,-71.48112979900013,-36.19428944384708,18.989417798894284,-0.01897182199132952,3375600.0
2308,BSESN,2012-11-22,18517.339844,18567.679688,18456.199219,18510.939453,6200.0,56.958984999997476,0.0,56.958984999997476,47.85027529568358,18255.689453,18973.429688,36.45474758705687,-63.54525241294313,-34.53580463835533,8.284373311444359,-0.020371492779071576,3381800.0
2309,BSESN,2012-11-23,18506.570313,18556.5,18402.380859,18543.949219,6000.0,-10.769530999998095,10.769530999998095,0.0,46.974352892287975,18255.689453,18973.429688,34.95427005008305,-65.04572994991695,-33.70195941880593,-0.11289323460570135,-0.01802423702196987,3375800.0
2310,BSESN,2012-11-26,18537.009766,18590.330078,18508.789063,18574.359375,5800.0,30.43945299999905,0.0,30.43945299999905,49.96160920881643,18255.689453,18973.429688,39.19528253839632,-60.80471746160367,-30.236375495580432,-6.13758968680065,-0.007850162518799886,3381600.0
2311,BSESN,2012-11-27,18842.080078,18862.699219,18616.550781,18616.550781,7600.0,305.07031199999983,0.0,305.07031199999983,69.70078175493924,18255.689453,18973.429688,81.69956154123074,-18.300438458769268,-2.840507071450702,-5.478173163730661,0.0091985596103219,3389200.0
2312,BSESN,2012-11-29,19170.910156,19205.330078,18873.630859,18873.630859,11400.0,328.8300780000027,0.0,328.8300780000027,79.67341003343157,18255.689453,19205.330078,96.3754791977231,-3.624520802276894,44.887322070775554,4.594925883170585,0.03787163851580799,3400600.0
2313,BSESN,2012-11-30,19339.900391,19372.699219,19186.300781,19229.699219,11200.0,168.99023499999745,0.0,168.99023499999745,82.99274072606937,18255.689453,19372.699219,97.06369371169858,-2.9363062883014286,95.2500864748472,22.725958001505912,0.056284366875991365,3411800.0
2314,BSESN,2012-12-03,19305.320313,19416.449219,19257.300781,19342.830078,7200.0,-34.58007799999905,34.58007799999905,0.0,79.9116235514128,18255.689453,19416.449219,90.42619245987906,-9.573807540120939,130.86409696265764,44.353585793736265,0.05269209406183539,3404600.0
2315,BSESN,2012-12-04,19348.119141,19373.939453,19263.710938,19277.580078,8200.0,42.79882799999905,0.0,42.79882799999905,80.92304238747641,18255.689453,19416.449219,94.11333162972508,-5.886668370274913,160.6896345133573,67.62079553766048,0.05558301184127479,3412800.0
2316,BSESN,2012-12-05,19391.859375,19463.25,19371.009766,19397.980469,9600.0,43.74023400000078,0.0,43.74023400000078,81.99220524622858,18255.689453,19463.25,94.08802935990587,-5.911970640094119,185.7152494432412,91.23968631877663,0.05045825019075245,3422400.0
2317,BSESN,2012-12-06,19486.800781,19523.25,19186.240234,19475.089844,10000.0,94.94140600000172,0.0,94.94140600000172,84.2087375450524,18255.689453,19523.25,97.12445933361808,-2.87554066638193,210.77947302143366,115.14764365930805,0.052354222861775046,3432400.0
2318,BSESN,2012-12-07,19424.099609,19561.869141,19363.130859,19514.880859,9000.0,-62.70117200000095,62.70117200000095,0.0,76.98765164857548,18255.689453,19561.869141,89.4524824367045,-10.547517563295504,223.01283705538663,136.7206823385238,0.049578570231107566,3423400.0
2319,BSESN,2012-12-10,19409.689453,19478.009766,19362.320313,19442.189453,6800.0,-14.410156000001733,14.410156000001733,0.0,75.27589426978493,18255.689453,19561.869141,88.34925321545805,-11.650746784541957,228.9063965799287,155.15782518680479,0.047077694731576525,3416600.0
2320,BSESN,2012-12-11,19387.140625,19612.179688,19285.289063,19466.289063,7600.0,-22.54882799999905,22.54882799999905,0.0,72.37062328183681,18309.810547,19612.179688,82.72079275256719,-17.2792072474328,229.11647093585634,169.9495543366151,0.028927833060024666,3409000.0
2321,BSESN,2012-12-12,19355.259766,19478.789063,19317.230469,19432.539063,7600.0,-31.880859000000786,31.880859000000786,0.0,68.08386613824703,18402.380859,19612.179688,78.76341786407853,-21.236582135921466,224.12684276530126,180.78501202235236,0.00961611151999997,3401400.0
2322,BSESN,2012-12-13,19229.259766,19421.720703,19196.75,19403.660156,9400.0,-126.0,126.0,0.0,53.60432402542667,18402.380859,19612.179688,68.34846316420091,-31.6515368357991,207.6121558195373,186.15044078178937,-0.005720847717058941,3392000.0
2323,BSESN,2012-12-14,19317.25,19348.849609,19193.109375,19217.960938,11400.0,87.99023400000078,0.0,87.99023400000078,60.391790052409306,18508.789063,19612.179688,73.27060051828879,-26.72939948171122,199.32651199799147,188.78565502502983,0.0006179481514205776,3403400.0
2324,BSESN,2012-12-17,19244.419922,19346.779297,19221.869141,19290.919922,12800.0,-72.83007799999905,72.83007799999905,0.0,52.988331999524775,18616.550781,19612.179688,63.06256644273992,-36.937433557260086,184.75357671902384,187.97923936382864,-0.005359653734003156,3390600.0
2325,BSESN,2012-12-18,19364.75,19396.279297,19149.029297,19293.009766,14000.0,120.33007799999905,0.0,120.33007799999905,61.89391539234293,18873.630859,19612.179688,66.49785656893914,-33.50214343106085,180.82956154924614,186.54930380091216,-0.0013979770828448368,3404600.0
2326,BSESN,2012-12-19,19476.0,19516.019531,19419.759766,19429.910156,9800.0,111.25,0.0,111.25,68.29996361030555,19149.029297,19612.179688,70.59709099975684,-29.40290900024316,184.56909882022592,186.15326280477493,-0.0005542613752449466,3414400.0
2327,BSESN,2012-12-20,19453.919922,19520.509766,19335.720703,19511.410156,10400.0,-22.080077999999045,22.080077999999045,0.0,65.76799134477105,19149.029297,19612.179688,65.82972419427377,-34.17027580572624,183.63421041634865,185.6494523270897,0.0015352224092890498,3404000.0
2328,BSESN,2012-12-21,19242.0,19394.550781,19221.119141,19394.550781,9200.0,-211.91992200000092,211.91992200000092,0.0,46.62604359938935,19149.029297,19612.179688,20.073545182432806,-79.92645481756719,163.90375751397733,181.30031336446726,-0.008639471198447213,3394800.0
2329,BSESN,2012-12-24,19255.089844,19347.640625,19237.259766,19278.0,7400.0,13.089843999998267,0.0,13.089843999998267,47.710706814177314,19149.029297,19612.179688,22.89980728959322,-77.10019271040677,147.62178045925248,174.56460678342432,-0.006811256159648393,3402200.0
2330,BSESN,2012-12-26,19417.460938,19468.400391,19274.070313,19302.470703,5800.0,162.3710940000019,0.0,162.3710940000019,59.49274617606917,19149.029297,19612.179688,57.9577705678758,-42.04222943212421,146.135626100604,168.87881064686027,0.003213657308245743,3408000.0
2331,BSESN,2012-12-27,19323.800781,19504.400391,19302.210938,19479.839844,7600.0,-93.66015699999843,93.66015699999843,0.0,51.73421308363067,19149.029297,19612.179688,37.73536358733228,-62.26463641266772,135.8344313740199,162.26993479229222,0.004916518688210969,3400400.0
2332,BSESN,2012-12-28,19444.839844,19465.740234,19346.070313,19364.080078,6600.0,121.0390629999965,0.0,121.0390629999965,59.59201949037264,19149.029297,19612.179688,63.8692210453079,-36.130778954692104,135.87126182613792,156.99020019906138,0.006604969340874067,3407000.0
2333,BSESN,2012-12-31,19426.710938,19491.580078,19406.169922,19422.589844,4800.0,-18.128905999998093,18.128905999998093,0.0,57.961246166373485,19149.029297,19612.179688,59.95496201578283,-40.04503798421716,132.90554660969065,152.17326948118725,0.00947240897563284,3402200.0
2334,BSESN,2013-01-02,19714.240234,19756.679688,19686.5,19693.300781,7400.0,287.5292960000006,0.0,287.5292960000006,71.98909434185154,19149.029297,19756.679688,93.01581063246623,-6.98418936753378,152.0041973704865,152.13945505904712,0.018047753469577543,3409600.0
2335,BSESN,2013-01-03,19764.779297,19786.300781,19693.289063,19771.029297,6600.0,50.53906300000017,0.0,50.53906300000017,73.76459940334357,19149.029297,19786.300781,96.62287038721463,-3.3771296127853656,169.26689233839716,155.56494251491713,0.01482744387964674,3416200.0
2336,BSESN,2013-01-04,19784.080078,19797.439453,19679.990234,19782.589844,7000.0,19.300780999998093,0.0,19.300780999998093,74.47747541136071,19149.029297,19797.439453,97.93967215405553,-2.0603278459444794,182.40249181082254,160.93245237409823,0.01697139483064425,3423200.0
2337,BSESN,2013-01-07,19691.419922,19856.429688,19654.460938,19820.560547,7400.0,-92.6601559999981,92.6601559999981,0.0,64.73378745595633,19149.029297,19856.429688,76.67378077544781,-23.326219224552194,183.2235616674443,165.39067423276745,0.02335619592557947,3415800.0
2338,BSESN,2013-01-08,19742.519531,19761.779297,19632.589844,19681.380859,7400.0,51.09960900000078,0.0,51.09960900000078,67.44399173783819,19149.029297,19856.429688,83.89735735953268,-16.10264264046732,185.85515430533997,169.48357024728196,0.0253143294032403,3423200.0
2339,BSESN,2013-01-09,19666.589844,19824.060547,19627.160156,19770.210938,9600.0,-75.92968700000347,75.92968700000347,0.0,59.59210746109722,19221.119141,19856.429688,70.11857509741584,-29.881424902584158,179.74186690420174,171.53522957866593,0.012830148431634214,3413600.0
2340,BSESN,2013-01-10,19663.550781,19783.75,19596.380859,19728.019531,9200.0,-3.0390629999965317,3.0390629999965317,0.0,59.27341880747171,19221.119141,19856.429688,69.6402164404807,-30.359783559519304,172.66148152833193,171.76047996859916,0.01758194486946163,3404400.0
2341,BSESN,2013-01-11,19663.640625,19839.800781,19619.830078,19813.640625,10000.0,0.08984399999826563,0.0,0.08984399999826563,59.28084684137228,19221.119141,19856.429688,69.6543581858716,-30.345641814128406,165.15368588025012,170.43912115092937,0.011252382778946579,3414400.0
2342,BSESN,2013-01-14,19906.410156,19948.630859,19689.089844,19689.089844,8800.0,242.7695310000017,0.0,242.7695310000017,74.04199720737168,19237.259766,19948.630859,94.06488351642946,-5.935116483570545,176.75564690947067,171.70242630263763,0.024692765519132465,3423200.0
2343,BSESN,2013-01-15,19986.820313,20036.820313,19881.779297,19999.820313,9600.0,80.41015699999843,0.0,80.41015699999843,77.20069267425002,19274.070313,20036.820313,93.44477220583414,-6.555227794165848,190.24567850889798,175.4110767438897,0.01382655764384455,3432800.0
2344,BSESN,2013-01-16,19817.630859,20009.359375,19783.019531,19978.189453,8600.0,-169.18945399999942,169.18945399999942,0.0,59.594891239143486,19302.210938,20036.820313,70.16244803573336,-29.83755196426664,185.15015504395342,177.35889240390247,0.0026740274306034095,3424200.0
2345,BSESN,2013-01-17,19964.029297,20005.980469,19783.410156,19846.419922,11800.0,146.39843800000014,0.0,146.39843800000014,67.08853267446956,19346.070313,20036.820313,89.46203170466896,-10.53796829533105,190.72647040283118,180.03240800368823,0.009095657634347498,3436000.0
2346,BSESN,2013-01-18,20039.039063,20126.550781,19990.619141,20038.669922,14600.0,75.00976599999922,0.0,75.00976599999922,70.34052398899618,19406.169922,20126.550781,87.85202064898264,-12.147979351017359,198.90554245434032,183.80703489381867,0.017653330352862318,3450600.0
2347,BSESN,2013-01-21,20101.820313,20163.380859,20056.460938,20132.830078,11400.0,62.78125,0.0,62.78125,72.92422949419598,19596.380859,20163.380859,89.14276084656075,-10.857239153439261,208.05510839265116,188.6566495935852,0.01819933780163252,3462000.0
2348,BSESN,2013-01-22,19981.570313,20156.859375,19952.910156,20102.429688,8600.0,-120.25,120.25,0.0,61.151215421515076,19596.380859,20163.380859,67.93464797178119,-32.065352028218804,203.25998075579992,191.57731582602815,0.016016018613216776,3453400.0
2349,BSESN,2013-01-23,20026.609375,20058.070313,19920.910156,19997.039063,10200.0,45.03906199999983,0.0,45.03906199999983,63.68491455675634,19596.380859,20163.380859,75.87804514991167,-24.12195485008832,200.77962096332703,193.41777685348796,0.018463531741724104,3463600.0
2350,BSESN,2013-01-24,19923.779297,20072.279297,19884.199219,20017.199219,12000.0,-102.83007799999905,102.83007799999905,0.0,54.347329869494665,19596.380859,20163.380859,57.74222892416228,-42.25777107583772,188.34526309784633,192.40327410235966,0.013229425667455663,3451600.0
2351,BSESN,2013-01-25,20103.529297,20129.009766,19928.109375,19945.689453,12000.0,179.75,0.0,179.75,64.7668199761118,19596.380859,20163.380859,89.44416895943566,-10.555831040564344,190.79589140155804,192.08179756219937,0.00990229476109672,3463600.0
2352,BSESN,2013-01-28,20103.349609,20172.449219,20062.789063,20129.0,6800.0,-0.17968800000016927,0.17968800000016927,0.0,64.74977420612421,19596.380859,20172.449219,88.0049635081507,-11.995036491849298,190.52725309361995,191.7708886684835,0.005830306880990399,3456800.0
2353,BSESN,2013-01-29,19990.900391,20203.660156,19970.050781,20080.310547,9000.0,-112.44921800000157,112.44921800000157,0.0,54.40966004071881,19596.380859,20203.660156,64.96508837843649,-35.03491162156351,179.17522274873045,189.2517554845329,0.008743201103743825,3447800.0
2354,BSESN,2013-01-30,20005.0,20073.460938,19964.640625,20014.800781,9200.0,14.099609000000784,0.0,14.099609000000784,55.439189303692324,19619.830078,20203.660156,65.97294941011916,-34.027050589880844,169.36405413379907,185.27421521438617,0.002052226150867975,3457000.0
2355,BSESN,2013-01-31,19894.980469,20008.830078,19865.720703,19987.279297,8400.0,-110.01953100000172,110.01953100000172,0.0,46.07192364406357,19689.089844,20203.660156,40.01214609520625,-59.98785390479375,150.97067962200163,178.4135080959093,-0.007188897309252318,3448600.0
2356,BSESN,2013-02-01,19781.189453,19966.689453,19736.449219,19907.210938,16400.0,-113.79101599999922,113.79101599999922,0.0,38.34079095926859,19736.449219,20203.660156,9.57602454413443,-90.42397545586557,125.7621065244748,167.8832277816224,-0.015950339571618177,3432200.0
2357,BSESN,2013-02-04,19751.189453,19902.599609,19728.210938,19860.970703,6800.0,-30.0,30.0,0.0,36.47867377421779,19728.210938,20203.660156,4.833011419528469,-95.16698858047154,102.18545117427857,154.74367246015365,-0.01152966740807726,3425400.0
2358,BSESN,2013-02-05,19659.820313,19717.259766,19631.970703,19665.539063,7800.0,-91.36913999999888,91.36913999999888,0.0,31.160353313339186,19631.970703,20203.660156,4.8714577212955845,-95.12854227870442,75.26049976117429,138.8470379203578,-0.01831508545115368,3417600.0
2359,BSESN,2013-02-06,19639.720703,19767.25,19611.269531,19737.769531,7200.0,-20.09961000000112,20.09961000000112,0.0,30.04838454171137,19611.269531,20203.660156,4.802772157307066,-95.19722784269294,51.70439515248654,121.41850936678354,-0.014257264636673317,3410400.0
2360,BSESN,2013-02-07,19580.320313,19702.560547,19540.080078,19589.439453,9000.0,-59.400389999998886,59.400389999998886,0.0,26.78859390089545,19540.080078,20203.660156,6.064111376170783,-93.93588862382921,27.92104111260778,102.71901571594839,-0.026025727934153253,3401400.0
2361,BSESN,2013-02-08,19484.769531,19648.070313,19414.800781,19577.189453,14200.0,-95.55078199999843,95.55078199999843,0.0,22.29865781212078,19414.800781,20203.660156,8.869609998613505,-91.1303900013865,1.3468860658285848,82.44458978592444,-0.030770000523846486,3387200.0
2362,BSESN,2013-02-11,19460.570313,19543.439453,19416.939453,19517.589844,7200.0,-24.199218000001565,24.199218000001565,0.0,21.257498036570738,19414.800781,20203.660156,5.801988725810406,-94.1980112741896,-21.419091957322962,61.671853437274955,-0.026528573882482864,3380000.0
2363,BSESN,2013-02-12,19561.039063,19583.529297,19438.529297,19489.869141,6800.0,100.46875,0.0,100.46875,35.65077148439265,19414.800781,20203.660156,18.537940554994154,-81.46205944500583,-30.99699106996195,43.13808453582757,-0.0221924987253187,3386800.0
2364,BSESN,2013-02-13,19608.080078,19723.009766,19574.150391,19601.689453,8000.0,47.041014999998886,0.0,47.041014999998886,41.43423231414048,19414.800781,20203.660156,24.501109212272127,-75.49889078772787,-34.39524141667789,27.631419345326478,-0.014420742530863118,3394800.0
2365,BSESN,2013-02-14,19497.179688,19639.830078,19444.330078,19626.810547,10000.0,-110.90038999999888,110.90038999999888,0.0,33.29433245403612,19414.800781,20203.660156,10.442787347237704,-89.5572126527623,-45.51247446420166,13.002640583420847,-0.01435756761112894,3384800.0
2366,BSESN,2013-02-15,19468.150391,19512.890625,19381.820313,19449.830078,7600.0,-29.02929700000095,29.02929700000095,0.0,31.429464448160758,19381.820313,20203.660156,10.504489254848512,-89.49551074515149,-56.01962405454833,-0.8018123441729915,-0.014330228702100212,3377200.0
2367,BSESN,2013-02-18,19501.080078,19554.480469,19462.919922,19496.25,6000.0,32.92968699999983,0.0,32.92968699999983,36.113155248392815,19381.820313,20073.460938,17.24302487292427,-82.75697512707573,-60.98645141958332,-12.83874015925506,-0.008074348212380844,3383200.0
2368,BSESN,2013-02-19,19635.720703,19671.169922,19457.210938,19523.699219,5800.0,134.640625,0.0,134.640625,51.68307530430623,19381.820313,20008.830078,40.49384940599759,-59.50615059400241,-53.44227540734937,-20.959447208873925,-0.00020366888411960105,3389000.0
2369,BSESN,2013-02-20,19642.75,19742.419922,19619.890625,19717.939453,6800.0,7.029297000000953,0.0,7.029297000000953,52.38215765354172,19381.820313,19966.689453,44.61334496123361,-55.3866550387664,-46.36182577488944,-26.039922922077032,0.003188389464627406,3395800.0
2370,BSESN,2013-02-21,19325.359375,19554.650391,19289.699219,19549.050781,12400.0,-317.390625,317.390625,0.0,29.867716218553355,19289.699219,19902.599609,5.818262899131389,-94.18173710086862,-65.60503531327413,-33.95294540031646,-0.008181269773110844,3383400.0
2371,BSESN,2013-02-22,19317.009766,19401.75,19289.830078,19341.900391,7600.0,-8.349609000000783,8.349609000000783,0.0,29.48306214829853,19289.699219,19767.25,5.718878093511243,-94.28112190648875,-80.60005392809762,-43.282367105872694,-0.00737699587889773,3375800.0
2372,BSESN,2013-02-25,19331.689453,19411.179688,19237.980469,19365.330078,7800.0,14.67968699999983,0.0,14.67968699999983,31.27845622017655,19237.980469,19767.25,17.70534264894241,-82.2946573510576,-90.25873959010642,-52.67764160271945,-0.011724817340292515,3383600.0
2373,BSESN,2013-02-26,19015.140625,19293.490234,18976.939453,19290.660156,9200.0,-316.54882799999905,316.54882799999905,0.0,19.148265942908708,18976.939453,19742.419922,4.990482911981502,-95.0095170880185,-122.04925464050757,-66.55196421027708,-0.030239546688982988,3374400.0
2374,BSESN,2013-02-27,19152.410156,19213.019531,18997.820313,19090.320313,8400.0,137.2695310000017,0.0,137.2695310000017,32.28756207047097,18976.939453,19742.419922,22.92294971669646,-77.07705028330354,-134.6152026527525,-80.16461189877216,-0.01768304634398965,3382800.0
2375,BSESN,2013-02-28,18861.539063,19322.279297,18793.970703,19264.800781,14800.0,-290.8710930000016,290.8710930000016,0.0,23.106525343126265,18793.970703,19742.419922,7.124088316635641,-92.87591168336435,-166.12963426744318,-97.35761637250639,-0.031159165910308095,3368000.0
2376,BSESN,2013-03-01,18918.519531,18988.970703,18820.900391,18876.679688,8400.0,56.98046800000157,0.0,56.98046800000157,27.750247128465816,18793.970703,19742.419922,13.131839375788704,-86.8681606242113,-184.38176262348497,-114.76244562270212,-0.02987324520846457,3376400.0
2377,BSESN,2013-03-04,18877.960938,18930.859375,18760.410156,18920.900391,7600.0,-40.55859300000157,40.55859300000157,0.0,26.438879303282008,18760.410156,19742.419922,11.970429019134473,-88.02957098086553,-199.81608983550177,-131.77317446526206,-0.03859088120377607,3368800.0
2378,BSESN,2013-03-05,19143.169922,19164.039063,18943.619141,18943.619141,9400.0,265.2089840000008,0.0,265.2089840000008,45.77306825780874,18760.410156,19742.419922,38.97718528391901,-61.02281471608099,-188.47513277556573,-143.1135661273228,-0.02543330633439811,3378200.0
2379,BSESN,2013-03-06,19252.609375,19293.390625,19195.470703,19254.199219,9400.0,109.43945299999905,0.0,109.43945299999905,51.804466465964154,18760.410156,19742.419922,50.12162160106244,-49.87837839893757,-168.71169002176248,-148.23319090621075,-0.003764483681173436,3387600.0
2380,BSESN,2013-03-07,19413.539063,19465.519531,19212.919922,19222.050781,8800.0,160.92968800000014,0.0,160.92968800000014,59.45587017117614,18760.410156,19742.419922,66.50941055916128,-33.49058944083872,-138.46717497508507,-146.27998771998563,0.004997113847812207,3396400.0
2381,BSESN,2013-03-08,19683.230469,19706.029297,19477.609375,19478.669922,10000.0,269.6914059999981,0.0,269.6914059999981,68.97881977964995,18760.410156,19742.419922,93.97262073664523,-6.027379263354773,-91.67951199578238,-135.35989257514498,0.018184702214189885,3406400.0
2382,BSESN,2013-03-11,19646.210938,19754.660156,19602.710938,19679.880859,7400.0,-37.01953099999809,37.01953099999809,0.0,66.504772327746,18760.410156,19754.660156,89.09235926577807,-10.907640734221932,-56.93085530264216,-119.67408512064442,0.0331877804874241,3399000.0
2383,BSESN,2013-03-12,19564.919922,19697.839844,19505.75,19675.810547,7600.0,-81.29101599999922,81.29101599999922,0.0,60.964526718259336,18760.410156,19754.660156,80.91624500880053,-19.083754991199477,-35.54209301254377,-102.8476866990243,0.021538269212074468,3391400.0
2384,BSESN,2013-03-13,19362.550781,19511.970703,19338.519531,19511.970703,8200.0,-202.3691409999992,202.3691409999992,0.0,49.19307946980927,18760.410156,19754.660156,60.56229570027659,-39.43770429972341,-34.5228848819861,-89.18272633561666,0.026562610629310646,3383200.0
2385,BSESN,2013-03-14,19570.439453,19604.699219,19179.330078,19367.259766,11200.0,207.88867199999734,0.0,207.88867199999734,58.65554603911203,18760.410156,19754.660156,81.471390193613,-18.528609806386996,-16.747225077338953,-74.69562608396113,0.03445935190286731,3394400.0
2386,BSESN,2013-03-15,19427.560547,19673.160156,19383.130859,19570.009766,10200.0,-142.8789059999981,142.8789059999981,0.0,51.10724588215805,18760.410156,19754.660156,67.10086909730944,-32.89913090269055,-14.027322004440066,-62.561965268056916,0.029113293051353573,3384200.0
2387,BSESN,2013-03-18,19293.199219,19345.419922,19232.230469,19282.630859,7400.0,-134.36132800000271,134.36132800000271,0.0,44.84527746376926,18760.410156,19754.660156,53.58703173246131,-46.412968267538695,-22.454770867501793,-54.540526387945896,0.007837223281791816,3376800.0
2388,BSESN,2013-03-19,19008.099609,19378.609375,18939.470703,19345.910156,12600.0,-285.0996099999975,285.0996099999975,0.0,34.49678185431003,18760.410156,19754.660156,24.91219039476983,-75.08780960523018,-51.54456697540081,-53.94133450543688,-0.012700084504778886,3364200.0
2389,BSESN,2013-03-20,18884.189453,19028.089844,18836.769531,19026.460938,11000.0,-123.91015600000172,123.91015600000172,0.0,30.9187764599464,18760.410156,19754.660156,12.44951440784484,-87.55048559215516,-83.63288614853445,-59.8796448340564,-0.027267032985700212,3353200.0
2390,BSESN,2013-03-21,18792.869141,19082.289063,18756.650391,18926.210938,12400.0,-91.32031199999984,91.32031199999984,0.0,28.41275839890602,18756.650391,19754.660156,3.62909775737514,-96.37090224262485,-115.10503704316943,-70.92472327587902,-0.04523451216009833,3340800.0
2391,BSESN,2013-03-22,18735.599609,18859.820313,18669.199219,18784.929688,13600.0,-57.269531999998435,57.269531999998435,0.0,26.838677108221432,18669.199219,19754.660156,6.117252840394229,-93.88274715960577,-143.01947648434725,-85.34367391757267,-0.04635048111178941,3327200.0
2392,BSESN,2013-03-25,18681.419922,18950.220703,18654.609375,18894.130859,12200.0,-54.17968699999983,54.17968699999983,0.0,25.308170282411453,18654.609375,19754.660156,2.437209941856394,-97.5627900581436,-167.58193852533077,-101.79132683912431,-0.04515735323846315,3315000.0
2393,BSESN,2013-03-26,18704.529297,18758.880859,18612.369141,18645.089844,12000.0,23.109375,0.0,23.109375,27.34721178909699,18612.369141,19754.660156,8.068010234677503,-91.9319897653225,-183.0727841297994,-118.04761829725935,-0.03398423541621909,3327000.0
2394,BSESN,2013-03-28,18835.769531,18882.539063,18568.429688,18702.460938,14600.0,131.24023400000078,0.0,131.24023400000078,38.37173060543427,18568.429688,19754.660156,22.536922647985907,-77.4630773520141,-182.65388057626842,-130.96887075306117,-0.03753977644520279,3341600.0
2395,BSESN,2013-04-01,18864.75,18959.480469,18796.599609,18890.810547,8400.0,28.980468999998266,0.0,28.980468999998266,40.66576042107125,18568.429688,19754.660156,24.979995034152118,-75.02000496584789,-177.93232179699407,-140.36156096184774,-0.028969697231848834,3350000.0
2396,BSESN,2013-04-02,19040.949219,19060.509766,18826.529297,18863.820313,8200.0,176.1992189999983,0.0,176.1992189999983,52.9517251822891,18568.429688,19697.839844,41.837726399903104,-58.162273600096896,-158.14959791240835,-143.91916835195988,-0.01307455529467516,3358200.0
2397,BSESN,2013-04-03,18801.640625,19035.199219,18721.720703,19034.0,7800.0,-239.3085939999983,239.3085939999983,0.0,39.978846275491655,18568.429688,19673.160156,21.110211382347742,-78.88978861765226,-159.93818244827708,-147.12297117122333,-0.010861632054066317,3350400.0
2398,BSESN,2013-04-04,18509.699219,18733.619141,18473.849609,18731.380859,8400.0,-291.94140600000173,291.94140600000173,0.0,29.72716578742093,18473.849609,19673.160156,2.9891849187579482,-97.01081508124206,-182.80561089719413,-154.2594991164175,-0.019830887363847527,3342000.0
2399,BSESN,2013-04-05,18450.230469,18525.449219,18389.289063,18493.669922,8000.0,-59.46875,59.46875,0.0,28.03733742541246,18389.289063,19673.160156,4.746691964034898,-95.2533080359651,-203.38237836119515,-164.08407496537302,-0.018232376835555897,3334000.0
2400,BSESN,2013-04-08,18437.779297,18504.480469,18402.929688,18455.800781,7600.0,-12.451171999997316,12.451171999997316,0.0,27.657522787738927,18389.289063,19378.609375,4.901368486205789,-95.0986315137942,-218.17928535594183,-174.9031170434868,-0.01589595840086888,3326400.0
2401,BSESN,2013-04-09,18226.480469,18565.560547,18206.609375,18481.470703,10600.0,-211.29882800000266,211.29882800000266,0.0,21.859183462199297,18206.609375,19378.609375,1.6954858361773264,-98.30451416382267,-244.14167699734026,-188.7508290342575,-0.02435250933277544,3315800.0
2402,BSESN,2013-04-10,18414.449219,18461.439453,18173.310547,18355.140625,8000.0,187.96875,0.0,187.96875,35.696750564017776,18173.310547,19082.289063,26.528533706290318,-73.47146629370968,-246.70568267652925,-200.34179976271187,-0.015508547335993605,3323800.0
2403,BSESN,2013-04-11,18542.199219,18599.140625,18397.939453,18577.519531,8400.0,127.75,0.0,127.75,43.53761865867522,18173.310547,19082.289063,40.58277126540993,-59.41722873459007,-235.71217507274196,-207.41587482471795,-0.01558578806758304,3332200.0
2404,BSESN,2013-04-12,18242.560547,18337.910156,18186.099609,18275.660156,9400.0,-299.6386719999973,299.6386719999973,0.0,32.73501141604845,18173.310547,19060.509766,7.805462236323287,-92.1945377636767,-248.3156495019939,-215.59582976017316,-0.03298159016154467,3322800.0
2405,BSESN,2013-04-15,18357.800781,18424.400391,18144.220703,18196.089844,9200.0,115.24023400000078,0.0,115.24023400000078,39.40679588673986,18144.220703,19060.509766,23.309246680378923,-76.69075331962108,-246.16740539383318,-221.71014488690514,-0.03587785620048378,3332000.0
2406,BSESN,2013-04-16,18744.929688,18771.330078,18325.730469,18356.320313,9400.0,387.1289069999984,0.0,387.1289069999984,56.23336207503544,18144.220703,19060.509766,65.55889503179642,-34.441104968203575,-210.79690354961713,-219.52749661944753,-0.0030162759799052807,3341400.0
2407,BSESN,2013-04-17,18731.160156,18869.880859,18673.439453,18773.449219,11000.0,-13.769531999998437,13.769531999998437,0.0,55.599703176525246,18144.220703,19060.509766,64.0561452385253,-35.943854761474704,-181.78115219532265,-211.97822773462255,0.011964588639705065,3330400.0
2408,BSESN,2013-04-18,19016.460938,19058.800781,18691.609375,18695.339844,10000.0,285.30078199999843,0.0,285.30078199999843,65.02253616296463,18144.220703,19060.509766,95.19269302901206,-4.807306970987936,-134.21739684713975,-196.42606155712602,0.030689614959085842,3340400.0
2409,BSESN,2013-04-22,19169.830078,19204.900391,18989.779297,18989.779297,8600.0,153.36913999999888,0.0,153.36913999999888,69.09127353762365,18144.220703,19204.900391,96.69360001923594,-3.306399980764048,-83.18822810600614,-173.77849486690207,0.03970384769271584,3349000.0
2410,BSESN,2013-04-23,19179.359375,19210.259766,19042.080078,19210.259766,8400.0,9.529297000000954,0.0,9.529297000000954,69.3469062585563,18144.220703,19210.259766,97.10138285992629,-2.8986171400737137,-41.49992431046121,-147.3227807556139,0.0522799180906417,3357400.0
2411,BSESN,2013-04-25,19406.849609,19434.849609,19192.109375,19192.109375,10200.0,227.4902340000008,0.0,227.4902340000008,75.03446622641863,18144.220703,19434.849609,97.8305150403938,-2.169484959606194,9.782154871922103,-115.9017936301067,0.0538924829191223,3367600.0
2412,BSESN,2013-04-26,19286.720703,19384.949219,19249.75,19376.0,9600.0,-120.12890600000172,120.12890600000172,0.0,67.41316599250729,18144.220703,19434.849609,88.52273451250274,-11.477265487497267,40.266011816846,-84.66823254071615,0.04015281441033691,3358000.0
2413,BSESN,2013-04-29,19387.5,19428.939453,19284.400391,19306.669922,9200.0,100.77929700000095,0.0,100.77929700000095,70.33028016843686,18144.220703,19434.849609,96.3312762654023,-3.668723734597706,71.7298777102551,-53.38861049052189,0.06276199276138805,3367200.0
2414,BSESN,2013-04-30,19504.179688,19622.679688,19317.380859,19492.830078,13400.0,116.67968800000016,0.0,116.67968800000016,73.4994009546803,18144.220703,19622.679688,91.98489770752755,-8.015102292472449,104.8714015673686,-21.736608078943785,0.06244641831969755,3380600.0
2415,BSESN,2013-05-02,19735.769531,19792.0,19451.259766,19459.330078,9400.0,231.5898430000016,0.0,231.5898430000016,78.70793286674795,18144.220703,19792.0,96.5874999702707,-3.412500029729299,148.11627067972222,12.233967672789426,0.05285908560298891,3390000.0
2416,BSESN,2013-05-03,19575.640625,19744.849609,19542.630859,19707.949219,11600.0,-160.1289060000017,160.1289060000017,0.0,68.03911228154266,18144.220703,19792.0,86.8696387074464,-13.130361292553602,167.5358278169806,43.29433970162767,0.045084258634641605,3378400.0
2417,BSESN,2013-05-06,19673.640625,19694.289063,19554.310547,19571.660156,7800.0,98.0,0.0,98.0,70.83115104002448,18144.220703,19792.0,92.81703713504055,-7.182962864959452,188.6590041744712,72.36727259619639,0.034558464329541794,3386200.0
2418,BSESN,2013-05-07,19888.949219,19917.880859,19697.330078,19697.330078,8200.0,215.3085939999983,0.0,215.3085939999983,76.11959087957852,18144.220703,19917.880859,98.36881716589666,-1.6311828341033383,220.23415549530546,101.94064917601821,0.037513068090534896,3394400.0
2419,BSESN,2013-05-08,19990.179688,20037.269531,19851.220703,19950.220703,6200.0,101.2304690000019,0.0,101.2304690000019,78.25806617250437,18325.730469,20037.269531,97.2486842955851,-2.7513157044149,250.53809601737885,131.66013854429036,0.04227567235936425,3400600.0
2420,BSESN,2013-05-09,19939.039063,20058.480469,19903.830078,20015.859375,5800.0,-51.140625,51.140625,0.0,74.37570225018163,18673.439453,20058.480469,91.376327154199,-8.623672845800993,267.3457705458677,158.79726494460584,0.02742276385514919,3394800.0
2421,BSESN,2013-05-10,20082.619141,20119.140625,19908.800781,19911.080078,8000.0,143.58007799999902,0.0,143.58007799999902,77.92360246632049,18691.609375,20119.140625,97.44163330925325,-2.558366690746755,288.9211825035636,184.82204845639743,0.04126665441244248,3402800.0
2422,BSESN,2013-05-13,19691.669922,20109.080078,19667.390625,20073.410156,6600.0,-390.9492189999983,390.9492189999983,0.0,54.302001307382085,18989.779297,20119.140625,62.14934118941255,-37.850658810587454,271.34561391767056,202.12676154865207,0.015688970831721605,3396200.0
2423,BSESN,2013-05-14,19722.289063,19831.789063,19652.689453,19715.800781,7200.0,30.619140999999214,0.0,30.619140999999214,55.52048825426825,19042.080078,20119.140625,63.15420120945164,-36.84579879054835,256.9258763997459,213.08658451887084,0.011182699220833703,3403400.0
2424,BSESN,2013-05-15,20212.960938,20241.960938,19798.179688,19798.179688,9200.0,490.671875,0.0,490.671875,70.20848026576772,19192.109375,20241.960938,97.23770473635996,-2.762295263640046,281.84234698941145,226.837737012979,0.02417901193315264,3412600.0
2425,BSESN,2013-05-16,20247.330078,20326.480469,20162.119141,20167.929688,9600.0,34.36913999999888,0.0,34.36913999999888,70.9829094102031,19249.75,20326.480469,92.64900610888171,-7.350993891118293,300.89361748570445,241.6489131075241,0.03431251451062023,3422200.0
2426,BSESN,2013-05-17,20286.119141,20328.189453,20155.009766,20267.599609,8000.0,38.78906300000017,0.0,38.78906300000017,71.93301806865009,19284.400391,20328.189453,95.96946226669697,-4.030537733303038,315.4851236980685,256.41615522563296,0.031131935754773465,3430200.0
2427,BSESN,2013-05-20,20223.980469,20443.619141,20186.660156,20277.759766,6800.0,-62.13867200000095,62.13867200000095,0.0,67.82787580633334,19317.380859,20443.619141,80.49802821389078,-19.501971786109227,318.3650122952422,268.8059266395548,0.01684509555084701,3423400.0
2428,BSESN,2013-05-21,20111.609375,20308.039063,20072.679688,20227.169922,15600.0,-112.37109399999828,112.37109399999828,0.0,60.61036597011768,19451.259766,20443.619141,66.54339401993363,-33.45660598006637,308.02916808738155,276.6505749291202,0.0060744670080625784,3407800.0
2429,BSESN,2013-05-22,20062.240234,20220.349609,20000.859375,20150.689453,7600.0,-49.36914099999922,49.36914099999922,0.0,57.50824892146365,19542.630859,20443.619141,57.67104693599122,-42.328953064008786,292.4827014847833,279.8170002402528,0.006178892102609801,3400200.0
2430,BSESN,2013-05-23,19674.330078,20027.560547,19634.789063,19971.369141,15600.0,-387.9101560000017,387.9101560000017,0.0,39.281109764465256,19554.310547,20443.619141,13.495824937456788,-86.50417506254321,246.02488527494643,273.0585772471915,-0.02033046885634804,3384600.0
2431,BSESN,2013-05-24,19704.330078,19833.140625,19568.490234,19765.320313,11000.0,30.0,0.0,30.0,40.951190710685,19568.490234,20443.619141,15.522266824171826,-84.47773317582818,209.2157713182387,260.29001606140093,0.000642919368958772,3395600.0
2432,BSESN,2013-05-27,20030.769531,20083.470703,19678.310547,19750.669922,8200.0,326.4394530000027,0.0,326.4394530000027,56.108533724446346,19568.490234,20443.619141,52.82413748446796,-47.17586251553204,204.0332506932573,249.0386629877722,0.015641210156417618,3403800.0
2433,BSESN,2013-05-28,20160.820313,20209.820313,19963.230469,20056.279297,8600.0,130.05078199999843,0.0,130.05078199999843,60.740972659685184,19568.490234,20443.619141,67.68489467803633,-32.31510532196368,208.02212739228344,240.83535586867447,-0.002579563932267659,3412400.0
2434,BSESN,2013-05-29,20147.640625,20216.490234,20044.740234,20202.509766,8000.0,-13.17968800000017,13.17968800000017,0.0,60.000473854507284,19568.490234,20443.619141,66.1788664924081,-33.8211335075919,207.72532203234368,234.2133491014083,-0.0049235851154675325,3404400.0
2435,BSESN,2013-05-30,20215.400391,20254.029297,20066.140625,20066.939453,9600.0,67.75976599999922,0.0,67.75976599999922,62.69813757222979,19568.490234,20443.619141,73.92169905775945,-26.078300942240546,210.53087954199873,229.4768551895264,-0.0034860659896781554,3414000.0
2436,BSESN,2013-05-31,19760.300781,20191.289063,19730.550781,20186.669922,9400.0,-455.0996099999975,455.0996099999975,0.0,41.17684002056156,19568.490234,20443.619141,21.91797636505239,-78.08202363494762,174.02551121432043,218.38658639448522,-0.022927221904250783,3404600.0
2437,BSESN,2013-06-03,19610.480469,19860.189453,19541.970703,19859.220703,7400.0,-149.82031200000347,149.82031200000347,0.0,36.427286618545594,19541.970703,20443.619141,7.5982792308679405,-92.40172076913206,131.48976457339086,201.00722203026635,-0.02491739455833586,3397200.0
2438,BSESN,2013-06-04,19545.779297,19742.699219,19522.470703,19605.679688,6000.0,-64.70117199999731,64.70117199999731,0.0,34.447377389012146,19522.470703,20443.619141,2.5303841420617923,-97.46961585793821,91.50423123848668,179.10662387191044,-0.025742934536529982,3391200.0
2439,BSESN,2013-06-05,19568.220703,19604.429688,19441.349609,19532.419922,5600.0,22.441405999998093,0.0,22.441405999998093,35.842938137821236,19441.349609,20443.619141,12.658380799706725,-87.34161920029328,60.923948548883345,155.47008880730505,-0.005393290372750825,3396800.0
2440,BSESN,2013-06-06,19519.490234,19635.369141,19395.320313,19503.679688,6600.0,-48.73046899999825,48.73046899999825,0.0,34.02787419982721,19395.320313,20443.619141,11.844897436058254,-88.15510256394174,32.383416737382504,130.85275439332054,-0.009380671317842593,3390200.0
2441,BSESN,2013-06-07,19429.230469,19711.550781,19397.509766,19522.310547,7000.0,-90.25976500000252,90.25976500000252,0.0,30.704827107854726,19395.320313,20308.039063,3.7152908275411347,-96.28470917245888,2.453350255582336,105.17287356577289,-0.030030751493049235,3383200.0
2442,BSESN,2013-06-10,19441.070313,19585.75,19366.820313,19530.349609,6400.0,11.839844000001905,0.0,11.839844000001905,31.714154493554787,19366.820313,20254.029297,8.3689414037764,-91.6310585962236,-20.079601458139223,80.12237856099047,-0.03570043226544184,3389600.0
2443,BSESN,2013-06-11,19143.0,19418.740234,19121.179688,19382.220703,14200.0,-298.07031300000017,298.07031300000017,0.0,22.285158491984944,19121.179688,20254.029297,1.9261437552387253,-98.07385624476127,-61.282484875355294,51.841405873721314,-0.04986393413000434,3375400.0
2444,BSESN,2013-06-12,19041.130859,19143.240234,18969.080078,19103.960938,10800.0,-101.86914099999922,101.86914099999922,0.0,19.946576947922253,18969.080078,20254.029297,5.607286259613784,-94.39271374038621,-100.99188358827087,21.274747981322875,-0.05808786911402408,3364600.0
2445,BSESN,2013-06-13,18827.160156,18914.130859,18765.529297,18897.490234,13200.0,-213.97070299999905,213.97070299999905,0.0,15.902185508080223,18765.529297,20254.029297,4.140467517635256,-95.85953248236474,-148.02121918855119,-12.584445452651947,-0.04722299702529009,3351400.0
2446,BSESN,2013-06-14,19177.929688,19213.099609,18952.089844,18959.830078,10400.0,350.7695319999985,0.0,350.7695319999985,39.21507664739175,18765.529297,20254.029297,27.7057703056768,-72.29422969432319,-155.1990981552808,-41.107375993177726,-0.022057123061506312,3361800.0
2447,BSESN,2013-06-17,19325.869141,19344.279297,19084.679688,19249.900391,7000.0,147.93945299999902,0.0,147.93945299999902,46.44042221337344,18765.529297,20254.029297,37.64459818609326,-62.35540181390673,-147.25270396504857,-62.3364415875519,-0.011251030345654,3368800.0
2448,BSESN,2013-06-18,19223.279297,19383.609375,19191.369141,19329.169922,8600.0,-102.58984399999828,102.58984399999828,0.0,42.40704340782346,18765.529297,20254.029297,30.752435337588174,-69.24756466241182,-147.53260827794657,-79.37567492563085,-0.017627632641485702,3360200.0
2449,BSESN,2013-06-19,19245.699219,19274.259766,19100.130859,19224.089844,10400.0,22.419921999997314,0.0,22.419921999997314,43.64131668224457,18765.529297,20191.289063,33.6781787121911,-66.3218212878089,-144.2821394373059,-92.35696782796586,-0.014026545351225383,3370600.0
2450,BSESN,2013-06-20,18719.289063,19069.199219,18687.189453,19069.199219,14200.0,-526.4101559999981,526.4101559999981,0.0,27.6105316722968,18687.189453,19860.189453,2.7365396419438297,-97.26346035805618,-182.08406786771957,-110.30238783591662,-0.03653986230348827,3356400.0
2451,BSESN,2013-06-21,18774.240234,18820.810547,18615.140625,18695.800781,14600.0,54.95117100000061,0.0,54.95117100000061,30.677651955784796,18615.140625,19742.699219,14.110096792007692,-85.88990320799232,-205.24236205259876,-129.29038267925307,-0.03430007032864335,3371000.0
2452,BSESN,2013-06-24,18540.890625,18714.060547,18467.160156,18714.060547,11200.0,-233.3496090000008,233.3496090000008,0.0,25.403757721033898,18467.160156,19711.550781,5.925026074509222,-94.07497392549078,-239.66216406009698,-151.36473895542187,-0.031453240087760514,3359800.0
2453,BSESN,2013-06-25,18629.150391,18802.310547,18487.300781,18602.25,10800.0,88.25976599999922,0.0,88.25976599999922,30.609837348623884,18467.160156,19711.550781,13.017635439032457,-86.98236456096754,-256.85738755816055,-172.46326867596963,-0.02163634455593666,3370600.0
2454,BSESN,2013-06-26,18552.119141,18690.5,18514.349609,18662.369141,9200.0,-77.03125,77.03125,0.0,28.599779221790712,18467.160156,19711.550781,6.827356562574351,-93.17264343742565,-273.5472220645315,-192.68005935368203,-0.014608736140822032,3361400.0
2455,BSESN,2013-06-27,18875.949219,18925.75,18688.279297,18716.109375,10000.0,323.83007799999905,0.0,323.83007799999905,45.84848011197028,18467.160156,19585.75,36.54503616251294,-63.45496383748706,-257.6733571556797,-205.67871891408157,-0.015746249668907586,3371400.0
2456,BSESN,2013-06-28,19395.810547,19432.939453,19093.179688,19093.179688,14000.0,519.8613280000027,0.0,519.8613280000027,62.589145043231575,18467.160156,19432.939453,96.15554960482879,-3.844450395171206,-200.82970056719932,-204.70891524470514,0.0036190561723106196,3385400.0
2457,BSESN,2013-07-01,19577.390625,19598.429688,19347.570313,19352.480469,8600.0,181.58007799999905,0.0,181.58007799999905,66.73384632996519,18467.160156,19598.429688,98.14022543656729,-1.8597745634327045,-139.5203941623513,-191.67121102823438,0.018420963589456996,3394000.0
2458,BSESN,2013-07-02,19463.820313,19589.140625,19442.75,19573.929688,9200.0,-113.57031199999984,113.57031199999984,0.0,61.793231082058135,18467.160156,19598.429688,88.10103417511644,-11.898965824883561,-98.9558012792113,-173.1281290784298,0.011333498020413169,3384800.0
2459,BSESN,2013-07-03,19177.759766,19347.109375,19147.310547,19347.109375,9600.0,-286.06054700000095,286.06054700000095,0.0,50.85163141885203,18467.160156,19598.429688,62.8143505945671,-37.1856494054329,-88.86636842456574,-156.275776947657,0.024491886495102033,3375200.0
2460,BSESN,2013-07-04,19410.839844,19445.019531,19245.009766,19256.119141,9600.0,233.08007799999905,0.0,233.08007799999905,57.865710910775846,18467.160156,19598.429688,83.41775866018796,-16.582241339812036,-61.355537391162215,-137.29172903635805,0.0339081423304215,3384800.0
2461,BSESN,2013-07-05,19495.820313,19640.269531,19477.740234,19568.789063,10000.0,84.9804690000019,0.0,84.9804690000019,60.25208126824821,18467.160156,19640.269531,87.68663680656363,-12.31336319343638,-32.3231903377382,-116.29802129663408,0.05150398151383295,3394800.0
2462,BSESN,2013-07-08,19324.769531,19422.689453,19185.919922,19418.980469,8400.0,-171.05078199999843,171.05078199999843,0.0,53.247883897048,18467.160156,19640.269531,73.10566203598876,-26.89433796401124,-22.85377066525325,-97.60917117035791,0.03734035774041877,3386400.0
2463,BSESN,2013-07-09,19439.480469,19486.0,19380.25,19399.369141,6600.0,114.7109379999965,0.0,114.7109379999965,57.106287322596785,18467.160156,19640.269531,82.8840288655946,-17.115971134405388,-6.023537740482425,-79.29204448438281,0.04783072603490024,3393000.0
2464,BSESN,2013-07-10,19294.119141,19505.929688,19237.910156,19482.660156,7800.0,-145.36132799999902,145.36132799999902,0.0,50.95728571910998,18467.160156,19640.269531,70.49291418372626,-29.507085816273737,-4.3645889619256195,-64.30655337989137,0.022153583756152617,3385200.0
2465,BSESN,2013-07-11,19676.060547,19723.509766,19468.460938,19468.460938,8400.0,381.9414060000017,0.0,381.9414060000017,63.02708692585114,18467.160156,19723.509766,96.22324720584756,-3.7767527941524466,27.45315644533912,-45.95461141484527,0.014448996566598593,3393600.0
2466,BSESN,2013-07-12,19958.470703,19991.939453,19785.589844,19898.689453,7600.0,282.41015599999815,0.0,282.41015599999815,69.44311399883588,18487.300781,19991.939453,97.77562875241584,-2.224371247584155,74.59717846589774,-21.84425343869666,0.019465315133129435,3401200.0
2467,BSESN,2013-07-15,20034.480469,20072.439453,19883.189453,19926.099609,7000.0,76.00976599999922,0.0,76.00976599999922,71.00565974469473,18514.349609,20072.439453,97.56374870510992,-2.43625129489008,116.74672487556381,5.873942224155441,0.029319020974461596,3408200.0
2468,BSESN,2013-07-16,19851.230469,19890.630859,19649.580078,19788.089844,8000.0,-183.25,183.25,0.0,62.16308569247515,18688.279297,20072.439453,84.01854127637517,-15.981458723624833,133.82119314666124,31.463392408656613,0.03511727705516399,3400200.0
2469,BSESN,2013-07-17,19948.730469,19983.220703,19778.539063,19928.949219,10400.0,97.5,0.0,97.5,64.85037815897779,19093.179688,20072.439453,87.36709212187422,-12.632907878125774,153.45137548844286,55.86098902461387,0.027710837311671677,3410600.0
2470,BSESN,2013-07-18,20128.410156,20176.900391,19956.199219,19999.509766,9800.0,179.67968700000347,0.0,179.67968700000347,69.46226201073604,19147.310547,20176.900391,95.29033475975142,-4.709665240248579,181.4158366794254,80.97195855557618,0.032447459652579225,3420400.0
2471,BSESN,2013-07-19,20149.849609,20256.599609,20111.130859,20213.449219,11600.0,21.439452999999045,0.0,21.439452999999045,70.0041156564111,19147.310547,20256.599609,90.37671931899027,-9.623280681009728,202.9681676332766,105.37120037111627,0.04269546794213719,3432000.0
2472,BSESN,2013-07-22,20159.119141,20264.900391,20065.689453,20096.710938,9400.0,9.269531999998437,0.0,9.269531999998437,70.26730687669118,19147.310547,20264.900391,90.5348773015514,-9.465122698448587,218.28031930785437,127.9530241584639,0.03701943954457043,3441400.0
2473,BSESN,2013-07-23,20302.130859,20351.060547,20249.980469,20249.980469,7800.0,143.01171800000157,0.0,143.01171800000157,74.28404970946079,19185.919922,20351.060547,95.80053369094395,-4.1994663090560564,239.19783650807585,150.2019866283863,0.05224450572910455,3449200.0
2474,BSESN,2013-07-24,20090.679688,20252.699219,19994.25,20200.199219,8000.0,-211.4511710000006,211.4511710000006,0.0,60.370161906165414,19185.919922,20351.060547,77.65240921026158,-22.34759078973843,235.99240373323119,167.36007004935527,0.021072263932589763,3441200.0
2475,BSESN,2013-07-25,19804.759766,20110.810547,19763.900391,20062.0,12800.0,-285.91992200000095,285.91992200000095,0.0,46.71756294140063,19185.919922,20351.060547,53.11288875538077,-46.88711124461923,207.98322583005574,175.48470120549538,-0.007701538824660292,3428400.0
2476,BSESN,2013-07-26,19748.189453,19907.449219,19699.759766,19892.470703,11000.0,-56.57031300000017,56.57031300000017,0.0,44.42403986248839,19237.910156,20351.060547,45.84100235922189,-54.15899764077812,179.15580249474442,176.2189214633452,-0.014289914652041324,3417400.0
2477,BSESN,2013-07-29,19593.279297,19751.029297,19570.869141,19714.419922,9900.0,-154.9101559999981,154.9101559999981,0.0,38.45844362202325,19237.910156,20351.060547,31.924629760112932,-68.07537023988706,142.1710475226937,169.40934667521492,-0.012994215769285389,3407500.0
2478,BSESN,2013-07-30,19348.339844,19672.720703,19328.539063,19577.75,9500.0,-244.93945300000266,244.93945300000266,0.0,30.89036541818288,19328.539063,20351.060547,1.9364660117007457,-98.06353398829926,92.03487518250768,153.93445237667348,-0.03009668339210847,3398000.0
2479,BSESN,2013-07-31,19345.699219,19387.5,19126.820313,19304.070313,13900.0,-2.640625,2.640625,0.0,30.814934213274213,19126.820313,20351.060547,17.87875450595573,-82.12124549404427,51.49491964324989,133.44654582998876,-0.038885879755718666,3384100.0
2480,BSESN,2013-08-01,19317.189453,19569.199219,19170.460938,19443.289063,10600.0,-28.509765999999214,28.509765999999214,0.0,29.90521014137191,19126.820313,20351.060547,15.549982324792532,-84.45001767520746,16.87172619632838,110.13158190325669,-0.04132339308518174,3373500.0
2481,BSESN,2013-08-02,19164.019531,19451.699219,19078.720703,19399.550781,8600.0,-153.1699219999973,153.1699219999973,0.0,25.278903467985955,19078.720703,20351.060547,6.704091552445524,-93.29590844755448,-22.665661036404344,83.57213331532448,-0.04936225650733639,3364900.0
2482,BSESN,2013-08-05,19182.259766,19306.509766,19141.679688,19178.060547,12000.0,18.240234999997483,0.0,18.240234999997483,26.83415555947903,19078.720703,20351.060547,8.137689272898383,-91.86231072710162,-51.92888686220613,56.471929279818355,-0.055160273607612886,3376900.0
2483,BSESN,2013-08-06,18733.039063,19131.919922,18667.300781,19127.099609,13800.0,-449.22070299999916,449.22070299999916,0.0,16.861208741866136,18667.300781,20351.060547,3.904255424523457,-96.09574457547654,-110.09940321162503,23.15766278152967,-0.0675756443327753,3363100.0
2484,BSESN,2013-08-07,18664.880859,18811.460938,18551.349609,18758.529297,12800.0,-68.15820399999939,68.15820399999939,0.0,15.831167095151102,18551.349609,20351.060547,6.308304717321221,-93.69169528267878,-159.85702171659432,-13.445274118095139,-0.05755580579961872,3350300.0
2485,BSESN,2013-08-08,18789.339844,18829.259766,18621.669922,18687.300781,11900.0,124.45898499999748,0.0,124.45898499999748,25.429369777015822,18551.349609,20351.060547,13.223803332799294,-86.7761966672007,-187.09082633767684,-48.1743845620115,-0.0485537983764045,3362200.0
2486,BSESN,2013-08-12,18946.980469,19066.970703,18796.009766,18898.939453,11700.0,157.640625,0.0,157.640625,36.08188934179607,18551.349609,20351.060547,21.98302247580147,-78.01697752419852,-193.72044304835435,-77.28359625928009,-0.03298574057988135,3373900.0
2487,BSESN,2013-08-13,19229.839844,19248.109375,18864.810547,18895.259766,11900.0,282.859375,0.0,282.859375,50.67121663904644,18551.349609,20252.699219,39.87953040410069,-60.12046959589931,-174.14266619149203,-96.65541024572249,-0.006124556471275078,3385800.0
2488,BSESN,2013-08-14,19367.589844,19392.560547,19203.630859,19299.419922,14700.0,137.75,0.0,137.75,56.278761203101844,18551.349609,20110.810547,52.341178615658116,-47.658821384341884,-145.8308163327929,-106.49049146313659,0.0011315499508284255,3400500.0
2489,BSESN,2013-08-16,18598.179688,19310.949219,18559.650391,19297.109375,14300.0,-769.4101559999982,769.4101559999982,0.0,32.48163780537904,18551.349609,19907.449219,3.453291974621206,-96.54670802537879,-183.36472628016418,-121.86533842654212,-0.037221241048000175,3386200.0
2490,BSESN,2013-08-19,18307.519531,18587.380859,18139.150391,18587.380859,14300.0,-290.66015699999843,290.66015699999843,0.0,27.426570573857134,18139.150391,19751.029297,10.445520403131471,-89.55447959686853,-233.86857450354364,-144.26598564194245,-0.04469312915354284,3371900.0
2491,BSESN,2013-08-20,18246.039063,18306.460938,17970.980469,18142.830078,18200.0,-61.48046800000157,61.48046800000157,0.0,26.422949261457717,17970.980469,19672.720703,16.163371383273166,-83.83662861672684,-275.6763724164048,-170.54806299683494,-0.048806590799037264,3353700.0
2492,BSESN,2013-08-21,17905.910156,18567.699219,17807.189453,18545.439453,17400.0,-340.12890699999843,340.12890699999843,0.0,21.41957020608008,17807.189453,19569.199219,5.602733021401582,-94.39726697859841,-332.4229488619094,-202.92304016984986,-0.04415348220960458,3336300.0
2493,BSESN,2013-08-22,18312.939453,18349.820313,17759.589844,17896.839844,19800.0,407.0292969999973,0.0,407.0292969999973,37.70696547107326,17759.589844,19569.199219,30.578400877261192,-69.42159912273881,-340.6246480387381,-230.46336174362753,-0.018855807795328028,3356100.0
2494,BSESN,2013-08-23,18519.439453,18546.599609,18210.75,18386.529297,19200.0,206.5,0.0,206.5,44.447344971498666,17759.589844,19451.699219,44.90546652754056,-55.09453347245944,-326.6957838833914,-249.70984617158032,-0.014364548900646312,3375300.0
2495,BSESN,2013-08-26,18558.130859,18728.189453,18488.929688,18602.560547,17200.0,38.69140600000173,0.0,38.69140600000173,45.71718663522024,17759.589844,19392.560547,48.90112318199999,-51.09887681800001,-308.97333332426206,-261.5625436021167,-0.02052303851984283,3392500.0
2496,BSESN,2013-08-27,17968.080078,18460.720703,17921.820313,18460.720703,17800.0,-590.0507810000017,590.0507810000017,0.0,32.60335013364531,17759.589844,19392.560547,12.767542835702695,-87.2324571642973,-338.6367368312167,-276.9773822479367,-0.06561467886554906,3374700.0
2497,BSESN,2013-08-28,17996.150391,18101.839844,17448.710938,17851.439453,21400.0,28.070313000000173,0.0,28.070313000000173,33.64809308386165,17448.710938,19392.560547,28.162644397249707,-71.83735560275029,-355.7789597744886,-292.7376977532471,-0.0708110541397522,3396100.0
2498,BSESN,2013-08-29,18401.039063,18455.660156,18071.220703,18073.660156,18600.0,404.8886720000009,0.0,404.8886720000009,47.2557297711656,17448.710938,19392.560547,48.99186236377197,-51.00813763622802,-332.85620380383625,-300.76139896336497,-0.01059999571502146,3414700.0
2499,BSESN,2013-08-30,18619.720703,18679.259766,18272.759766,18424.720703,18600.0,218.6816399999989,0.0,218.6816399999989,53.23288432122783,17448.710938,19392.560547,60.24178823187953,-39.75821176812046,-293.6588572877554,-299.3408906282431,0.01705316613052621,3433300.0
2500,BSESN,2013-09-02,18886.130859,18942.060547,18678.929688,18691.830078,10800.0,266.41015600000173,0.0,266.41015600000173,59.65904696278722,17448.710938,19392.560547,73.94707462680051,-26.052925373199486,-238.3500536151878,-287.14272322563204,0.035081136995809725,3444100.0
2501,BSESN,2013-09-03,18234.660156,19007.310547,18166.169922,19002.769531,19400.0,-651.470702999999,651.470702999999,0.0,42.99111121438792,17448.710938,19392.560547,40.43261445541187,-59.56738554458813,-244.26987828635902,-278.56815423777743,0.01835985979689725,3424700.0
2502,BSESN,2013-09-04,18567.550781,18612.599609,18188.429688,18314.679688,14400.0,332.890625,0.0,332.890625,51.053786792689436,17448.710938,19310.949219,60.0803803903762,-39.91961960962381,-219.5688377491133,-266.7682909400446,0.01390335662133646,3439100.0
2503,BSESN,2013-09-05,18979.759766,19117.519531,18847.019531,18857.599609,13800.0,412.2089849999975,0.0,412.2089849999975,59.28170538189106,17448.710938,19117.519531,91.74502303152975,-8.254976968470247,-164.83119365014136,-246.38087148206395,0.024856060798613022,3452900.0
2504,BSESN,2013-09-06,19270.060547,19293.960938,18929.380859,19072.019531,15600.0,290.30078100000173,0.0,290.30078100000173,64.17534082203679,17448.710938,19293.960938,98.70476136024932,-1.2952386397506688,-96.90925983299894,-216.48654915225097,0.03836214397931892,3468500.0
2505,BSESN,2013-09-10,19997.099609,20012.689453,19444.660156,19448.390625,17800.0,727.0390619999997,0.0,727.0390619999997,73.40995179397852,17448.710938,20012.689453,99.39196666786428,-0.6080333321357131,15.407727560294006,-170.10769380974196,0.11292355789778119,3486300.0
2506,BSESN,2013-09-11,19997.449219,20055.529297,19777.630859,19999.769531,15700.0,0.3496099999974831,0.0,0.3496099999974831,73.4137542794172,17448.710938,20055.529297,97.77199367192263,-2.2280063280773708,103.25766973384088,-115.43462110102539,0.11120705175929535,3502000.0
2507,BSESN,2013-09-12,19781.880859,20052.050781,19676.490234,20046.050781,11900.0,-215.56835999999748,215.56835999999748,0.0,66.63429126364781,17448.710938,20055.529297,89.50258896807163,-10.497411031928369,153.71291001529244,-61.60511487776181,0.07504151212724386,3490100.0
2508,BSESN,2013-09-13,19732.759766,19899.369141,19675.679688,19744.539063,10600.0,-49.12109300000157,49.12109300000157,0.0,65.05476132975684,17448.710938,20055.529297,87.61825771689674,-12.381742283103264,187.5731631017261,-11.769459281864213,0.05977743064753205,3479500.0
2509,BSESN,2013-09-16,19742.470703,20086.429688,19596.150391,19977.380859,11200.0,9.710936999999829,0.0,9.710936999999829,65.24270042275671,17448.710938,20086.429688,86.95998256068805,-13.04001743931195,212.7389271540378,33.132218005316204,0.04534225937505454,3490700.0
2510,BSESN,2013-09-17,19804.029297,19819.099609,19635.439453,19721.900391,9900.0,61.5585940000019,0.0,61.5585940000019,66.55821022987914,17448.710938,20086.429688,89.29376412856756,-10.706235871432435,234.94197569469543,73.49416954319206,0.08606517081063392,3500600.0
2511,BSESN,2013-09-18,19962.160156,20013.330078,19775.289063,19865.990234,9300.0,158.13085900000078,0.0,158.13085900000078,69.93137444709288,18071.220703,20086.429688,93.83341713316157,-6.166582866838417,262.2745526117942,111.2502461569125,0.0751100342446398,3509900.0
2512,BSESN,2013-09-19,20646.640625,20739.689453,20347.300781,20354.730469,18300.0,684.4804689999983,0.0,684.4804689999983,80.00462849329,18166.169922,20739.689453,96.38437451594382,-3.6156254840561814,335.30251151138145,156.0606992278063,0.08782412841631548,3528200.0
2513,BSESN,2013-09-20,20263.710938,20677.990234,20051.429688,20616.349609,13500.0,-382.92968699999983,382.92968699999983,0.0,65.77959524816623,18166.169922,20739.689453,81.50476383542164,-18.495236164578355,358.14994004511755,196.4785473912686,0.051564466472560744,3514700.0
2514,BSESN,2013-09-23,19900.960938,20199.810547,19826.300781,20060.820313,11100.0,-362.75,362.75,0.0,55.075851805658225,18166.169922,20739.689453,67.40928114603847,-32.59071885396153,343.0315442804349,225.78914676910188,-0.004807630750447989,3503600.0
2515,BSESN,2013-09-24,19920.210938,20050.419922,19782.779297,19820.029297,10700.0,19.25,0.0,19.25,55.51904169969909,18188.429688,20739.689453,67.87945601454663,-32.120543985453374,328.8130684616044,246.39393110760238,-0.0038624066576757876,3514300.0
2516,BSESN,2013-09-25,19856.240234,19978.490234,19658.740234,19947.429688,13900.0,-63.97070399999939,63.97070399999939,0.0,53.495439869788754,18847.019531,20739.689453,53.32259425000787,-46.67740574999213,308.8230034017033,258.87974556642257,0.003758963848281782,3500400.0
2517,BSESN,2013-09-26,19893.849609,19997.279297,19826.990234,19853.660156,14900.0,37.609375,0.0,37.609375,54.617546091291,18929.380859,20739.689453,53.27648298177393,-46.72351701822607,292.64209911372745,265.63221627588354,0.008163573920236145,3515300.0
2518,BSESN,2013-09-27,19727.269531,19981.570313,19674.380859,19951.730469,11800.0,-166.58007799999902,166.58007799999902,0.0,48.62178671980519,19444.660156,20739.689453,21.822624063770547,-78.17737593622945,263.34136048225264,265.17404511715733,-0.0007699731319691372,3503500.0
2519,BSESN,2013-09-30,19379.769531,19651.310547,19320.730469,19643.890625,10000.0,-347.5,347.5,0.0,38.45942863903825,19320.730469,20739.689453,4.1607306952294145,-95.83926930477058,209.6631024606395,254.07185658585377,-0.021422901351911605,3493500.0
2520,BSESN,2013-10-01,19517.150391,19532.910156,19264.720703,19452.050781,9200.0,137.38085999999748,0.0,137.38085999999748,43.81609761291655,19264.720703,20739.689453,17.114239742367435,-82.88576025763257,176.17732101965885,238.49294947261478,-0.022292665799810596,3502700.0
2521,BSESN,2013-10-03,19902.070313,19929.240234,19583.970703,19585.789063,15700.0,384.9199220000009,0.0,384.9199220000009,56.154310384596144,19264.720703,20739.689453,43.21105853937591,-56.78894146062409,178.64016613547938,226.52239280518768,-0.03606254041630563,3518400.0
2522,BSESN,2013-10-04,19915.949219,20052.0,19833.169922,19870.0,12900.0,13.878905999998095,0.0,13.878905999998095,56.55127350250193,19264.720703,20739.689453,44.15202125468755,-55.84797874531245,179.64110946968867,217.14613613808785,-0.017161798254230587,3531300.0
2523,BSESN,2013-10-07,19895.099609,19921.380859,19647.880859,19880.939453,12300.0,-20.849609999997483,20.849609999997483,0.0,55.67751046438051,19264.720703,20739.689453,42.738458424966744,-57.26154157503325,176.71491544982564,209.05989200043538,-0.0002945249236084857,3519000.0
2524,BSESN,2013-10-08,19983.609375,20150.269531,19936.720703,20094.210938,10900.0,88.50976599999922,0.0,88.50976599999922,58.79591676472758,19264.720703,20739.689453,48.739247662026806,-51.260752337973194,179.4690762211576,203.14172884457986,0.003182618758271305,3529900.0
2525,BSESN,2013-10-09,20249.259766,20277.740234,19826.960938,19918.199219,10200.0,265.6503909999992,0.0,265.6503909999992,66.86856417405976,19264.720703,20739.689453,66.74982524206023,-33.250174757939774,200.7731470337858,202.66801248242106,0.019793250251224803,3540100.0
2526,BSESN,2013-10-10,20272.910156,20323.769531,20135.910156,20228.759766,10400.0,23.650390000002517,0.0,23.650390000002517,67.52220330106184,19264.720703,20677.990234,71.33737980515491,-28.662620194845097,217.06299833104276,205.54700965214542,0.019054157664312177,3550500.0
2527,BSESN,2013-10-11,20528.589844,20559.689453,20368.060547,20535.900391,11700.0,255.67968799999653,0.0,255.67968799999653,73.93634950245132,19264.720703,20559.689453,97.59842783850956,-2.401572161490444,247.74815040346948,213.98723780241025,0.04061993028182531,3562200.0
2528,BSESN,2013-10-14,20607.539063,20645.939453,20497.880859,20534.609375,8900.0,78.9492190000019,0.0,78.9492190000019,75.64973654224788,19264.720703,20645.939453,97.21981836693145,-2.7801816330685405,275.26382661516254,226.24255556496072,0.06335315443437284,3571100.0
2529,BSESN,2013-10-15,20547.619141,20759.580078,20446.730469,20722.900391,13600.0,-59.91992200000095,59.91992200000095,0.0,71.53170096313863,19264.720703,20759.580078,85.82067714563453,-14.17932285436547,288.904846090245,238.7750136700176,0.05279811495817466,3557500.0
2530,BSESN,2013-10-17,20415.509766,20629.800781,20375.419922,20579.560547,10300.0,-132.109375,132.109375,0.0,62.83077634785844,19264.720703,20759.580078,76.9830983600046,-23.01690163999539,285.7612519913491,248.17226133428395,0.025798293590824084,3547200.0
2531,BSESN,2013-10-18,20882.890625,20932.230469,20486.779297,20486.779297,15700.0,467.38085900000084,0.0,467.38085900000084,75.16318575940525,19264.720703,20932.230469,97.04110614486211,-2.958893855137895,317.3257268256457,262.0029544325563,0.04855110822825015,3562900.0
2532,BSESN,2013-10-21,20893.890625,20970.919922,20768.990234,20915.759766,12200.0,11.0,0.0,11.0,75.38497192308289,19264.720703,20970.919922,95.48532808231224,-4.514671917687759,339.3169737547905,277.46575829700316,0.05020286581265343,3575100.0
2533,BSESN,2013-10-22,20864.970703,20948.910156,20810.25,20863.150391,10700.0,-28.91992200000095,28.91992200000095,0.0,73.39673720681475,19264.720703,20970.919922,93.79033715288544,-6.2096628471145605,350.37272074765497,292.04715078713355,0.044104211179317954,3564400.0
2534,BSESN,2013-10-23,20767.880859,20922.320313,20589.720703,20875.310547,11200.0,-97.08984399999828,97.08984399999828,0.0,66.5931632100972,19583.970703,20970.919922,85.36074282904225,-14.639257170957743,347.29672048567954,303.09706472684275,0.02561185440816982,3553200.0
2535,BSESN,2013-10-24,20725.429688,21039.419922,20656.699219,20766.050781,8200.0,-42.45117100000061,42.45117100000061,0.0,63.61804349913412,19647.880859,21039.419922,77.43575855333349,-22.564241446666504,337.54253318657356,309.98615841878893,0.022321389900012534,3545000.0
2536,BSESN,2013-10-25,20683.519531,20782.160156,20622.550781,20725.519531,9600.0,-41.910156999998435,41.910156999998435,0.0,60.537166161057684,19647.880859,21039.419922,74.42397411160572,-25.576025888394277,322.7104647079432,312.5310196766198,0.007547020432350227,3535400.0
2537,BSESN,2013-10-28,20570.279297,20771.359375,20550.640625,20696.509766,8100.0,-113.24023400000078,113.24023400000078,0.0,52.59612853020953,19826.960938,21039.419922,61.30668078747976,-38.69331921252024,298.37887712259544,309.70059116581496,-0.0018080648002699595,3527300.0
2538,BSESN,2013-10-29,20929.009766,20952.550781,20493.660156,20593.490234,11300.0,358.73046899999827,0.0,358.73046899999827,67.95910151569586,19826.960938,21039.419922,90.89369970803057,-9.106300291969436,304.53201398168676,308.66687572898934,0.01856130495620234,3538600.0
2539,BSESN,2013-10-30,21033.970703,21086.589844,20937.119141,20944.140625,10400.0,104.96093699999984,0.0,104.96093699999984,71.11905175514539,20135.910156,21086.589844,94.46510305582552,-5.534896944174472,314.2553496407272,309.78457051133694,0.030293680838182402,3549000.0
2540,BSESN,2013-10-31,21164.519531,21205.439453,20991.980469,21000.599609,11900.0,130.54882800000271,0.0,130.54882800000271,74.6999365795226,20368.060547,21205.439453,95.11333260166964,-4.886667398330357,328.70624163979664,313.5689047370289,0.01348610740999856,3560900.0
2541,BSESN,2013-11-01,21196.810547,21293.880859,21141.320313,21158.810547,10000.0,32.29101599999922,0.0,32.29101599999922,75.56461520980865,20375.419922,21293.880859,89.43119864007892,-10.568801359921075,338.85814699929324,318.6267531894818,0.014498014153359717,3570900.0
2542,BSESN,2013-11-05,20974.789063,21158.560547,20951.710938,21134.099609,11900.0,-222.0214840000008,222.0214840000008,0.0,59.44631464336522,20375.419922,21293.880859,65.25798940973353,-34.74201059026647,325.2391721669992,319.9492369849853,0.00526328848303681,3559000.0
2543,BSESN,2013-11-06,20894.939453,21045.380859,20861.419922,21004.539063,10900.0,-79.84961000000112,79.84961000000112,0.0,54.61220811858129,20375.419922,21293.880859,56.56414008165904,-43.43585991834096,304.49283641900183,316.85795687178864,0.0061180336531512225,3548100.0
2544,BSESN,2013-11-07,20822.769531,21142.849609,20797.060547,20896.130859,11900.0,-72.16992199999731,72.16992199999731,0.0,50.342869605511765,20486.779297,21293.880859,41.629238477424835,-58.370761522575165,279.01143615581896,309.28865272859474,0.0046966381139186275,3536200.0
2545,BSESN,2013-11-08,20666.150391,20821.009766,20600.900391,20785.199219,10700.0,-156.61914000000255,156.61914000000255,0.0,42.101412114331325,20493.660156,21293.880859,21.555332716753977,-78.44466728324602,243.37392408460073,296.1057069997959,-0.0008397574684506637,3525500.0
2546,BSESN,2013-11-11,20490.960938,20672.529297,20453.150391,20596.400391,10300.0,-175.18945299999905,175.18945299999905,0.0,34.757525901931515,20453.150391,21293.880859,4.497344682886036,-95.50265531711396,198.7040773611734,276.62538107207143,-0.0038559689858741475,3515200.0
2547,BSESN,2013-11-12,20281.910156,20584.220703,20262.220703,20510.310547,10200.0,-209.05078199999843,209.05078199999843,0.0,28.026392184690224,20262.220703,21293.880859,1.9085212204320756,-98.09147877956792,144.765484613632,250.25340178038354,-0.030918787713083096,3505000.0
2548,BSESN,2013-11-13,20194.400391,20365.589844,20161.640625,20248.519531,9000.0,-87.50976500000252,87.50976500000252,0.0,25.62907790584441,20161.640625,21293.880859,2.89335823054661,-97.10664176945339,93.87531833434696,218.97778509117623,-0.03991497011452316,3496000.0
2549,BSESN,2013-11-14,20399.419922,20568.990234,20348.269531,20351.390625,12600.0,205.0195310000017,0.0,205.0195310000017,39.59624527708076,20161.640625,21293.880859,21.00078144723488,-78.99921855276511,69.28913562169328,189.04005519727963,-0.03615010526836426,3508600.0
2550,BSESN,2013-11-18,20850.740234,20868.759766,20570.589844,20570.589844,10900.0,451.32031199999983,0.0,451.32031199999983,59.10449473117133,20161.640625,21293.880859,60.86160766125895,-39.13839233874105,85.23959701067724,168.27996355995916,-0.016326527627005594,3519500.0
2551,BSESN,2013-11-19,20890.820313,20934.400391,20828.689453,20870.160156,11400.0,40.08007899999939,0.0,40.08007899999939,60.41452643388297,20161.640625,21293.880859,64.40149944362423,-35.598500556375775,99.96227708454535,154.6164262648764,-0.004003317971293607,3530900.0
2552,BSESN,2013-11-20,20635.130859,20895.300781,20579.939453,20857.009766,8900.0,-255.6894539999994,255.6894539999994,0.0,48.88709361593381,20161.640625,21293.880859,41.818884348178045,-58.181115651821955,89.9610896200902,141.68535893591917,-0.012434043878633783,3522000.0
2553,BSESN,2013-11-21,20229.050781,20579.259766,20189.230469,20579.259766,8100.0,-406.08007799999916,406.08007799999916,0.0,36.22195633107094,20161.640625,21293.880859,5.95369727869975,-94.04630272130025,48.70635145711276,123.08955744015789,-0.028512957852033005,3513900.0
2554,BSESN,2013-11-22,20217.390625,20388.119141,20137.669922,20316.580078,10600.0,-11.660156000001733,11.660156000001733,0.0,35.913696894960296,20137.669922,21293.880859,6.894996444753321,-93.10500355524668,14.899050121934124,101.45145597651315,-0.021714724683094877,3503300.0
2555,BSESN,2013-11-25,20605.080078,20626.150391,20326.660156,20326.660156,8200.0,387.68945299999916,0.0,387.68945299999916,51.68736596993791,20137.669922,21158.560547,45.78454778150187,-54.21545221849813,19.168852447681274,84.99493527074678,0.0055692429625575635,3511500.0
2556,BSESN,2013-11-26,20425.019531,20604.269531,20390.619141,20604.269531,10500.0,-180.06054699999734,180.06054699999734,0.0,45.66418756983799,20137.669922,21142.849609,28.58688975874627,-71.41311024125373,7.931886390106229,69.58232549461867,0.007056010696194992,3501000.0
2557,BSESN,2013-11-27,20420.259766,20482.669922,20348.060547,20449.0,7000.0,-4.759765000002517,4.759765000002517,0.0,45.50245740449498,20137.669922,21142.849609,28.113365963790944,-71.88663403620906,-1.3420926167163998,55.397441872351656,0.011184257547981469,3494000.0
2558,BSESN,2013-11-28,20534.910156,20606.380859,20461.509766,20522.359375,9000.0,114.65039000000252,0.0,114.65039000000252,50.38623023135172,20137.669922,20934.400391,49.858797856518486,-50.14120214348152,0.5531639747132431,44.42858629282397,0.006641867000045432,3503000.0
2559,BSESN,2013-11-29,20791.929688,20819.769531,20558.929688,20558.929688,11200.0,257.01953199999843,0.0,257.01953199999843,59.72260729219001,20137.669922,20934.400391,82.11808026134378,-17.88191973865623,22.53473036430296,40.04981510711977,-0.002820549550758944,3514200.0
2560,BSESN,2013-12-02,20898.009766,20941.0,20770.509766,20771.269531,9600.0,106.08007799999905,0.0,106.08007799999905,63.03528459058203,20137.669922,20941.0,94.648496903411,-5.351503096589001,47.962177713816345,41.63228762845909,0.00034414412130701066,3523800.0
2561,BSESN,2013-12-03,20854.919922,20927.050781,20817.75,20857.849609,12000.0,-43.089843999998266,43.089843999998266,0.0,60.69556537710862,20137.669922,20941.0,89.28459417151325,-10.715405828486748,63.90002295102386,46.08583469297205,0.010651207617815572,3511800.0
2562,BSESN,2013-12-04,20708.710938,20863.369141,20673.619141,20839.449219,12200.0,-146.20898400000078,146.20898400000078,0.0,52.99439074904318,20137.669922,20941.0,71.08423195377976,-28.915768046220236,63.99533861036252,49.66773547645015,0.02371145152547216,3499600.0
2563,BSESN,2013-12-05,20957.810547,21165.599609,20929.199219,20992.25,11900.0,249.0996090000008,0.0,249.0996090000008,62.37832629163847,20137.669922,21165.599609,79.78567360901604,-20.214326390983963,83.21191839348467,56.37657205985706,0.03662292210372731,3511500.0
2564,BSESN,2013-12-06,20996.529297,21049.839844,20922.449219,20955.740234,10100.0,38.71875,0.0,38.71875,63.67877146943664,20137.669922,21165.599609,83.5523466110382,-16.447653388961793,100.40803453816625,65.1828645555189,0.01899770432913539,3521600.0
2565,BSESN,2013-12-09,21326.419922,21483.740234,21282.640625,21416.669922,13400.0,329.890625,0.0,329.890625,72.89098864826809,20137.669922,21483.740234,88.3126230036043,-11.6873769963957,139.0525852550818,79.95680869543149,0.0441321678851716,3535000.0
2566,BSESN,2013-12-10,21255.259766,21327.75,21175.080078,21293.580078,17300.0,-71.16015600000173,71.16015600000173,0.0,68.56279225386265,20137.669922,21483.740234,83.0261119376057,-16.97388806239429,162.06841641784558,96.37913023991432,0.040890762878065035,3517700.0
2567,BSESN,2013-12-11,21171.410156,21215.939453,21069.449219,21191.269531,10600.0,-83.84960999999748,83.84960999999748,0.0,63.44107375196844,20137.669922,21483.740234,76.79689721884311,-23.20310278115688,171.5649714722349,111.41629848637844,0.03099599633816874,3507100.0
2568,BSESN,2013-12-12,20925.609375,21103.800781,20901.470703,21101.050781,9100.0,-245.8007810000017,245.8007810000017,0.0,50.64459617720869,20326.660156,21483.740234,51.76385199158175,-48.23614800841825,157.44209650376797,120.62145808985635,0.006429402609857471,3498000.0
2569,BSESN,2013-12-13,20715.580078,20867.169922,20692.669922,20867.169922,9500.0,-210.02929700000092,210.02929700000092,0.0,42.243687506512245,20348.060547,21483.740234,32.361196137163816,-67.63880386283618,127.82848021218888,122.06286251432286,-0.008729524487867901,3488500.0
2570,BSESN,2013-12-16,20659.519531,20764.519531,20637.769531,20714.259766,10300.0,-56.060546999997314,56.060546999997314,0.0,40.190440150486296,20348.060547,21483.740234,27.424896963927193,-72.5751030360728,98.69812774200545,117.3899155598594,-0.009369510491088917,3478200.0
2571,BSESN,2013-12-17,20612.140625,20784.029297,20594.990234,20732.439453,8300.0,-47.37890600000173,47.37890600000173,0.0,38.37171822751762,20461.509766,21483.740234,14.735508646568785,-85.26449135343121,70.97092316004637,108.1061170798968,-0.0046632701228542794,3469900.0
2572,BSESN,2013-12-18,20859.859375,20917.570313,20568.699219,20568.699219,8400.0,247.71875,0.0,247.71875,51.58821593738472,20558.929688,21483.740234,32.53960373847203,-67.46039626152796,68.19958426352241,100.12481051662193,-0.004673731150509952,3478300.0
2573,BSESN,2013-12-19,20708.619141,21017.449219,20646.029297,20959.800781,10300.0,-151.24023400000078,151.24023400000078,0.0,44.81742243812059,20568.699219,21483.740234,15.291109328033844,-84.70889067196616,53.18635609943158,90.73711963318387,-0.013712273677590092,3468000.0
2574,BSESN,2013-12-20,21079.720703,21117.990234,20745.939453,20792.369141,9100.0,371.10156199999983,0.0,371.10156199999983,59.76739916068013,20568.699219,21483.740234,55.84683917146592,-44.15316082853408,70.42128648825019,86.67395300419714,-0.011567774614880899,3477100.0
2575,BSESN,2013-12-23,21101.029297,21207.890625,21059.119141,21080.539063,6700.0,21.308594000001907,0.0,21.308594000001907,60.47681420976829,20568.699219,21483.740234,58.1755428744362,-41.8244571255638,84.82174615483746,86.30351163432522,-0.007256108403187134,3483800.0
2576,BSESN,2013-12-24,21032.710938,21156.919922,21010.650391,21127.660156,5800.0,-68.31835900000078,68.31835900000078,0.0,56.7734364890002,20568.699219,21483.740234,50.70939022334432,-49.29060977665568,89.68763040467093,86.98033538839437,-0.006551250813148779,3478000.0
2577,BSESN,2013-12-26,21074.589844,21135.849609,21013.140625,21051.0,7300.0,41.87890599999809,0.0,41.87890599999809,58.56796822836419,20568.699219,21483.740234,55.28611468853105,-44.71388531146895,95.8186190516426,88.74799212104402,0.007119528341095194,3485300.0
2578,BSESN,2013-12-27,21193.580078,21235.140625,21113.25,21114.490234,5500.0,118.99023400000078,0.0,118.99023400000078,63.53141373687736,20568.699219,21483.740234,68.28992894925034,-31.710071050749665,109.0222485493905,92.80284340671332,0.02307442022864903,3490800.0
2579,BSESN,2013-12-30,21143.009766,21304.699219,21089.210938,21260.150391,6100.0,-50.57031199999983,50.57031199999983,0.0,60.006277280507575,20568.699219,21327.75,75.66167658023919,-24.338323419760812,114.09045476501706,97.06036567837408,0.023402782154469337,3484700.0
2580,BSESN,2013-12-31,21170.679688,21230.880859,21122.679688,21177.769531,5000.0,27.66992200000095,0.0,27.66992200000095,61.359864552725405,20568.699219,21304.699219,81.79082459239156,-18.209175407608438,118.96838270300941,101.44196908330116,0.027097576770971576,3489700.0
2581,BSESN,2014-01-01,21140.480469,21244.349609,21133.820313,21222.189453,4000.0,-30.199219000001907,30.199219000001907,0.0,58.85151664155249,20568.699219,21304.699219,77.68766983695652,-22.312330163043477,119.02530156380453,104.95863557940184,0.013452683882246852,3485700.0
2582,BSESN,2014-01-02,20888.330078,21331.320313,20846.669922,21179.910156,9300.0,-252.1503909999992,252.1503909999992,0.0,42.22270331333197,20568.699219,21331.320313,41.91214503699526,-58.08785496300474,97.59892131441302,103.48669272640409,0.00867807436972945,3476400.0
2583,BSESN,2014-01-03,20851.330078,20885.179688,20731.330078,20819.580078,9300.0,-37.0,37.0,0.0,40.294980726665244,20568.699219,21331.320313,37.06045652600321,-62.93954347399679,76.7480658903587,98.13896735919502,-0.010834613428606588,3467100.0
2584,BSESN,2014-01-06,20787.300781,20913.789063,20721.980469,20913.789063,7600.0,-64.02929699999731,64.02929699999731,0.0,36.92843640799022,20568.699219,21331.320313,28.664505049738754,-71.33549495026125,54.42955357932078,89.39708460322018,-0.014867924762542395,3459500.0
2585,BSESN,2014-01-07,20693.240234,20890.480469,20637.179688,20845.769531,8100.0,-94.06054700000095,94.06054700000095,0.0,32.34753219567307,20568.699219,21331.320313,16.330654368183815,-83.66934563181619,28.819854388853855,77.28163856034692,-0.016140130723076407,3451400.0
2586,BSESN,2014-01-08,20729.380859,20786.410156,20688.179688,20767.419922,8000.0,36.140625,0.0,36.140625,35.87415843406575,20637.179688,21331.320313,13.282779840180167,-86.71722015981983,11.309856682488316,64.0872821847752,-0.01638034180286929,3459400.0
2587,BSESN,2014-01-09,20713.369141,20778.130859,20652.689453,20755.730469,9000.0,-16.011718000001565,16.011718000001565,0.0,34.94299461468336,20637.179688,21331.320313,10.9760832684298,-89.0239167315702,-3.8149777903854556,50.50683018974307,-0.022658320832660173,3450400.0
2588,BSESN,2014-01-10,20758.490234,20971.230469,20625.169922,20760.720703,10400.0,45.12109300000157,0.0,45.12109300000157,40.006358935764325,20625.169922,21331.320313,18.879875122805103,-81.1201248771949,-12.022040368388843,38.00105607811669,-0.018186603338676166,3460800.0
2589,BSESN,2014-01-13,21134.210938,21169.080078,20850.539063,20850.539063,7900.0,375.7207039999994,0.0,375.7207039999994,65.67453334298196,20625.169922,21331.320313,72.08677110255962,-27.91322889744038,11.656950128828612,32.73223488825907,-0.0017226064792180695,3468700.0
2590,BSESN,2014-01-14,21032.880859,21154.759766,21009.050781,21115.0,5600.0,-101.33007899999942,101.33007899999942,0.0,57.95796746184909,20625.169922,21331.320313,57.73712543338382,-42.26287456661618,21.99271187873819,30.584330286354895,-0.00508974288251296,3463100.0
2591,BSESN,2014-01-15,21289.490234,21302.730469,21091.460938,21091.460938,9400.0,256.609375,0.0,256.609375,68.70307536963111,20625.169922,21331.320313,94.07632148432819,-5.923678515671803,50.31016525113591,34.5294972793111,0.019204989317097798,3472500.0
2592,BSESN,2014-01-16,21265.179688,21379.289063,21199.650391,21366.910156,13400.0,-24.31054600000061,24.31054600000061,0.0,66.83580853209432,20625.169922,21379.289063,84.86852159080787,-15.131478409192125,69.98356618676189,41.620311060801264,0.019847636023787807,3459100.0
2593,BSESN,2014-01-17,21063.619141,21270.109375,21015.609375,21236.650391,12000.0,-201.56054700000092,201.56054700000092,0.0,53.043899802682866,20625.169922,21379.289063,58.14057688796931,-41.85942311203068,68.5207618464483,47.00040121793067,0.0132926522260437,3447100.0
2594,BSESN,2014-01-20,21205.050781,21221.369141,21001.130859,21083.529297,6000.0,141.43164000000255,0.0,141.43164000000255,59.76589859682312,20625.169922,21379.289063,76.89512538178651,-23.104874618213493,77.87612275535867,53.175545525416275,0.024733224048647084,3453100.0
2595,BSESN,2014-01-21,21251.119141,21302.519531,21189.199219,21237.960938,9400.0,46.068359999997476,0.0,46.068359999997476,61.82011012574165,20625.169922,21379.289063,83.00402217214096,-16.995977827859043,87.99331317965698,60.13909905626442,0.025169023886860487,3462500.0
2596,BSESN,2014-01-22,21337.669922,21377.910156,21168.429688,21251.650391,13400.0,86.55078100000173,0.0,86.55078100000173,65.6247445750562,20625.169922,21379.289063,94.48109207985223,-5.518907920147761,101.82144988040454,68.47556922109246,0.03013999203848794,3475900.0
2597,BSESN,2014-01-23,21373.660156,21409.660156,21264.710938,21319.689453,6500.0,35.99023400000078,0.0,35.99023400000078,67.19330871608472,20625.169922,21409.660156,95.41103273951018,-4.588967260489818,114.36611753050238,77.65367888297445,0.02963461769451925,3482400.0
2598,BSESN,2014-01-24,21133.560547,21333.660156,21123.990234,21289.150391,10800.0,-240.0996090000008,240.0996090000008,0.0,49.72693556213093,20625.169922,21409.660156,64.80522037958212,-35.194779620417876,103.73799810501805,82.87054272738317,-3.077432140274894e-05,3471600.0
2599,BSESN,2014-01-27,20707.449219,20899.029297,20688.029297,20899.029297,10100.0,-426.1113280000027,426.1113280000027,0.0,32.45248614287195,20625.169922,21409.660156,10.488250004141827,-89.51174999585817,60.23713765365392,78.34386171263732,-0.01547251858561971,3461500.0
2600,BSESN,2014-01-28,20683.509766,20795.349609,20554.279297,20721.169922,8200.0,-23.93945299999905,23.93945299999905,0.0,31.73777903774814,20554.279297,21409.660156,15.107944916031627,-84.89205508396837,23.55910386807227,67.38691014372431,-0.028463831747001178,3453300.0
2601,BSESN,2014-01-29,20647.300781,20828.679688,20613.619141,20784.039063,7800.0,-36.208984999997476,36.208984999997476,0.0,30.563078263928332,20554.279297,21409.660156,10.874861533463505,-89.1251384665365,-8.334193244478229,52.242689466083796,-0.029055898706967898,3445500.0
2602,BSESN,2014-01-30,20498.25,20528.410156,20343.779297,20491.740234,12600.0,-149.0507810000017,149.0507810000017,0.0,25.99345368825081,20343.779297,21409.660156,14.492304810213216,-85.50769518978679,-45.11693341819773,32.77076488922749,-0.02684102561935886,3432900.0
2603,BSESN,2014-01-31,20513.849609,20572.320313,20448.429688,20544.640625,6100.0,15.599609000000784,0.0,15.599609000000784,27.305984332563938,20343.779297,21409.660156,15.955846337231177,-84.04415366276882,-72.17675325324308,11.781261260733372,-0.03259606303887408,3439000.0
2604,BSESN,2014-02-03,20209.259766,20480.349609,20182.199219,20479.029297,5700.0,-304.5898430000016,304.5898430000016,0.0,19.510317601390653,20182.199219,21409.660156,2.204595371168286,-97.79540462883172,-116.8527049501754,-13.94553198144839,-0.049026094488827665,3433300.0
2605,BSESN,2014-02-04,20211.929688,20255.519531,19963.119141,20050.990234,9800.0,2.6699220000009514,0.0,2.6699220000009514,19.7420647898023,19963.119141,21409.660156,17.200379693347344,-82.79962030665266,-150.31059122041916,-41.21854382924255,-0.05275834887853981,3443100.0
2606,BSESN,2014-02-05,20261.029297,20289.330078,20076.099609,20241.119141,9300.0,49.09960900000078,0.0,49.09960900000078,24.36306059029998,19963.119141,21409.660156,20.594656695579506,-79.4053433044205,-170.8943157430258,-67.15369821199921,-0.05205616870855245,3452400.0
2607,BSESN,2014-02-06,20310.740234,20358.189453,20079.820313,20286.089844,12400.0,49.71093699999983,0.0,49.71093699999983,29.12991993117177,19963.119141,21409.660156,24.031195064316996,-75.96880493568301,-181.10810703859534,-89.94457997731844,-0.038934296526611734,3464800.0
2608,BSESN,2014-02-07,20376.560547,20450.509766,20282.300781,20441.039063,11100.0,65.82031300000017,0.0,65.82031300000017,35.35427162747365,19963.119141,21409.660156,28.58138149646597,-71.41861850353402,-181.79583186517266,-108.31483035488931,-0.015979209631304725,3475900.0
2609,BSESN,2014-02-10,20334.269531,20434.5,20312.210938,20429.160156,7900.0,-42.29101599999922,42.29101599999922,0.0,33.192979271964646,19963.119141,21409.660156,25.657785444818643,-74.34221455518136,-183.63654254280118,-123.37917279247169,-0.016884959997170657,3468000.0
2610,BSESN,2014-02-11,20363.369141,20443.349609,20349.509766,20400.939453,9400.0,29.099609999997483,0.0,29.099609999997483,36.28539297065147,19963.119141,21409.660156,27.669453949081372,-72.33054605091863,-180.6646342413078,-134.83626508223892,-0.013751513721410036,3477400.0
2611,BSESN,2014-02-12,20448.490234,20516.599609,20427.230469,20449.830078,10100.0,85.12109300000157,0.0,85.12109300000157,44.894675799099424,19963.119141,21333.660156,35.414561672202176,-64.58543832779783,-169.48707320462563,-141.76642670671626,-0.00242751288524623,3487500.0
2612,BSESN,2014-02-13,20193.349609,20503.859375,20164.669922,20478.669922,7900.0,-255.140625,255.140625,0.0,30.59628878180567,19963.119141,20899.029297,24.599633471655707,-75.40036652834429,-179.1513464869422,-149.24341066276145,-0.015623591188822394,3479600.0
2613,BSESN,2014-02-14,20366.820313,20391.949219,20149.009766,20265.130859,8300.0,173.4707039999994,0.0,173.4707039999994,44.470553732597914,19963.119141,20828.679688,46.64043126725374,-53.359568732746254,-170.8433409447498,-153.56339671915913,0.00779645315189037,3487900.0
2614,BSESN,2014-02-17,20464.060547,20492.429688,20338.949219,20438.869141,6100.0,97.24023400000078,0.0,97.24023400000078,50.828391811421184,19963.119141,20828.679688,57.87479659698504,-42.12520340301495,-154.63023142941893,-153.7767636612111,0.012474358603656421,3494000.0
2615,BSESN,2014-02-18,20634.210938,20685.019531,20436.480469,20457.560547,9400.0,170.15039099999922,0.0,170.15039099999922,60.06089233133772,19963.119141,20685.019531,92.9618277391426,-7.038172260857401,-126.59223430566999,-148.33985779010288,0.018418691149874267,3503400.0
2616,BSESN,2014-02-19,20722.970703,20750.519531,20629.560547,20643.849609,4700.0,88.75976499999888,0.0,88.75976499999888,64.11628931591463,19963.119141,20750.519531,96.50129357949612,-3.498706420503881,-96.10194494312964,-137.89227522070823,0.020296181441478378,3508100.0
2617,BSESN,2014-02-20,20536.640625,20662.660156,20522.039063,20661.070313,6000.0,-186.33007799999905,186.33007799999905,0.0,51.45969281974737,19963.119141,20750.519531,72.83733806634245,-27.162661933657546,-85.98230058280751,-127.51028029312809,0.007856089236982111,3502100.0
2618,BSESN,2014-02-21,20700.75,20725.039063,20599.910156,20600.580078,6300.0,164.109375,0.0,164.109375,59.57020726422897,19963.119141,20750.519531,93.6792600521824,-6.3207399478176,-63.98260285796641,-114.80474480609577,0.01802279980804289,3508400.0
2619,BSESN,2014-02-24,20811.439453,20828.630859,20637.300781,20695.480469,12500.0,110.68945299999905,0.0,110.68945299999905,64.22259095443533,20076.099609,20828.630859,97.71552264440822,-2.2844773555917754,-37.18729810080913,-99.28125546503844,0.022003741566411383,3520900.0
2620,BSESN,2014-02-25,20852.470703,20912.539063,20777.730469,20877.720703,9500.0,41.03125,0.0,41.03125,65.90090517159474,20079.820313,20912.539063,92.78647682665952,-7.213523173340473,-12.496890691629233,-81.92438251035661,0.019756004691646734,3530400.0
2621,BSESN,2014-02-26,20986.990234,21005.039063,20860.019531,20869.609375,8500.0,134.5195310000017,0.0,134.5195310000017,71.03994790898048,20149.009766,21005.039063,97.89156410145628,-2.1084358985437115,17.72076306418603,-61.99535339544808,0.03930207916799899,3538900.0
2622,BSESN,2014-02-28,21120.119141,21140.509766,20989.660156,20995.390625,11400.0,133.12890699999843,0.0,133.12890699999843,75.29211129704306,20149.009766,21140.509766,97.94345688350984,-2.0565431164901664,51.813586786669475,-39.23356535902457,0.03698657013825435,3550300.0
2623,BSESN,2014-03-03,20946.650391,21140.0,20920.980469,21079.269531,121600.0,-173.46875,173.46875,0.0,61.67675757412728,20149.009766,21140.509766,80.4478693898134,-19.552130610186584,64.09605737509264,-18.56764081220112,0.023582311188516503,3428700.0
2624,BSESN,2014-03-04,21209.730469,21224.640625,20940.390625,20947.0,9700.0,263.08007799999905,0.0,263.08007799999905,70.88877182446993,20149.009766,21224.640625,98.61382221649316,-1.3861777835068345,93.97508121074861,3.940903592388834,0.027891521160138932,3438400.0
2625,BSESN,2014-03-05,21276.859375,21333.199219,21176.160156,21280.359375,7500.0,67.12890600000172,0.0,67.12890600000172,72.81286174592792,20149.009766,21333.199219,95.24232850940632,-4.757671490593685,121.66864416791213,27.486451707493504,0.026728246636946507,3445900.0
2626,BSESN,2014-03-06,21513.869141,21525.140625,21329.880859,21336.320313,9700.0,237.0097659999992,0.0,237.0097659999992,78.58029838194774,20149.009766,21525.140625,99.18092934794068,-0.8190706520593166,160.88610480764692,54.166382327524204,0.047584633428818135,3455600.0
2627,BSESN,2014-03-07,21919.789063,21960.890625,21539.439453,21539.439453,15200.0,405.9199220000009,0.0,405.9199220000009,84.90740636703839,20338.949219,21960.890625,97.46590340144509,-2.534096598554916,222.15965202331063,87.7650362666815,0.05888864234387636,3470800.0
2628,BSESN,2014-03-10,21934.830078,22023.980469,21805.220703,21819.189453,15500.0,15.041014999998882,0.0,15.041014999998882,85.09563684222726,20436.480469,22023.980469,94.38422733858273,-5.615772661417274,268.83411155668364,123.97885132468195,0.05397947737046427,3486300.0
2629,BSESN,2014-03-11,21826.419922,22018.519531,21772.109375,21918.830078,12000.0,-108.4101559999981,108.4101559999981,0.0,77.09886381612928,20522.039063,22023.980469,86.84632128718359,-13.153678712816417,293.69068009642433,157.92121707903044,0.046706658068095486,3474300.0
2630,BSESN,2014-03-12,21856.220703,21965.949219,21768.140625,21793.320313,10400.0,29.800780999998093,0.0,29.800780999998093,77.76171250339685,20522.039063,22023.980469,88.83047199246072,-11.169528007539292,312.19556754954465,188.7760871731333,0.041417585814272684,3484700.0
2631,BSESN,2014-03-13,21774.609375,21991.359375,21720.130859,21736.609375,9500.0,-81.61132799999905,81.61132799999905,0.0,71.24563366338734,20599.910156,22023.980469,82.48884962185159,-17.511150378148418,316.62560913190464,214.3459915648876,0.030988946114866023,3475200.0
2632,BSESN,2014-03-14,21809.800781,21853.320313,21573.480469,21648.050781,8800.0,35.19140600000173,0.0,35.19140600000173,72.39648437977287,20637.300781,22023.980469,84.55449446231471,-15.445505537685285,319.2954620282653,235.33588565756318,0.04120708437330234,3484000.0
2633,BSESN,2014-03-18,21832.609375,22040.720703,21785.380859,21849.650391,8600.0,22.808593999998266,0.0,22.808593999998266,73.19868159882749,20777.730469,22040.720703,83.52233276255096,-16.477667237449037,319.56802137408886,252.18231280086835,0.029367601201269355,3492600.0
2634,BSESN,2014-03-19,21832.859375,21895.830078,21782.009766,21872.679688,11000.0,0.25,0.0,0.25,73.20852857124231,20860.019531,22040.720703,82.3950942940201,-17.6049057059799,316.1597072276709,264.9777916862289,0.026131676212199473,3503600.0
2635,BSESN,2014-03-20,21740.089844,21853.25,21704.660156,21797.609375,7600.0,-92.76953100000172,92.76953100000172,0.0,63.257423316948746,20920.980469,22040.720703,73.15173199358303,-26.848268006416976,302.4859975775944,272.47943286450203,0.010515110114195148,3496000.0
2636,BSESN,2014-03-21,21753.75,21870.109375,21729.900391,21823.519531,60600.0,13.660156000001733,0.0,13.660156000001733,64.08681890748129,20920.980469,22040.720703,74.37167172471193,-25.628328275288077,289.41554237508535,275.8666547666187,-0.007574847664947204,3556600.0
2637,BSESN,2014-03-24,22055.480469,22074.339844,21827.5,21827.5,9000.0,301.73046899999827,0.0,301.73046899999827,77.202498169367,20940.390625,22074.339844,98.33684130788222,-1.6631586921177666,299.9466414685594,280.68265210700685,0.005500402354199574,3565600.0
2638,BSESN,2014-03-25,22055.210938,22079.960938,21916.869141,21948.310547,7800.0,-0.2695309999980964,0.2695309999980964,0.0,77.17344842731148,21176.160156,22079.960938,97.26156466193453,-2.738435338065468,304.7578061888744,285.49768292338035,0.010482296996833229,3557800.0
2639,BSESN,2014-03-26,22095.300781,22172.199219,22020.580078,22134.710938,10600.0,40.08984300000157,0.0,40.08984300000157,78.55812165094827,21329.880859,22172.199219,90.87062069975576,-9.12937930024424,308.2522639590534,290.04859913051496,0.010938765729392008,3568400.0
2640,BSESN,2014-03-27,22214.369141,22307.740234,22094.289063,22116.230469,10400.0,119.06835999999748,0.0,119.06835999999748,82.24836685289569,21539.439453,22307.740234,87.84706519776381,-12.152934802236178,316.97557139769197,295.4339935839504,0.020195988751233296,3578800.0
2641,BSESN,2014-03-28,22339.970703,22363.970703,22185.109375,22273.439453,9200.0,125.60156199999984,0.0,125.60156199999984,85.32290026586693,21573.480469,22363.970703,96.96390936058042,-3.0360906394195855,330.2173121271335,302.39065729258704,0.02430879251597129,3588000.0
2642,BSESN,2014-03-31,22386.269531,22467.210938,22253.779297,22423.140625,11200.0,46.298828000002686,0.0,46.298828000002686,86.32991317902251,21573.480469,22467.210938,90.94342088498291,-9.056579115017087,340.52208886812514,310.01694360769466,0.025359321301922977,3599200.0
2643,BSESN,2014-04-01,22446.439453,22485.769531,22295.650391,22455.230469,11000.0,60.169921999997314,0.0,60.169921999997314,87.60515687820129,21573.480469,22485.769531,95.68885788088046,-4.311142119119536,349.5149181111519,317.9165385083861,0.028103514407397556,3610200.0
2644,BSESN,2014-04-02,22551.490234,22592.099609,22473.460938,22550.580078,15700.0,105.05078100000172,0.0,105.05078100000172,89.56599103251195,21573.480469,22592.099609,96.01329158217075,-3.9867084178292487,360.95762534017194,326.5247558747433,0.03732277078072599,3625900.0
2645,BSESN,2014-04-03,22509.070313,22620.650391,22369.279297,22598.189453,7400.0,-42.41992100000061,42.41992100000061,0.0,83.41740860713614,21573.480469,22620.650391,89.34460629017198,-10.655393709828017,362.4253068177204,333.7048660633387,0.03472138426708038,3618500.0
2646,BSESN,2014-04-04,22359.5,22525.210938,22339.400391,22522.460938,7100.0,-149.57031300000014,149.57031300000014,0.0,65.20602168191985,21704.660156,22620.650391,71.48982805477179,-28.51017194522821,347.51346184636714,336.4665852199444,0.013784307779071803,3611400.0
2647,BSESN,2014-04-07,22343.449219,22481.619141,22197.509766,22355.560547,4700.0,-16.050781000001734,16.050781000001734,0.0,63.489740068394084,21704.660156,22620.650391,69.73754070642448,-30.262459293575517,330.58972087055736,335.29121235006704,0.013068942383288595,3606700.0
2648,BSESN,2014-04-09,22702.339844,22740.039063,22379.949219,22389.210938,8500.0,358.890625,0.0,358.890625,78.25566846945267,21704.660156,22740.039063,96.3588963668156,-3.6411036331844033,342.1924269907031,336.6714552781943,0.027473672751356926,3615200.0
2649,BSESN,2014-04-10,22715.330078,22792.490234,22644.429688,22729.460938,10900.0,12.990234000000784,0.0,12.990234000000784,78.61684570563811,21729.900391,22792.490234,92.73848169090756,-7.261518309092441,348.41949544391537,339.02106331133854,0.022551211507303215,3626100.0
2650,BSESN,2014-04-11,22628.960938,22679.179688,22526.890625,22642.050781,9500.0,-86.36913999999888,86.36913999999888,0.0,69.73116400920513,21827.5,22792.490234,83.0537874645475,-16.946212535452506,342.4378143124595,339.7044135115628,0.012936016740666245,3616600.0
2651,BSESN,2014-04-15,22484.929688,22737.310547,22416.240234,22698.089844,8600.0,-144.03125,144.03125,0.0,57.27495386847015,21916.869141,22792.490234,64.87515565137258,-35.12484434862741,322.3592144024842,336.2353736897471,0.004407172747713739,3608000.0
2652,BSESN,2014-04-16,22277.230469,22533.609375,22247.390625,22486.730469,6700.0,-207.6992190000019,207.6992190000019,0.0,44.151910767243535,22020.580078,22792.490234,33.248738730158465,-66.75126126984154,286.3859096593151,326.26548088366076,-0.007538344081443382,3601300.0
2653,BSESN,2014-04-17,22628.839844,22648.689453,22312.189453,22327.759766,8500.0,351.609375,0.0,351.609375,61.418935273358585,22094.289063,22792.490234,76.56114071455742,-23.438859285442586,282.9866505624195,317.60971481941255,0.003429911247434081,3609800.0
2654,BSESN,2014-04-21,22764.830078,22795.580078,22636.75,22644.75,9100.0,135.99023400000078,0.0,135.99023400000078,66.09677539890508,22185.109375,22795.580078,94.9629032402559,-5.037096759744103,287.9467180783831,311.67711547120666,0.011362520150478561,3618900.0
2655,BSESN,2014-04-22,22758.369141,22853.029297,22727.630859,22771.240234,9000.0,-6.460936999999831,6.460936999999831,0.0,65.66034996614378,22197.509766,22853.029297,85.55952164299411,-14.440478357005885,288.0359643991178,306.9488852567889,0.017838911469397756,3609900.0
2656,BSESN,2014-04-23,22876.539063,22912.519531,22780.130859,22783.650391,7200.0,118.16992200000095,0.0,118.16992200000095,69.86016359675776,22197.509766,22912.519531,94.96783543928223,-5.032164560717774,294.2500860418695,304.40912541380504,0.023858887621821756,3617100.0
2657,BSESN,2014-04-25,22688.070313,22939.310547,22656.640625,22892.5,7500.0,-188.46875,188.46875,0.0,57.02552234452388,22197.509766,22939.310547,66.13103673720718,-33.86896326279282,280.7308783711778,299.6734760052796,-0.0006285489116122367,3609600.0
2658,BSESN,2014-04-28,22631.609375,22721.359375,22597.189453,22717.589844,6900.0,-56.46093800000017,56.46093800000017,0.0,53.62034020878691,22197.509766,22939.310547,58.51970234040502,-41.480297659594974,262.4356878101462,292.2259183662529,-0.0036856476534797844,3602700.0
2659,BSESN,2014-04-29,22466.189453,22681.890625,22443.560547,22654.279297,7700.0,-165.41992200000098,165.41992200000098,0.0,44.61431888442795,22197.509766,22939.310547,36.21992506368083,-63.78007493631917,231.9152377488208,280.1637822427665,-0.007193060496501369,3595000.0
2660,BSESN,2014-04-30,22417.800781,22680.460938,22284.960938,22517.630859,9700.0,-48.388671999997314,48.388671999997314,0.0,42.22081666972942,22197.509766,22939.310547,29.696789305483623,-70.30321069451637,201.50023052984398,264.431071900182,-0.0029855066451830448,3585300.0
2661,BSESN,2014-05-02,22403.890625,22575.619141,22386.949219,22493.589844,6300.0,-13.910156000001733,13.910156000001733,0.0,41.4826369221113,22247.390625,22939.310547,22.618224309488777,-77.38177569051122,174.26486792204742,246.39783110455508,0.005685632968436272,3579000.0
2662,BSESN,2014-05-05,22445.119141,22592.029297,22354.449219,22412.800781,11700.0,41.22851599999922,0.0,41.22851599999922,44.78414889276749,22247.390625,22939.310547,28.576791867542,-71.423208132458,154.22958091112378,227.96418106586884,-0.008118874156454514,3590700.0
2663,BSESN,2014-05-06,22508.419922,22602.710938,22475.650391,22512.230469,6200.0,63.30078100000173,0.0,63.30078100000173,49.80153831007791,22247.390625,22939.310547,37.72536224213538,-62.27463775786462,141.82445161298165,210.7362351752914,-0.011263433775760667,3596900.0
2664,BSESN,2014-05-07,22323.900391,22532.820313,22286.259766,22488.960938,10800.0,-184.5195310000017,184.5195310000017,0.0,38.14369980279501,22247.390625,22939.310547,11.05760414859093,-88.94239585140907,115.76959340374742,191.74290682098263,-0.019090504565957178,3586100.0
2665,BSESN,2014-05-08,22344.039063,22443.130859,22277.039063,22382.140625,6000.0,20.138672000000955,0.0,20.138672000000955,39.91494281201166,22247.390625,22939.310547,13.968153673135609,-86.0318463268644,95.64343509847095,172.52301247648032,-0.0232771224062146,3592100.0
2666,BSESN,2014-05-09,22994.230469,23048.490234,22317.179688,22374.980469,11300.0,650.1914059999981,0.0,650.1914059999981,70.92740716685357,22277.039063,23048.490234,92.96653280989024,-7.033467190109752,130.65224448209847,164.14885887760397,0.013494323306313616,3603400.0
2667,BSESN,2014-05-12,23551.0,23572.880859,23008.650391,23031.109375,12400.0,556.7695310000017,0.0,556.7695310000017,80.74635423822028,22277.039063,23572.880859,98.31145599196272,-1.6885440080372875,201.0065478170509,171.52039666549337,0.040624182300336376,3615800.0
2668,BSESN,2014-05-13,23871.230469,24068.939453,23729.25,23729.779297,18200.0,320.23046899999827,0.0,320.23046899999827,84.27167557289637,22277.039063,24068.939453,88.96651928291611,-11.033480717083883,279.38221835222066,193.09276100283884,0.06254024604125186,3634000.0
2669,BSESN,2014-05-14,23815.119141,23964.669922,23753.359375,23897.880859,11500.0,-56.11132799999905,56.11132799999905,0.0,81.26340730426256,22277.039063,24068.939453,85.8351327218585,-14.164867278141505,333.1276979526847,221.099748392808,0.062330751069225476,3622500.0
2670,BSESN,2014-05-15,23905.599609,23971.779297,23742.75,23809.419922,14900.0,90.48046800000157,0.0,90.48046800000157,82.43035179268264,22277.039063,24068.939453,90.88454665719458,-9.11545334280542,378.65746775985826,252.61129226621807,0.0670289374794697,3637400.0
2671,BSESN,2014-05-16,24121.740234,25375.630859,23873.160156,24271.539063,35700.0,216.140625,0.0,216.140625,85.00458324772826,22277.039063,25375.630859,59.53353305141199,-40.466466948588014,427.2557421927122,287.54018225151697,0.07469869428927889,3673100.0
2672,BSESN,2014-05-19,24363.050781,24448.470703,24107.990234,24340.320313,23500.0,241.31054700000092,0.0,241.31054700000092,87.38549153811051,22277.039063,25375.630859,67.32128190272924,-32.67871809727075,479.71214622765547,325.9745750467447,0.08239720359878588,3696600.0
2673,BSESN,2014-05-20,24376.880859,24587.160156,24299.529297,24555.310547,19000.0,13.830077999999046,0.0,13.830077999999046,87.51656490842669,22277.039063,25375.630859,67.76761620264745,-32.23238379735257,516.446917477504,364.0690435328966,0.09196334117436189,3715600.0
2674,BSESN,2014-05-21,24298.019531,24419.539063,24156.470703,24404.480469,18000.0,-78.86132799999905,78.86132799999905,0.0,81.91638141491907,22277.039063,25375.630859,65.22254627437222,-34.77745372562778,533.0513540581305,397.86550563794344,0.08744974274752515,3697600.0
2675,BSESN,2014-05-22,24374.400391,24524.759766,24326.480469,24415.419922,14500.0,76.38085999999748,0.0,76.38085999999748,83.12327384227294,22277.039063,25375.630859,67.6875647417482,-32.31243525825179,546.078928768784,427.5081902641116,0.06002244449366101,3712100.0
2676,BSESN,2014-05-23,24693.349609,24745.859375,24470.779297,24535.140625,21200.0,318.9492180000016,0.0,318.9492180000016,87.22973727985482,22277.039063,25375.630859,77.98092504857325,-22.019074951426738,575.5058388381731,457.10771997892385,0.04850535471954487,3733300.0
2677,BSESN,2014-05-26,24716.880859,25175.220703,24433.900391,24913.890625,21900.0,23.53125,0.0,23.53125,87.48888484995904,22277.039063,25375.630859,78.74034260174618,-21.259657398253818,593.8797759143199,484.4621311660031,0.03542550481837092,3755200.0
2678,BSESN,2014-05-27,24549.509766,24777.310547,24422.330078,24748.099609,12600.0,-167.37109300000157,167.37109300000157,0.0,74.99831687644968,22277.039063,25375.630859,73.33882139407815,-26.661178605921844,588.1559097840764,505.2008868896178,0.030837159396598368,3742600.0
2679,BSESN,2014-05-28,24556.089844,24643.330078,24488.810547,24591.609375,15100.0,6.580077999999047,0.0,6.580077999999047,75.15919370297803,22317.179688,25375.630859,73.20405103175007,-26.795948968249927,577.493674339763,519.6594443796469,0.02721078933971177,3757700.0
2680,BSESN,2014-05-29,24234.150391,24528.199219,24206.5,24523.130859,16000.0,-321.93945299999905,321.93945299999905,0.0,55.132035174240116,23008.650391,25375.630859,51.77482520738735,-48.22517479261265,536.8771668510344,523.1029888739243,0.004660118047434825,3741700.0
2681,BSESN,2014-05-30,24217.339844,24353.589844,24163.619141,24300.990234,14900.0,-16.810547000000955,16.810547000000955,0.0,54.260911417663266,23729.25,25375.630859,29.646229262921604,-70.3537707370784,497.5958462162598,518.0015603423915,-0.005980816536886202,3726800.0
2682,BSESN,2014-06-02,24684.849609,24709.089844,24270.199219,24368.960938,14400.0,467.5097650000025,0.0,467.5097650000025,69.64949159221091,23742.75,25375.630859,57.69555101386612,-42.30444898613388,498.4435010896814,514.0899484918494,0.012633640529374768,3741200.0
2683,BSESN,2014-06-03,24858.589844,24892.060547,24626.970703,24729.220703,21100.0,173.74023499999748,0.0,173.74023499999748,73.47603863334145,23742.75,25375.630859,68.33565583488769,-31.66434416511231,507.286970223111,512.7293528381017,0.023070617433853302,3762300.0
2684,BSESN,2014-06-04,24805.830078,24925.900391,24773.929688,24909.029297,14800.0,-52.75976599999922,52.75976599999922,0.0,70.36744994798173,23873.160156,25375.630859,62.07574764271446,-37.92425235728554,504.2258097752456,511.02864422553046,0.01770011487787415,3747500.0
2685,BSESN,2014-06-05,25019.509766,25044.060547,24644.880859,24828.380859,17500.0,213.67968800000014,0.0,213.67968800000014,75.25896767478507,24107.990234,25175.220703,85.40981151466731,-14.590188485332693,513.1269747374608,511.4483103279166,0.01320842097829944,3765000.0
2686,BSESN,2014-06-06,25396.460938,25419.140625,25129.759766,25204.949219,18100.0,376.9511720000009,0.0,376.9511720000009,81.48131783161051,24156.470703,25419.140625,98.20383089793758,-1.7961691020624324,544.3234000413358,518.0233282706006,0.02749457275279732,3783100.0
2687,BSESN,2014-06-09,25580.210938,25644.769531,25496.839844,25543.599609,15300.0,183.75,0.0,183.75,83.77628786293026,24156.470703,25644.769531,95.66225600763548,-4.337743992364512,577.2200477860642,529.8626721736933,0.04198459284215428,3798400.0
2688,BSESN,2014-06-10,25583.689453,25711.109375,25347.330078,25706.349609,13600.0,3.478514999998879,0.0,3.478514999998879,83.82008619618438,24163.619141,25711.109375,91.76602739064518,-8.233972609354826,596.6932567850781,543.2287890959703,0.041847037355219774,3812000.0
2689,BSESN,2014-06-11,25473.890625,25735.869141,25365.650391,25650.619141,14000.0,-109.79882799999905,109.79882799999905,0.0,76.31636390251465,24163.619141,25735.869141,83.33734991254576,-16.662650087454235,596.3912404420334,553.861279365183,0.05115674426368222,3798000.0
2690,BSESN,2014-06-12,25576.210938,25611.320313,25409.689453,25597.210938,10200.0,102.32031300000016,0.0,102.32031300000016,78.39594554601474,24163.619141,25735.869141,89.84524070599466,-10.154759294005347,597.5204407494239,562.5931116420312,0.056111492953123454,3808200.0
2691,BSESN,2014-06-13,25228.169922,25688.310547,25171.609375,25677.050781,14700.0,-348.04101599999916,348.04101599999916,0.0,58.303297104016444,24163.619141,25735.869141,67.70874740022272,-32.29125259977728,563.8318364005208,562.8408565937292,0.022010274383114314,3793500.0
2692,BSESN,2014-06-16,25190.480469,25268.410156,25063.929688,25239.5,12000.0,-37.689453000002686,37.689453000002686,0.0,56.49410764200332,24163.619141,25735.869141,65.31158072825562,-34.68841927174437,528.0056306297156,555.8738114009265,0.01335114449704422,3781500.0
2693,BSESN,2014-06-17,25521.189453,25545.880859,25104.5,25189.460938,11300.0,330.7089840000008,0.0,330.7089840000008,66.8947811390805,24163.619141,25735.869141,86.34570278263634,-13.654297217363661,520.3008512636516,548.7592193734715,0.028838356658519748,3792800.0
2694,BSESN,2014-06-18,25246.25,25609.279297,25114.300781,25565.189453,13200.0,-274.93945299999905,274.93945299999905,0.0,54.41584090230658,24163.619141,25735.869141,68.85869670853877,-31.14130329146123,486.4024968057529,536.2878748599278,0.00906253704091875,3779600.0
2695,BSESN,2014-06-19,25201.800781,25425.849609,25069.660156,25327.089844,15200.0,-44.449218999998266,44.449218999998266,0.0,52.58592975969897,24270.199219,25735.869141,63.5614846164526,-36.4385153835474,450.7551019477869,519.1813202774996,-0.007664853676865424,3764400.0
2696,BSESN,2014-06-20,25105.509766,25276.310547,25056.179688,25237.539063,8800.0,-96.29101500000252,96.29101500000252,0.0,48.50845192740254,24626.970703,25735.869141,43.15445369939281,-56.84554630060718,410.0080865240525,497.34667352681015,-0.01855735956011295,3755600.0
2697,BSESN,2014-06-23,25031.320313,25197.5,24878.660156,25108.089844,10200.0,-74.18945299999905,74.18945299999905,0.0,45.38026032584054,24644.880859,25735.869141,35.421045338046994,-64.57895466195302,367.49308290119734,471.3759554016877,-0.02159067561442851,3745400.0
2698,BSESN,2014-06-24,25368.900391,25414.689453,25115.830078,25115.830078,9700.0,337.58007799999905,0.0,337.58007799999905,59.1956928396626,24644.880859,25735.869141,66.36363964173168,-33.63636035826831,356.92511667928557,448.4857876572073,-0.0041214840538320585,3755100.0
2699,BSESN,2014-06-25,25313.740234,25427.800781,25274.390625,25421.490234,7700.0,-55.160156999998435,55.160156999998435,0.0,56.501246848560974,24878.660156,25735.869141,50.755426694460084,-49.244573305539916,340.1776079221818,426.82415171020216,-0.010262298220649724,3747400.0
2700,BSESN,2014-06-26,25062.669922,25309.330078,25021.230469,25217.689453,10300.0,-251.07031199999986,251.07031199999986,0.0,45.600287279271754,24878.660156,25735.869141,21.466149937754064,-78.53385006224593,303.15127152362766,402.0895756728873,-0.006560127052881337,3737100.0
2701,BSESN,2014-06-27,25099.919922,25209.609375,25032.939453,25132.080078,10100.0,37.25,0.0,37.25,47.33956898161882,24878.660156,25735.869141,25.811648019531653,-74.18835198046835,273.6588282310404,376.40342618451797,-0.0035950305557467255,3747200.0
2702,BSESN,2014-06-30,25413.779297,25460.960938,25179.550781,25179.550781,9500.0,313.859375,0.0,313.859375,59.82680740494856,24878.660156,25735.869141,62.42575035538164,-37.57424964461837,272.47080909034776,355.61690276568396,-0.00420866575195511,3756700.0
2703,BSESN,2014-07-01,25516.349609,25571.900391,25466.769531,25469.939453,10600.0,102.57031199999984,0.0,102.57031199999984,63.12411124515497,24878.660156,25688.310547,78.76108751240011,-21.23891248759989,276.6171915289451,339.8169605183362,0.010698603119275063,3767300.0
2704,BSESN,2014-07-02,25841.210938,25864.529297,25660.160156,25660.570313,12300.0,324.8613289999994,0.0,324.8613289999994,71.63281057195053,24878.660156,25864.529297,97.63474095797864,-2.3652590420213593,302.6283129434705,332.3792310033631,0.025371605884689785,3779600.0
2705,BSESN,2014-07-03,25823.75,25999.080078,25793.699219,25875.75,3700.0,-17.46093800000017,17.46093800000017,0.0,70.62221021649904,24878.660156,25999.080078,84.35139588672902,-15.648604113270977,318.1657456307039,329.53653392883126,0.02860886875807256,3775900.0
2706,BSESN,2014-07-04,25962.060547,25981.509766,25659.330078,25844.800781,9500.0,138.31054700000095,0.0,138.31054700000095,73.9776510613073,24878.660156,25999.080078,96.69592353071369,-3.304076469286324,337.74644740411895,331.1785166238888,0.0371830259994963,3785400.0
2707,BSESN,2014-07-07,26100.080078,26123.550781,25992.730469,26039.669922,8900.0,138.0195309999981,0.0,138.0195309999981,77.00213414323703,24878.660156,26123.550781,98.11463734012756,-1.8853626598724436,360.2485957405079,336.9925324472127,0.02882189120263945,3794300.0
2708,BSESN,2014-07-08,25582.109375,26190.439453,25495.039063,26166.919922,12700.0,-517.970702999999,517.970702999999,0.0,51.22245101444935,24878.660156,26190.439453,53.62557715377633,-46.37442284622367,332.4534866964714,336.08472329706444,0.01060171821782152,3781600.0
2709,BSESN,2014-07-09,25444.810547,25683.970703,25364.769531,25615.279297,10500.0,-137.29882799999905,137.29882799999905,0.0,46.46464255630191,24878.660156,26190.439453,43.15896677854037,-56.84103322145964,295.9354350785361,328.0548656533588,0.015247402858087344,3771100.0
2710,BSESN,2014-07-10,25372.75,25920.460938,25239.890625,25513.740234,16900.0,-72.06054700000095,72.06054700000095,0.0,43.990179557644844,24878.660156,26190.439453,37.665622954255184,-62.334377045744816,258.2035226818225,314.08459705905153,0.010869758901535853,3754200.0
2711,BSESN,2014-07-11,25024.349609,25548.330078,24978.330078,25488.859375,18600.0,-348.40039099999916,348.40039099999916,0.0,33.91452823773514,24978.330078,26190.439453,3.7966483841445196,-96.20335161585548,197.90636898431694,290.8489514441046,-0.015323564569004189,3735600.0
2712,BSESN,2014-07-14,25006.980469,25095.759766,24892.0,25093.160156,11400.0,-17.369140000002517,17.369140000002517,0.0,33.47350028904957,24892.0,26190.439453,8.855281525398809,-91.14471847460119,147.0240935918664,262.083979873657,-0.019962461237807316,3724200.0
2713,BSESN,2014-07-15,25228.650391,25254.480469,25020.320313,25100.900391,8100.0,221.66992200000092,0.0,221.66992200000092,44.16550794623756,24892.0,26190.439453,25.927307601612092,-74.0726923983879,123.16664546852917,234.3005129926314,-0.02370479264573544,3732300.0
2714,BSESN,2014-07-16,25549.720703,25602.779297,25246.75,25322.169922,9600.0,321.07031199999983,0.0,321.07031199999983,55.98731226446082,24892.0,26190.439453,50.654707193343384,-49.345292806656616,128.6837506543052,213.17716052496615,-0.010611522222760073,3741900.0
2715,BSESN,2014-07-17,25561.160156,25613.029297,25494.460938,25540.919922,21900.0,11.439453000002684,0.0,11.439453000002684,56.367106376045484,24892.0,26190.439453,51.535722705739616,-48.46427729426039,132.45233643057873,197.0321957060887,-0.015441778601287703,3763800.0
2716,BSESN,2014-07-18,25641.560547,25713.400391,25441.240234,25558.480469,8300.0,80.40039099999922,0.0,80.40039099999922,59.2208153678411,24892.0,26190.439453,57.72780126698764,-42.27219873301235,140.30921019341258,185.68759860355348,-0.01756774422261209,3772100.0
2717,BSESN,2014-07-21,25715.169922,25861.150391,25677.710938,25776.539063,7600.0,73.609375,0.0,73.609375,61.856191441197446,24892.0,26190.439453,63.396866145594664,-36.603133854405336,150.7378880965589,178.6976565021546,0.0052013125676819705,3779700.0
2718,BSESN,2014-07-22,26025.800781,26050.380859,25780.390625,25784.480469,8500.0,310.6308590000008,0.0,310.6308590000008,70.98614984065067,24892.0,26190.439453,87.32026575289241,-12.679734247107588,181.9703636605991,179.3521979338435,0.022833348785475716,3788200.0
2719,BSESN,2014-07-23,26147.330078,26188.640625,26000.400391,26130.259766,8200.0,121.52929699999731,0.0,121.52929699999731,73.815421367592,24892.0,26190.439453,96.67990872424606,-3.3200912757539287,214.0611603599391,186.29399041906265,0.030528030189868938,3796400.0
2720,BSESN,2014-07-24,26271.849609,26292.660156,26077.699219,26188.5,7800.0,124.51953100000172,0.0,124.51953100000172,76.52207885730832,24892.0,26292.660156,98.51423295573485,-1.4857670442651563,246.69726098352476,198.37464453195508,0.049851445471787104,3804200.0
2721,BSESN,2014-07-25,26126.75,26300.169922,26007.310547,26257.140625,11100.0,-145.09960900000078,145.09960900000078,0.0,67.18451525196065,24892.0,26300.169922,87.68473042275356,-12.315269577246433,257.8805931076058,210.27583424708527,0.04477827830465686,3793100.0
2722,BSESN,2014-07-28,25991.230469,26181.830078,25900.25,26173.470703,7400.0,-135.5195310000017,135.5195310000017,0.0,59.376431533093196,24892.0,26300.169922,78.06092516439912,-21.939074835600874,252.89297798991902,218.79926299565204,0.03022674880270415,3785700.0
2723,BSESN,2014-07-30,26087.419922,26113.480469,25850.039063,26005.140625,9200.0,96.18945300000269,0.0,96.18945300000269,62.90697080228481,24892.0,26300.169922,84.89173808670515,-15.108261913294854,253.7765637867269,225.794723153867,0.021045209270599496,3794900.0
2724,BSESN,2014-07-31,25894.970703,26118.880859,25853.689453,26105.890625,9200.0,-192.4492190000019,192.4492190000019,0.0,52.39489356132347,24892.0,26300.169922,71.2251190236684,-28.77488097633161,236.22471679804585,227.8807218827028,0.013059287800817554,3785700.0
2725,BSESN,2014-08-01,25480.839844,25862.679688,25459.130859,25753.919922,12700.0,-414.13085900000084,414.13085900000084,0.0,37.030418227546306,24892.0,26300.169922,41.81596516162471,-58.18403483837529,186.74517024226589,219.6536115546154,-0.006267976658651753,3773000.0
2726,BSESN,2014-08-04,25723.160156,25754.419922,25531.380859,25631.679688,7400.0,242.32031200000347,0.0,242.32031200000347,47.43701896886178,25020.320313,26300.169922,54.915814956505656,-45.084185043494344,165.1813889094774,208.75916702558777,0.00031072063782722203,3780400.0
2727,BSESN,2014-08-05,25908.009766,25928.320313,25562.359375,25817.839844,8800.0,184.84960999999748,0.0,184.84960999999748,54.11205103647134,25246.75,26300.169922,62.77266569484895,-37.22733430515105,161.15011727940873,199.237357076352,-0.004525932400358479,3789200.0
2728,BSESN,2014-08-06,25665.269531,25901.679688,25621.849609,25892.550781,6800.0,-242.74023499999748,242.74023499999748,0.0,45.38012256440742,25441.240234,26300.169922,26.082379050332804,-73.9176209496672,136.79135161733575,186.74815598454876,-0.0184363200970028,3782400.0
2729,BSESN,2014-08-07,25589.009766,25778.050781,25526.050781,25668.710938,7100.0,-76.25976500000252,76.25976500000252,0.0,42.872312259972006,25441.240234,26300.169922,17.20391483313107,-82.79608516686892,110.06457274685454,171.41143933700994,-0.02599131211401573,3775300.0
2730,BSESN,2014-08-08,25329.140625,25406.869141,25232.820313,25406.869141,7500.0,-259.8691409999992,259.8691409999992,0.0,35.219524610804115,25232.820313,26300.169922,9.024251396900992,-90.975748603099,67.14018976004445,150.55718942161684,-0.030528457423904642,3767800.0
2731,BSESN,2014-08-11,25519.240234,25553.439453,25437.050781,25476.869141,6000.0,190.0996090000008,0.0,190.0996090000008,43.70178839143842,25232.820313,26300.169922,26.834686459326782,-73.16531354067321,47.90948597539318,130.0276487323721,-0.018159595620643842,3773800.0
2732,BSESN,2014-08-12,25880.769531,25904.980469,25645.789063,25703.779297,8100.0,361.5292970000009,0.0,361.5292970000009,56.26738851506493,25232.820313,26300.169922,60.70637142098781,-39.29362857901219,61.136662133001664,116.24945141249802,-0.007921457607454996,3781900.0
2733,BSESN,2014-08-13,25918.949219,25972.619141,25791.789063,25861.470703,8800.0,38.17968799999653,0.0,38.17968799999653,57.42530429801604,25232.820313,26300.169922,64.28342693101577,-35.716573068984225,73.84879335467849,107.76931980093413,0.000925991238801549,3790700.0
2734,BSESN,2014-08-14,26103.230469,26135.0,25945.349609,25948.300781,10100.0,184.28125,0.0,184.28125,62.896509575009254,25232.820313,26300.169922,81.54873985623932,-18.45126014376069,97.66735720807992,105.74892728236328,0.0244258285366743,3800800.0
2735,BSESN,2014-08-18,26390.960938,26413.109375,26075.279297,26123.689453,8200.0,287.73046900000185,0.0,287.73046900000185,69.87173425502121,25232.820313,26413.109375,98.1234735021208,-1.8765264978791978,138.1684647945549,112.23283478480161,0.025961070799624508,3809000.0
2736,BSESN,2014-08-19,26420.669922,26530.669922,26387.839844,26482.560547,10400.0,29.708984000000786,0.0,29.708984000000786,70.53174009614405,25232.820313,26530.669922,91.52444171981101,-8.47555828018899,170.69547983473603,123.92536379478851,0.019787708922079483,3819400.0
2737,BSESN,2014-08-20,26314.289063,26504.519531,26277.609375,26496.289063,8900.0,-106.38085900000078,106.38085900000078,0.0,64.67774795539037,25232.820313,26530.669922,83.32774017116488,-16.672259828835116,185.74813842365256,136.28991872056133,0.02528785178803883,3810500.0
2738,BSESN,2014-08-21,26360.109375,26464.800781,26262.519531,26322.660156,6500.0,45.82031199999983,0.0,45.82031199999983,66.07702566626949,25232.820313,26530.669922,86.85821948727799,-13.141780512722015,199.0799255867787,148.84792009380482,0.030134015190558694,3817000.0
2739,BSESN,2014-08-22,26419.550781,26508.269531,26383.160156,26419.529297,6700.0,59.44140600000173,0.0,59.44140600000173,67.97596265013888,25232.820313,26530.669922,91.4382113128179,-8.561788687182101,211.99810546003573,161.47795716705102,0.04304963094262115,3823700.0
2740,BSESN,2014-08-25,26437.019531,26630.740234,26401.640625,26490.310547,10000.0,17.46875,0.0,17.46875,68.57251278791286,25232.820313,26630.740234,86.14221744108052,-13.85778255891948,221.09677225007545,173.40172018365593,0.03596420930185906,3833700.0
2741,BSESN,2014-08-26,26442.810547,26481.970703,26314.890625,26349.869141,9500.0,5.7910159999992175,0.0,5.7910159999992175,68.79486312928853,25232.820313,26630.740234,86.55647693570569,-13.443523064294308,226.1676973961221,183.9549156261492,0.021716549630674153,3843200.0
2742,BSESN,2014-08-27,26560.150391,26599.119141,26492.5,26553.240234,6600.0,117.33984399999828,0.0,117.33984399999828,73.22394214573612,25232.820313,26630.740234,94.95036575846882,-5.049634241531174,236.92367818694402,194.5486681383082,0.024738702428953596,3849800.0
2743,BSESN,2014-08-28,26638.109375,26674.380859,26573.689453,26620.179688,6700.0,77.95898400000078,0.0,77.95898400000078,75.85146605846022,25232.820313,26674.380859,97.48387370196515,-2.5161262980348496,248.86969401807437,205.41287331426145,0.020490908458063117,3856500.0
2744,BSESN,2014-09-01,26867.550781,26900.300781,26732.390625,26733.179688,9200.0,229.4414060000017,0.0,229.4414060000017,81.88729460064405,25437.050781,26900.300781,97.76183153938152,-2.238168460618486,273.6960044040861,219.06949953222642,0.018058828707285368,3865700.0
2745,BSESN,2014-09-02,27019.390625,27082.849609,26886.220702999995,26888.210938,8000.0,151.8398439999983,0.0,151.8398439999983,84.79019217051807,25645.789063,27082.849609,95.58411201416416,-4.415887985835829,302.1403547474947,235.6836705752801,0.022661071985213166,3873700.0
2746,BSESN,2014-09-03,27139.939452999995,27225.849609,27067.019531,27128.060547000005,9700.0,120.54882799999541,0.0,120.54882799999541,86.73736052520766,25791.789063,27225.849609,94.00930760980538,-5.9906923901946145,330.59905021600935,254.66674650342597,0.031376503770376374,3883400.0
2747,BSESN,2014-09-04,27085.929688,27169.119141000006,26972.390625,27164.949219,7400.0,-54.00976499999524,54.00976499999524,0.0,81.35327420139423,25945.349609,27225.849609,89.07302452167117,-10.926975478328824,344.81976711907555,272.69735062655593,0.02753479899018818,3876000.0
2748,BSESN,2014-09-05,27026.699219,27178.800781,26920.560547000005,27127.259766000006,7100.0,-59.2304690000019,59.2304690000019,0.0,75.4286230655404,26075.279297,27225.849609,82.69115864341869,-17.308841356581304,347.3068467426274,287.61924984977026,0.022981028066405784,3868900.0
2749,BSESN,2014-09-08,27319.849609,27354.990234,27144.560547000005,27145.119141000006,7300.0,293.1503899999989,0.0,293.1503899999989,82.64601365555988,26262.519531,27354.990234,96.78338056082406,-3.2166194391759384,368.68271691215705,303.83194326224765,0.03339370676655862,3876200.0
2750,BSESN,2014-09-09,27265.320313,27328.269531,27177.089844,27316.429688,7600.0,-54.529295999996975,54.529295999996975,0.0,77.74473893689522,26262.519531,27354.990234,91.79200680130269,-8.20799319869731,376.8787657468383,318.4413077591658,0.031105232348053624,3868600.0
2751,BSESN,2014-09-10,27057.410156,27251.439452999995,27018.109375,27230.939452999995,5900.0,-207.91015699999843,207.91015699999843,0.0,61.657933116777684,26262.519531,27354.990234,72.76081846562806,-27.239181534371937,362.41983118999997,327.23701244533265,0.018722023696390755,3862700.0
2752,BSESN,2014-09-11,26995.869141000006,27150.779297000005,26904.5,27143.220702999995,7600.0,-61.541014999998886,61.541014999998886,0.0,57.58817164825271,26314.890625,27354.990234,65.47243265043915,-34.52756734956085,342.05221082564094,330.2000521213943,0.013430373791308403,3855100.0
2753,BSESN,2014-09-12,27061.039063,27096.869141000006,26965.910156,27048.150391000006,8000.0,65.16992199999731,0.0,65.16992199999731,60.75345016688019,26314.890625,27354.990234,71.73817118510229,-28.26182881489771,327.39538282706053,329.6391182625276,0.0072015601115686945,3863100.0
2754,BSESN,2014-09-15,26816.560547,26998.070313,26790.910156,26998.070313,6000.0,-244.4785159999992,244.4785159999992,0.0,45.91932763699355,26314.890625,27354.990234,48.23287285746885,-51.76712714253115,292.6785518329925,322.2470049766206,-0.007506833918464739,3857100.0
2755,BSESN,2014-09-16,26492.509766,26861.289063,26464.029297,26854.900391000006,9400.0,-324.05078100000173,324.05078100000173,0.0,33.43400860866605,26464.029297,27354.990234,3.1966013118258934,-96.8033986881741,236.29318260592845,305.0562405024822,-0.023855236969897886,3847700.0
2756,BSESN,2014-09-17,26631.289063,26682.640625,26511.710938,26627.210938,7600.0,138.77929700000095,0.0,138.77929700000095,41.31835859331479,26464.029297,27354.990234,18.772962882434346,-81.22703711756566,200.49452462340196,284.14389732666615,-0.01678512165677748,3855300.0
2757,BSESN,2014-09-18,27112.210938,27132.199219,26503.080078,26573.890625,7000.0,480.921875,0.0,480.921875,60.17802599526192,26464.029297,27354.990234,72.75084844713,-27.249151552870003,208.52644330235125,269.0204065218032,0.0031639719784903875,3862300.0
2758,BSESN,2014-09-19,27090.419922000005,27247.169922000005,27047.679688,27139.390625,7300.0,-21.79101599999558,21.79101599999558,0.0,59.18357401009909,26464.029297,27354.990234,70.30506041142,-29.694939588579995,210.70457269124017,257.35723975569056,-0.008397911785151813,3855000.0
2759,BSESN,2014-09-22,27206.740234,27254.800781,26918.929688,27008.119141000006,7100.0,116.32031199999255,0.0,116.32031199999255,62.95417941817147,26464.029297,27354.990234,83.36066219702289,-16.639337802977106,219.2890058171106,249.74359296797456,-0.0021485197433044334,3862100.0
2760,BSESN,2014-09-23,26775.689453,27256.869141000006,26744.070313,27244.980469,7900.0,-431.0507809999981,431.0507809999981,0.0,45.128449876308224,26464.029297,27354.990234,34.98022674814509,-65.0197732518549,189.1298639890374,237.62084717218713,-0.010411961136551406,3854200.0
2761,BSESN,2014-09-24,26744.689453,26844.699219,26560.0,26817.939453,12300.0,-31.0,31.0,0.0,44.09243033479196,26464.029297,27354.990234,31.50083739305376,-68.49916260694624,160.87264615804816,222.27120696935935,-0.009304374928182146,3841900.0
2762,BSESN,2014-09-25,26468.359375,26814.199219,26349.550781,26808.660156,11000.0,-276.33007799999905,276.33007799999905,0.0,35.67003788104053,26349.550781,27354.990234,11.816583648622586,-88.1834163513774,114.85706874450625,200.78837932438873,-0.02190158650671914,3830900.0
2763,BSESN,2014-09-26,26626.320313,26721.029297,26220.490234,26429.300781,10000.0,157.96093800000014,0.0,157.96093800000014,42.8681583628217,26220.490234,27328.269531,36.634560701670075,-63.36543929832993,90.09693826102375,178.65009111171574,-0.007094132510639284,3840900.0
2764,BSESN,2014-09-29,26597.109375,26715.769531,26518.009766,26694.410156,6500.0,-29.210938000000173,29.210938000000173,0.0,41.868533001804735,26220.490234,27256.869141000006,36.339907967655805,-63.660092032344195,67.3410126199924,156.38827541337108,0.003948271036753326,3834400.0
2765,BSESN,2014-09-30,26630.509766,26851.330077999995,26481.310547,26610.710938,8200.0,33.40039099999922,0.0,33.40039099999922,43.603567159679095,26220.490234,27256.869141000006,39.56270522591755,-60.43729477408245,51.409295657704206,135.3924794622377,-2.926245883771994e-05,3842600.0
2766,BSESN,2014-10-01,26567.990234,26683.699219,26548.220703,26681.470703,7900.0,-62.519531999998435,62.519531999998435,0.0,40.962980817404514,26220.490234,27256.869141000006,33.53020769265792,-66.46979230734208,33.35400721536644,114.98478501286344,-0.02007290018672836,3834700.0
2767,BSESN,2014-10-07,26271.970703,26570.380859,26250.240234,26487.509766,10200.0,-296.01953100000173,296.01953100000173,0.0,30.779566628656255,26220.490234,27256.869141000006,4.967340482547854,-95.03265951745215,-4.786070330224902,91.03061394424577,-0.030211758302622238,3824500.0
2768,BSESN,2014-10-08,26246.789063,26338.310547,26150.089844,26229.669922,8600.0,-25.18163999999888,25.18163999999888,0.0,30.046394787475194,26150.089844,27256.869141000006,8.736992032838971,-91.26300796716103,-36.62214714993388,65.50006172540984,-0.035283579096343165,3815900.0
2769,BSESN,2014-10-09,26637.279297,26688.699219,26394.210938,26394.369141,7500.0,390.49023400000084,0.0,390.49023400000084,50.95118683973189,26150.089844,27256.869141000006,44.018663370426154,-55.98133662957385,-29.997377875915845,46.400573805144695,-0.005169247135277444,3823400.0
2770,BSESN,2014-10-10,26297.380859,26555.919922,26261.609375,26551.740234,9200.0,-339.89843800000017,339.89843800000017,0.0,39.18902590167571,26150.089844,27256.869141000006,13.308074644985107,-86.69192535501489,-51.579586429026676,26.804541758310418,-0.016725136957977393,3814200.0
2771,BSESN,2014-10-13,26384.070313,26443.160156,26092.689453,26275.070313,6400.0,86.68945399999939,0.0,86.68945399999939,43.05745542139432,26092.689453,27256.869141000006,25.028856198356834,-74.97114380164317,-60.98552458968334,9.246528488711661,-0.0031845215944745764,3820600.0
2772,BSESN,2014-10-14,26349.330078,26550.789063,26212.009766,26537.419922,11900.0,-34.74023500000112,34.74023500000112,0.0,41.8271157224981,26092.689453,27256.869141000006,22.04476058510294,-77.95523941489706,-70.43115842393308,-6.689008893817293,-0.010402873237604804,3808700.0
2773,BSESN,2014-10-16,25999.339844,26462.080078,25933.980469,26260.349609,10700.0,-349.99023400000084,349.99023400000084,0.0,31.397959324282567,25933.980469,27256.869141000006,4.940655731913289,-95.0593442680867,-104.94839837470863,-26.340886789995565,-0.0224749811181314,3798000.0
2774,BSESN,2014-10-17,26108.529297,26248.539063,25910.769531,25950.0,9400.0,109.18945300000269,0.0,109.18945300000269,37.04826134808027,25910.769531,26851.330077999995,21.025734773882725,-78.97426522611728,-122.08555708970744,-45.48982084993795,-0.019600844053928923,3807400.0
2775,BSESN,2014-10-20,26429.849609,26517.900391,26368.939453,26434.160156,9300.0,321.32031199999983,0.0,321.32031199999983,50.80612640136018,25910.769531,26851.330077999995,55.18837459806855,-44.81162540193146,-108.48842797935504,-58.08954227582137,-0.0051995135417964855,3816700.0
2776,BSESN,2014-10-21,26575.650391,26615.410156,26407.0,26552.449219,8400.0,145.80078199999843,0.0,145.80078199999843,55.85708600130799,25910.769531,26851.330077999995,70.68985214409615,-29.31014785590385,-84.96823962247436,-63.46528174515197,0.011559075313879008,3825100.0
2777,BSESN,2014-10-22,26787.230469,26818.330078,26712.210938,26782.570313,6000.0,211.58007799999905,0.0,211.58007799999905,62.3328175391373,25910.769531,26851.330077999995,93.18495665117479,-6.815043348825217,-48.694259734635125,-60.5110773430486,0.02059076272921545,3831100.0
2778,BSESN,2014-10-27,26752.900391,26994.960938,26726.839844,26959.570313,6500.0,-34.33007799999905,34.33007799999905,0.0,60.66662346598099,25910.769531,26994.960938,77.67363350814665,-22.326366491853346,-22.458136304165237,-52.90048913527193,0.004340574452474932,3824600.0
2779,BSESN,2014-10-28,26880.820313,26907.140625,26764.150391,26788.730469,6800.0,127.91992200000095,0.0,127.91992200000095,64.7211031300312,25910.769531,26994.960938,89.47228097704337,-10.527719022956632,8.557602455366577,-40.608870817144236,0.022186219119244566,3831400.0
2780,BSESN,2014-10-29,27098.169922000005,27126.300781,26971.160156,27017.439452999995,8100.0,217.34960900000442,0.0,217.34960900000442,70.65200703284869,25910.769531,27126.300781,97.68571486747074,-2.314285132529266,50.098590492543735,-22.46737855520664,0.027065558897034547,3839500.0
2781,BSESN,2014-10-30,27346.330077999995,27390.599609,27088.650391000006,27098.939452999995,7000.0,248.16015599999082,0.0,248.16015599999082,75.973339555942,25910.769531,27390.599609,97.00847200917582,-2.991527990824187,101.87027629383738,2.40015241460217,0.03783777413120748,3846500.0
2782,BSESN,2014-10-31,27865.830077999995,27894.320313,27438.279297000005,27439.060547000005,11600.0,519.5,0.0,519.5,83.2912531384704,25910.769531,27894.320313,98.56367503879693,-1.4363249612030746,182.71281900090253,38.46268573186225,0.07178990871303736,3858100.0
2783,BSESN,2014-11-03,27860.380859,27969.820313,27785.400391000006,27943.039063,9500.0,-5.4492189999982665,5.4492189999982665,0.0,82.98534439961512,25910.769531,27969.820313,94.68495605078284,-5.315043949217153,243.53410058619556,79.47696870272893,0.06709882207732387,3848600.0
2784,BSESN,2014-11-05,27915.880859,28010.390625,27857.650391000006,27907.189452999995,8700.0,55.5,0.0,55.5,83.68934109528057,25910.769531,28010.390625,95.49872278050188,-4.501277219498124,292.8381348699877,122.1492019361807,0.056225490193253735,3857300.0
2785,BSESN,2014-11-07,27868.630859,27980.929688,27739.560547000005,27902.710938,10500.0,-47.25,47.25,0.0,80.42066523573203,25910.769531,28010.390625,93.2483167365245,-6.751683263475507,324.36023426759857,162.59140840246428,0.04865282500999024,3846800.0
2786,BSESN,2014-11-10,27874.730469,28027.960938,27764.75,27919.449219,7900.0,6.09961000000112,0.0,6.09961000000112,80.53391271269086,25910.769531,28027.960938,92.76255946942817,-7.237440530571831,345.8472014393192,199.24256700983528,0.04059770200053081,3854700.0
2787,BSESN,2014-11-11,27910.060547000005,27996.919922000005,27790.400391000006,27911.25,7000.0,35.330078000006324,0.0,35.330078000006324,81.25839507527655,25910.769531,28027.960938,94.43128332137636,-5.568716678623647,361.5587950303925,231.70581261394676,0.043253633777565526,3861700.0
2788,BSESN,2014-11-12,28008.900391000006,28126.480469,27958.640625,27958.640625,7000.0,98.83984399999828,0.0,98.83984399999828,83.26850273785236,26368.939453,28126.480469,93.30996677007327,-6.690033229926727,377.63277990054485,260.8912060712664,0.04196598410556862,3868700.0
2789,BSESN,2014-11-13,27940.640625,28098.740234,27822.699219,28048.560547000005,8700.0,-68.25976600000286,68.25976600000286,0.0,76.7122190533863,26407.0,28126.480469,89.19209334735407,-10.807906652645931,380.4776268284404,284.8084902227012,0.031089579311997184,3860000.0
2790,BSESN,2014-11-14,28046.660156,28093.230469,27912.900391000006,27949.539063,9900.0,106.01953100000172,0.0,106.01953100000172,79.59192424425275,26712.210938,28126.480469,94.3560749029531,-5.64392509704691,386.8279666172057,305.2123855016021,0.0256096549702447,3869900.0
2791,BSESN,2014-11-17,28177.880859,28205.710938,27921.339844,28018.679688,6700.0,131.2207029999954,0.0,131.2207029999954,82.65500525340316,26726.839844,28205.710938,98.11815383281814,-1.881846167181854,397.86275653013945,323.7424597073096,0.01119833071997256,3876600.0
2792,BSESN,2014-11-18,28163.289063,28282.849609,28119.949219,28209.029297000005,7300.0,-14.591795999996975,14.591795999996975,0.0,81.09331191157482,26764.150391,28282.849609,92.12743744232306,-7.8725625576769405,400.8101807806743,339.1560039219826,0.010872364076176977,3869300.0
2793,BSESN,2014-11-19,28032.849609,28294.009766000006,27963.509766000006,28193.900391000006,6800.0,-130.43945400000302,130.43945400000302,0.0,67.8671370661603,26971.160156,28294.009766000006,80.25775908116987,-19.742240918830127,388.14635238686606,348.9540736149593,0.004190043315874359,3862500.0
2794,BSESN,2014-11-20,28067.560547000005,28118.529297000005,27915.230469,28100.839844,8700.0,34.710938000007445,0.0,34.710938000007445,69.39957187715535,27088.650391000006,28294.009766000006,81.2131366215987,-18.786863378401307,376.570192974199,354.4772974868073,0.007138122034285654,3871200.0
2795,BSESN,2014-11-21,28334.630859,28360.660156,28038.400391000006,28100.099609,10100.0,267.0703119999925,0.0,267.0703119999925,78.50171373301589,27438.279297000005,28360.660156,97.1780315315497,-2.8219684684503012,384.51390843180707,360.48461967580727,0.016498828231235052,3881300.0
2796,BSESN,2014-11-24,28499.539063,28541.960938,28394.480469,28413.009766000006,9700.0,164.90820400000302,0.0,164.90820400000302,82.26103133667351,27739.560547000005,28541.960938,94.71312882249079,-5.286871177509213,399.51076264581206,368.28984826980826,0.021120646263282916,3891000.0
2797,BSESN,2014-11-25,28338.050781,28541.220702999995,28217.5,28520.759766000006,10800.0,-161.48828199999843,161.48828199999843,0.0,68.68915197330425,27739.560547000005,28541.960938,74.58748035430611,-25.412519645693887,393.8253494329001,373.39694850242665,0.011751635566020324,3880200.0
2798,BSESN,2014-11-26,28386.189452999995,28470.150391000006,28261.310547000005,28321.580077999995,8700.0,48.138671999993676,0.0,48.138671999993676,70.37054961444753,27739.560547000005,28541.960938,80.58681342292546,-19.41318657707454,388.72304967426317,376.462168736794,0.01594626386631015,3888900.0
2799,BSESN,2014-11-27,28438.910156,28498.300781,28307.580077999995,28397.800781,11900.0,52.720703000006324,0.0,52.720703000006324,72.253418511176,27764.75,28541.960938,86.74095062722877,-13.259049372771234,384.5012691947086,378.06998882837695,0.013985622452664437,3900800.0
2800,BSESN,2014-11-28,28693.990234,28822.369141000006,28483.990234,28490.710938,14600.0,255.0800779999954,0.0,255.0800779999954,79.5192534076962,27790.400391000006,28822.369141000006,87.55980672864312,-12.44019327135688,397.1600939107848,381.8880098448586,0.0183161174391564,3915400.0
2801,BSESN,2014-12-01,28559.619141000006,28809.640625,28538.439452999995,28748.220702999995,8300.0,-134.3710929999943,134.3710929999943,0.0,68.60033776085197,27822.699219,28822.369141000006,73.71632433690469,-26.28367566309531,391.8328740169891,383.8769826792847,0.014072577855286594,3907100.0
2802,BSESN,2014-12-02,28444.009766000006,28576.390625,28386.460938,28522.460938,11200.0,-115.609375,115.609375,0.0,60.37090312575876,27822.699219,28822.369141000006,62.15156956577944,-37.84843043422055,373.97139405442067,381.89586495431195,0.014667083893890043,3895900.0
2803,BSESN,2014-12-03,28442.710938,28504.650391000006,28370.730469,28472.320313,10100.0,-1.2988280000026862,1.2988280000026862,0.0,60.2771678458568,27912.900391000006,28822.369141000006,58.254947957254565,-41.74505204274543,355.6119645674589,376.6390848769414,0.01336597779389459,3885800.0
2804,BSESN,2014-12-04,28562.820313,28808.779297000005,28448.949219,28616.929688,10400.0,120.109375,0.0,120.109375,65.92279893309367,27915.230469,28822.369141000006,71.38818617138571,-28.611813828614284,346.75661280909844,370.66259046337285,0.008053376630721809,3896200.0
2805,BSESN,2014-12-05,28458.099609,28651.75,28409.050781,28604.5,7700.0,-104.72070400000301,104.72070400000301,0.0,57.676239720437515,27915.230469,28822.369141000006,59.84411829815559,-40.155881701844415,327.5132284877727,362.03271806825285,-0.0014540394463361528,3888500.0
2806,BSESN,2014-12-08,28119.400391000006,28494.849609,28097.119141000006,28433.0,9500.0,-338.6992179999943,338.6992179999943,0.0,39.32010144357592,27915.230469,28822.369141000006,22.50702437256543,-77.49297562743457,281.6854173586653,345.96325792633536,-0.007715787923797346,3879000.0
2807,BSESN,2014-12-09,27797.009766000006,28157.529297000005,27763.820313,28134.220702999995,9600.0,-322.390625,322.390625,0.0,29.13586600928251,27763.820313,28822.369141000006,3.135372891840387,-96.86462710815962,216.8525762477293,320.14112159061415,-0.020755856927380578,3869400.0
2808,BSESN,2014-12-10,27831.099609,27905.25,27710.029297000005,27711.960938,9900.0,34.08984299999429,0.0,34.08984299999429,31.306661584634455,27710.029297000005,28822.369141000006,10.884291581664856,-89.11570841833515,166.3057785084202,289.37405297417536,-0.021372497879345254,3879300.0
2809,BSESN,2014-12-11,27602.009766000006,27796.339844,27539.470702999995,27796.339844,9800.0,-229.08984299999432,229.08984299999432,0.0,25.29766875804262,27539.470702999995,28822.369141000006,4.874825718667727,-95.12517428133226,106.53339076954944,252.80592053325017,-0.03805606885256718,3869500.0
2810,BSESN,2014-12-12,27350.679688,27692.320313,27320.050781,27598.960938,10900.0,-251.33007800000266,251.33007800000266,0.0,20.352608906392092,27320.050781,28822.369141000006,2.038776055429312,-97.96122394457069,38.439993689014955,209.9327351644031,-0.042330377272589814,3858600.0
2811,BSESN,2014-12-15,27319.560547000005,27392.179688,27105.039063,27136.279297000005,9100.0,-31.11914099999558,31.11914099999558,0.0,19.799666414871908,27105.039063,28822.369141000006,12.491569719074333,-87.50843028092567,-17.830035142622364,164.38018110299802,-0.03953202197054828,3849500.0
2812,BSESN,2014-12-16,26781.439453,27199.369141000006,26736.230469,27181.179688,14300.0,-538.1210940000055,538.1210940000055,0.0,12.839617554275094,26736.230469,28822.369141000006,2.1671130786650123,-97.83288692133499,-104.64008762161757,110.5761273580749,-0.058407635215267484,3835200.0
2813,BSESN,2014-12-17,26710.130859,26871.910156,26469.419922,26724.009766,16600.0,-71.30859399999827,71.30859399999827,0.0,12.18471089266734,26469.419922,28822.369141000006,10.230179854977962,-89.76982014502204,-177.14961671916535,53.03097854262683,-0.06486367360427536,3818600.0
2814,BSESN,2014-12-18,27126.570313,27180.919922000005,26900.570313,27053.859375,11200.0,416.4394539999994,0.0,416.4394539999994,34.64687442622635,26469.419922,28809.640625,28.080701540567453,-71.91929845943254,-198.72003644266442,2.680775545568572,-0.046789115025055894,3829800.0
2815,BSESN,2014-12-19,27371.839844,27497.119141000006,27292.140625,27292.550781,11800.0,245.2695309999981,0.0,245.2695309999981,44.324811317718094,26469.419922,28808.779297000005,38.57551480306423,-61.42448519693576,-193.7896615429272,-36.613311872130595,-0.026585223603817543,3841600.0
2816,BSESN,2014-12-22,27701.789063,27725.269531,27382.320313,27479.869141000006,7400.0,329.94921900000185,0.0,329.94921900000185,54.730552658088754,26469.419922,28808.779297000005,52.67977011868889,-47.32022988131111,-161.3976675953454,-61.57018301677357,-0.0034255736067149156,3849000.0
2817,BSESN,2014-12-23,27506.460938,27851.099609,27475.130859,27733.119141000006,8600.0,-195.328125,195.328125,0.0,48.53434347235292,26469.419922,28808.779297000005,44.33012845664201,-55.669871543358,-149.76176586894871,-79.2084995872086,-0.011664600952203119,3840400.0
2818,BSESN,2014-12-24,27208.609375,27571.25,27146.519531,27530.259766000006,10600.0,-297.85156300000017,297.85156300000017,0.0,40.472423891175225,26469.419922,28651.75,33.871569679204114,-66.1284303207959,-162.69887050076068,-95.90657376991904,-0.014252599514858355,3829800.0
2819,BSESN,2014-12-30,27403.539063,27478.300781,27312.289063,27478.300781,6100.0,194.92968800000014,0.0,194.92968800000014,47.10700452118024,26469.419922,28494.849609,46.11955413686001,-53.88044586313999,-155.43071388464523,-107.8114017928643,0.0019326530676015974,3835900.0
2820,BSESN,2014-12-31,27499.419922000005,27527.240234,27346.0,27358.300781,6500.0,95.88085900000442,0.0,95.88085900000442,50.25372167861978,26469.419922,28157.529297000005,61.01500384120557,-38.98499615879443,-140.31638346593172,-114.3123981274778,0.006583538365874331,3842400.0
2821,BSESN,2015-01-02,27887.900391000006,27937.470702999995,27519.259766000006,27521.279297000005,7400.0,388.4804689999983,0.0,388.4804689999983,61.07879804009874,26469.419922,27937.470702999995,96.62339255279555,-3.3766074472044507,-95.88572953143375,-110.627064408269,0.04131446854982479,3849800.0
2822,BSESN,2015-01-05,27842.320313,28064.490234,27786.849609,27978.429688,9200.0,-45.580078000002686,45.580078000002686,0.0,59.330943021416054,26469.419922,28064.490234,86.07146535619299,-13.928534643807014,-63.61869088153617,-101.22538970292244,0.04238801599201114,3840600.0
2823,BSESN,2015-01-06,26987.460938,27698.929688,26937.060547000005,27694.230469,14100.0,-854.859375,854.859375,0.0,36.640472205130244,26469.419922,28064.490234,32.477628860789636,-67.52237113921036,-105.8071584249883,-102.14174344733563,-0.0051281593432154216,3826500.0
2824,BSESN,2015-01-07,26908.820313,27051.599609,26776.119141,26983.429688,12200.0,-78.640625,78.640625,0.0,35.21111043595063,26469.419922,28064.490234,27.547399490436963,-72.45260050956304,-143.9283477148747,-110.49906430084347,-0.01691590823411504,3814300.0
2825,BSESN,2015-01-08,27274.710938,27316.410156,27101.939452999995,27178.769531,8200.0,365.890625,0.0,365.890625,46.430109053182335,26469.419922,28064.490234,50.486239380273744,-49.513760619726256,-142.96731114467184,-116.99271366960916,-0.015416987113313518,3822500.0
2826,BSESN,2015-01-09,27458.380859,27507.669922000005,27119.630859,27404.189452999995,11100.0,183.66992099999698,0.0,183.66992099999698,51.31324741441897,26469.419922,28064.490234,62.00108732260073,-37.99891267739927,-125.93337356807751,-118.78084564930283,-0.0017479558387526462,3833600.0
2827,BSESN,2015-01-12,27585.269531,27620.660156,27323.740234,27523.859375,7500.0,126.88867200000459,0.0,126.88867200000459,54.611308180709386,26776.119141,28064.490234,62.804140390629016,-37.195859609370984,-101.03038455429851,-115.23075343030197,0.013843418118461015,3841100.0
2828,BSESN,2015-01-13,27425.730469,27670.189452999995,27324.580077999995,27611.560547000005,7800.0,-159.53906200000347,159.53906200000347,0.0,49.724652995416655,26776.119141,28064.490234,50.42113499204365,-49.578865007956345,-93.09491509274812,-110.80358576279122,0.000809800732269661,3833300.0
2829,BSESN,2015-01-14,27346.820313,27512.800781,27203.25,27432.140625,10200.0,-78.9101559999981,78.9101559999981,0.0,47.30872422211056,26776.119141,28064.490234,44.29633473622186,-55.703665263778134,-92.11158348505705,-107.06518530724438,-0.005549193744189607,3823100.0
2830,BSESN,2015-01-15,28075.550781,28194.609375,27703.699219,27831.160156,16700.0,728.7304680000017,0.0,728.7304680000017,65.28259331792725,26776.119141,28194.609375,91.60666805126569,-8.39333194873432,-32.1591173025663,-92.08397170630876,0.006728738534240941,3839800.0
2831,BSESN,2015-01-16,28121.890625,28176.099609,27945.310547000005,28056.609375,12100.0,46.33984399999825,0.0,46.33984399999825,66.13030790339965,26776.119141,28194.609375,94.87351070476245,-5.126489295237542,18.8752995105242,-69.89211746294217,0.010041200189391697,3851900.0
2832,BSESN,2015-01-19,28262.009766000006,28334.060547000005,28197.359375,28249.839844,10900.0,140.11914100000286,0.0,140.11914100000286,68.78918517275108,26776.119141,28334.060547000005,95.37525732851613,-4.624742671483875,69.82202137251079,-41.94928969585157,0.04722744503190235,3862800.0
2833,BSESN,2015-01-20,28784.669922000005,28829.289063,28324.849609,28324.849609,11100.0,522.6601560000017,0.0,522.6601560000017,76.67136318717121,26776.119141,28829.289063,97.82681693697656,-2.173183063023439,150.63553930571652,-3.432323895537941,0.06971132837412997,3873900.0
2834,BSESN,2015-01-21,28888.859375,28958.099609,28792.570313,28843.089844,15400.0,104.18945299999541,0.0,104.18945299999541,77.9521020638161,26776.119141,28958.099609,96.8267253068738,-3.1732746931262055,220.54573861742756,41.363288607055175,0.05918113818581716,3889300.0
2835,BSESN,2015-01-22,29006.019531,29060.410156,28892.230469,28957.789063,11100.0,117.16015600000172,0.0,117.16015600000172,79.41818642440805,26776.119141,29060.410156,97.6189275077983,-2.3810724922016973,282.151454356037,89.52092175685155,0.05636307107644822,3900400.0
2836,BSESN,2015-01-23,29278.839844,29408.730469,29165.560547000005,29189.449219,11900.0,272.82031299999653,0.0,272.82031299999653,82.53801084749924,26776.119141,29408.730469,95.06609184506252,-4.933908154937486,348.96608334375924,141.40995407423313,0.06139400998408884,3912300.0
2837,BSESN,2015-01-27,29571.039063,29618.589844,29286.089844,29451.650391000006,11300.0,292.19921900000185,0.0,292.19921900000185,85.29300516819964,26776.119141,29618.589844,98.3271320633204,-1.6728679366795962,420.64624508236375,197.25721227585927,0.07822247784520808,3923600.0
2838,BSESN,2015-01-28,29559.179688,29786.320313,29417.669922000005,29565.720702999995,11200.0,-11.859375,11.859375,0.0,84.66743782467795,27101.939452999995,29786.320313,91.53843523530414,-8.461564764695856,471.0661795489941,252.0190057304863,0.08090005893476038,3912400.0
2839,BSESN,2015-01-29,29681.769531,29740.630859,29378.300781,29516.490234,12700.0,122.58984300000157,0.0,122.58984300000157,85.90081329832807,27119.630859,29786.320313,96.07937917768514,-3.92062082231486,514.9799483926618,304.61119426292146,0.05721058733732853,3925100.0
2840,BSESN,2015-01-30,29182.949219,29844.160156,29070.480469,29801.599609,15800.0,-498.8203120000034,498.8203120000034,0.0,62.35202034685598,27203.25,29844.160156,74.96276291346872,-25.037237086531277,503.7246717614289,344.433889762623,0.03773069912506988,3909300.0
2841,BSESN,2015-02-02,29122.269531,29268.130859,28958.519531,29143.630859,18000.0,-60.67968799999653,60.67968799999653,0.0,60.04170374463058,27203.25,29844.160156,72.6650820225783,-27.334917977421703,484.3254380730141,372.41219942470127,0.03043873284747467,3891300.0
2842,BSESN,2015-02-03,29000.140625,29253.060547000005,28900.410156,29217.400391000006,16600.0,-122.12890600000172,122.12890600000172,0.0,55.28454400094568,27203.25,29844.160156,68.04058142294481,-31.95941857705519,453.8647532165851,388.70271018307807,0.007485606178006199,3874700.0
2843,BSESN,2015-02-04,28883.109375,29133.619141000006,28824.679688,29129.849609,15800.0,-117.03125,117.03125,0.0,50.831481610345016,27703.699219,29844.160156,55.1007558985413,-44.8992441014587,415.49147017275027,394.06046218101255,-0.0001990386648832443,3858900.0
2844,BSESN,2015-02-05,28850.970702999995,29277.830077999995,28753.289063,28912.380859,12800.0,-32.13867200000459,32.13867200000459,0.0,49.56640604130081,27945.310547000005,29844.160156,47.695201963727094,-52.30479803627291,378.1282179398622,390.8740133327825,-0.005345401765116331,3846100.0
2845,BSESN,2015-02-06,28717.910156,28922.849609,28647.140625,28892.210938,11400.0,-133.06054699999368,133.06054699999368,0.0,44.299540778121184,28197.359375,29844.160156,31.609821115332657,-68.39017888466734,333.9313445728985,379.48547958080576,-0.019158193801006917,3834700.0
2846,BSESN,2015-02-09,28227.390625,28566.5,28183.320313,28566.5,11700.0,-490.5195310000017,490.5195310000017,0.0,30.509735637435014,28183.320313,29844.160156,2.6534955905438133,-97.34650440945619,256.3689160196045,354.86216686856557,-0.04543798529153498,3823000.0
2847,BSESN,2015-02-10,28355.619141000006,28633.720702999995,28044.490234,28122.480469,14600.0,128.22851600000286,0.0,128.22851600000286,36.47437349361048,28044.490234,29844.160156,17.28810951367367,-82.71189048632634,202.9081038593904,324.47135426673054,-0.04071698063693552,3837600.0
2848,BSESN,2015-02-11,28533.970702999995,28618.910156,28424.390625,28450.259766000006,13800.0,178.35156199999255,0.0,178.35156199999255,44.16570236796176,28044.490234,29844.160156,27.19834693108764,-72.80165306891236,172.9379841343325,294.16468024025096,-0.03867016172338478,3851400.0
2849,BSESN,2015-02-12,28805.099609,28838.519531,28406.25,28650.25,13800.0,271.12890600000173,0.0,271.12890600000173,53.9462697415414,28044.490234,29844.160156,42.26382658852925,-57.736173411470745,169.11483458182556,269.1547111085659,-0.0129476156492776,3865200.0
2850,BSESN,2015-02-13,29094.929688,29154.669922000005,28835.699219,28888.990234,17600.0,289.830079000003,0.0,289.830079000003,62.128799668351,28044.490234,29844.160156,58.36845085640092,-41.63154914359908,187.31260309104255,252.78628950506123,-0.0009387950678396706,3882800.0
2851,BSESN,2015-02-16,29135.880859,29325.349609,29083.400391000006,29170.769531,10500.0,40.951170999996975,0.0,40.951170999996975,63.19490832493573,28044.490234,29844.160156,60.643933182320495,-39.356066817679505,202.70225755163483,242.769483114376,0.0046806750268990616,3893300.0
2852,BSESN,2015-02-18,29320.259766000006,29411.320313,29126.910156,29136.070313,11000.0,184.37890700000568,0.0,184.37890700000568,67.89076823481147,28044.490234,29844.160156,70.88908451513282,-29.11091548486717,227.15797077801108,239.64718064710306,0.015135156860167642,3904300.0
2853,BSESN,2015-02-19,29462.269531,29522.859375,29108.150391000006,29434.910156,11900.0,142.00976499999888,0.0,142.00976499999888,71.16075499602412,28044.490234,29844.160156,78.77996290699802,-21.22003709300198,255.05814933681904,242.72937438504627,0.021188154613336563,3916200.0
2854,BSESN,2015-02-20,29231.410156,29462.089844,29178.259766000006,29446.210938,11500.0,-230.859375,230.859375,0.0,59.74742253930998,28044.490234,29522.859375,80.28576145719221,-19.714238542807788,255.59448553717448,245.30239661547193,0.01788082758148457,3904700.0
2855,BSESN,2015-02-23,28975.109375,29362.960938,28913.160156,29316.580077999995,8800.0,-256.30078100000173,256.30078100000173,0.0,49.56410065141633,28044.490234,29522.859375,62.94903723237278,-37.05096276762722,232.65628794443182,242.7731748812639,0.02648912044097229,3895900.0
2856,BSESN,2015-02-24,29004.660156,29130.669922000005,28875.939452999995,29016.550781,10200.0,29.55078100000173,0.0,29.55078100000173,50.68235241133934,28044.490234,29522.859375,64.94791425032874,-35.05208574967127,214.39073916443158,237.09668773789744,0.022889326160455248,3906100.0
2857,BSESN,2015-02-25,29007.990234,29269.830077999995,28967.609375,29115.320313,8000.0,3.3300779999954107,0.0,3.3300779999954107,50.82412272059388,28044.490234,29522.859375,65.17316773456653,-34.82683226543346,197.90257196454695,229.25786458322736,0.016612462945795547,3914100.0
2858,BSESN,2015-02-26,28746.650391000006,29069.130859,28693.820313,29051.900391000006,10700.0,-261.3398429999943,261.3398429999943,0.0,40.326852304995775,28044.490234,29522.859375,47.495590751106334,-52.504409248893666,161.88156948071628,215.78260556272514,-0.0020291274390085157,3903400.0
2859,BSESN,2015-02-27,29220.119141000006,29254.019531,28837.060547000005,28865.119141000006,16500.0,473.46875,0.0,473.46875,58.32175544755858,28044.490234,29522.859375,79.52201344007939,-20.477986559920602,169.58476902209077,206.54303825459826,0.004302792766385011,3919900.0
2860,BSESN,2015-03-02,29459.140625,29576.320313,29259.769531,29533.419922000005,15300.0,239.02148399999714,0.0,239.02148399999714,64.54895927112563,28044.490234,29576.320313,92.3503468428759,-7.649653157124107,192.7546902465656,203.78536865299176,0.01109490279577896,3935200.0
2861,BSESN,2015-03-03,29593.730469,29636.859375,29364.869141000006,29500.189452999995,12200.0,134.5898439999983,0.0,134.5898439999983,67.68585175329409,28406.25,29636.859375,96.4953211899591,-3.504678810040898,219.4476395563761,206.91782283366862,0.009327021833452909,3947400.0
2862,BSESN,2015-03-04,29380.730469,30024.740234,29289.050781,29937.269531,17000.0,-213.0,213.0,0.0,58.27053621584103,28406.25,30024.740234,60.20922762021422,-39.79077237978578,220.86863813749733,209.70798589443436,-0.0027675757264459255,3930400.0
2863,BSESN,2015-03-05,29448.949219,29518.320313,29162.470702999995,29436.769531,13400.0,68.21875,0.0,68.21875,60.31077795369039,28693.820313,30024.740234,56.73736594404749,-43.26263405595251,224.90688616387342,212.74776594832218,0.007441962664101798,3943800.0
2864,BSESN,2015-03-09,28844.779297000005,29321.060547000005,28799.759766000006,29316.539063,11800.0,-604.1699219999938,604.1699219999938,0.0,40.217304022384255,28693.820313,30024.740234,11.342454314349718,-88.65754568565029,177.31182304876347,205.66057736841046,-0.0044980012435240635,3932000.0
2865,BSESN,2015-03-10,28709.869141000006,28949.109375,28584.490234,28924.060547000005,11200.0,-134.9101560000017,134.9101560000017,0.0,37.03793921597587,28584.490234,30024.740234,8.705357194931832,-91.29464280506816,127.2395324024692,189.97636837522222,-0.010163574177889934,3920800.0
2866,BSESN,2015-03-11,28659.169922000005,28843.230469,28608.179688,28725.75,12500.0,-50.69921899999825,50.69921899999825,0.0,35.81038432261629,28584.490234,30024.740234,5.185189237979781,-94.81481076202022,82.5146999542012,168.48403469101802,-0.01202497343615161,3908300.0
2867,BSESN,2015-03-12,28930.410156,28971.009766000006,28772.710938,28798.609375,11100.0,271.24023399999714,0.0,271.24023399999714,46.712696203794536,28584.490234,30024.740234,24.01804700572824,-75.98195299427177,68.17093593400568,148.42141493961557,0.0063923887653194456,3919400.0
2868,BSESN,2015-03-13,28503.300781,29183.759766000006,28448.480469,29134.929688,11500.0,-427.109375,427.109375,0.0,35.69687408895973,28448.480469,30024.740234,3.4778729507190955,-96.5221270492809,22.08466428360407,123.15406480841327,-0.024531671364549812,3907900.0
2869,BSESN,2015-03-16,28437.710938,28581.820313,28384.089844,28546.310547000005,11100.0,-65.58984300000158,65.58984300000158,0.0,34.265084563046585,28384.089844,30024.740234,3.2682827692499328,-96.73171723075006,-19.506728779055265,94.62190609091957,-0.03467275912771128,3896800.0
2870,BSESN,2015-03-17,28736.380859,28784.349609,28435.449219,28595.0,11000.0,298.669920999997,0.0,298.669920999997,45.70693258729239,28384.089844,30024.740234,21.472643845834945,-78.52735615416506,-28.04475837768041,70.08857319719958,-0.028970650080701654,3907800.0
2871,BSESN,2015-03-18,28622.119141000006,28806.970702999995,28546.759766000006,28766.869141000006,9700.0,-114.26171799999427,114.26171799999427,0.0,42.44563610381693,28384.089844,30024.740234,14.50822786200099,-85.491772137999,-43.529394303921435,47.36497969697537,-0.025820029519021404,3898100.0
2872,BSESN,2015-03-19,28469.669922000005,28978.740234,28411.699219,28805.220702999995,11400.0,-152.4492189999983,152.4492189999983,0.0,38.24464989269739,28384.089844,30024.740234,5.216228790827654,-94.78377120917234,-67.32636135378198,24.426711486823898,-0.03325345463831275,3886700.0
2873,BSESN,2015-03-20,28261.080077999995,28484.359375,28209.660156,28465.439452999995,13900.0,-208.58984400000918,208.58984400000918,0.0,33.076309398669395,28209.660156,30024.740234,2.8329285645982227,-97.16707143540178,-101.84310245148299,-0.8272513008374861,-0.020235870518888532,3872800.0
2874,BSESN,2015-03-23,28192.019531,28385.140625,28163.900391000006,28317.289063,10000.0,-69.06054699999368,69.06054699999368,0.0,31.45255222960327,28163.900391000006,30024.740234,1.5110994159853297,-98.48890058401467,-133.23463153428747,-27.308727347527494,-0.018037337873493597,3862800.0
2875,BSESN,2015-03-24,28161.720702999995,28455.320313,28130.089844,28209.330077999995,9700.0,-30.298828000006324,30.298828000006324,0.0,30.68987140560776,28130.089844,30024.740234,1.6694826215403837,-98.33051737845962,-158.7277915218474,-53.59254018239148,-0.017357418946671754,3853100.0
2876,BSESN,2015-03-25,28111.830077999995,28249.599609,28031.419922000005,28216.089844,17400.0,-49.890625,49.890625,0.0,29.338228874994485,28031.419922000005,29518.320313,5.407904691309685,-94.59209530869032,-180.8720802127027,-79.04844818845373,-0.028294796844773984,3835700.0
2877,BSESN,2015-03-26,27457.580077999995,27997.140625,27384.869141000006,27937.619141000006,12700.0,-654.25,654.25,0.0,17.605681533430456,27384.869141000006,29321.060547000005,3.755358936862722,-96.24464106313728,-248.35125704784514,-112.90900996033203,-0.03668770543575339,3823000.0
2878,BSESN,2015-03-27,27458.640625,27694.410156,27248.449219,27649.779297000005,11400.0,1.0605470000045898,0.0,1.0605470000045898,17.66726513159425,27248.449219,29183.759766000006,10.86086190796752,-89.13913809203248,-298.3047421916417,-149.988156406594,-0.03442859079391347,3834400.0
2879,BSESN,2015-03-30,27975.859375,28017.970702999995,27624.759766000006,27655.789063,11100.0,517.21875,0.0,517.21875,42.043324821463,27248.449219,29183.759766000006,37.58622393328995,-62.41377606671005,-292.78298847591213,-178.54712282045764,-0.0264654581149808,3845500.0
2880,BSESN,2015-03-31,27957.490234,28180.640625,27868.210938,28069.849609,11100.0,-18.369141000002852,18.369141000002852,0.0,41.53934505389791,27248.449219,29183.759766000006,36.63706665057509,-63.3629333494249,-286.5856144652862,-200.15482114942338,-0.023220814074802476,3834400.0
2881,BSESN,2015-04-01,28260.140625,28298.339844,27889.019531,27954.859375,8100.0,302.65039100000286,0.0,302.65039100000286,52.38915715118397,27248.449219,29183.759766000006,52.275403943220354,-47.724596056779646,-254.32113794453835,-210.98808450844643,-0.007359737488143114,3842500.0
2882,BSESN,2015-04-06,28504.460938,28530.810547000005,28221.990234,28351.939452999995,8300.0,244.32031300000014,0.0,244.32031300000014,59.4066182923794,27248.449219,28978.740234,72.58962267685358,-27.410377323146413,-206.6545158391673,-210.12137077459064,0.008611873973969786,3850800.0
2883,BSESN,2015-04-07,28516.589844,28641.080077999995,28274.359375,28582.330077999995,11900.0,12.128905999998095,0.0,12.128905999998095,59.746468931145436,27248.449219,28978.740234,73.290597593492,-26.70940240650801,-165.98628646499492,-201.29435391267154,0.011512843648646687,3862700.0
2884,BSESN,2015-04-08,28707.75,28763.060547000005,28566.609375,28601.490234,9800.0,191.1601560000017,0.0,191.1601560000017,65.06527164187732,27248.449219,28978.740234,84.33845915798156,-15.66154084201844,-116.98288876768493,-184.43206088367424,0.019389060162855687,3872500.0
2885,BSESN,2015-04-09,28885.210938,28906.710938,28622.439452999995,28858.419922000005,13100.0,177.46093800000014,0.0,177.46093800000014,69.3967028457034,27248.449219,28978.740234,94.59459159244375,-5.405408407556256,-63.100346927709325,-160.16571809248126,0.027510868479716732,3885600.0
2886,BSESN,2015-04-10,28879.380859,28907.810547000005,28756.75,28889.269531,8000.0,-5.830079000003026,5.830079000003026,0.0,69.0720672943684,27248.449219,28907.810547000005,98.28670901748268,-1.713290982517323,-20.630665498356393,-132.2587075736563,0.051781722094992766,3877600.0
2887,BSESN,2015-04-13,29044.439452999995,29072.509766000006,28843.939452999995,28955.130859,8500.0,165.0585939999983,0.0,165.0585939999983,73.17183965526638,27248.449219,29072.509766000006,98.46110848424534,-1.5388915157546554,26.04547606023698,-100.59787084687763,0.05775227002884442,3886100.0
2888,BSESN,2015-04-15,28799.689452999995,29094.609375,28721.630859,29087.25,10500.0,-244.75,244.75,0.0,59.64451714189441,27248.449219,29094.609375,84.02522549078324,-15.974774509216758,42.79407157127207,-71.9194823632477,0.029447891732548248,3875600.0
2889,BSESN,2015-04-16,28666.039063,28876.230469,28497.699219,28876.230469,8400.0,-133.65038999999524,133.65038999999524,0.0,53.421777362781135,27248.449219,29094.609375,76.78585410874832,-23.21414589125167,44.76693926144435,-48.58219803830928,0.02534379241732898,3867200.0
2890,BSESN,2015-04-17,28442.099609,28696.189452999995,28403.759766000006,28682.970702999995,13900.0,-223.93945400000302,223.93945400000302,0.0,44.45493759270557,27248.449219,29094.609375,64.65584180877542,-35.34415819122459,27.938352782100992,-33.278087874227225,0.0064387147401181455,3853300.0
2891,BSESN,2015-04-20,27886.210938,28539.460938,27802.369141000006,28525.650391000006,19000.0,-555.888670999997,555.888670999997,0.0,30.021751367585594,27248.449219,29094.609375,34.54530837572693,-65.45469162427308,-29.90921838869326,-32.604313977120434,-0.021689587512100483,3834300.0
2892,BSESN,2015-04-21,27676.039063,27976.929688,27598.210938,27860.509766000006,20700.0,-210.171875,210.171875,0.0,26.297106596282305,27598.210938,29094.609375,5.201029557076449,-94.79897044292355,-91.65639131864373,-44.414729445425095,-0.029475851972421308,3813600.0
2893,BSESN,2015-04-22,27890.130859,27947.259766000006,27385.480469,27756.679688,11700.0,214.09179599999698,0.0,214.09179599999698,35.676822016434485,27385.480469,29094.609375,29.52675999033171,-70.47324000966829,-121.9107408983109,-59.91393173600227,-0.02848078100861262,3825300.0
2894,BSESN,2015-04-23,27735.019531,28087.779297000005,27621.179688,27977.269531,11400.0,-155.1113279999954,155.1113279999954,0.0,32.246184329715476,27385.480469,29094.609375,20.451298949595035,-79.54870105040497,-156.5985481769858,-79.25085502419898,-0.039819387487555535,3813900.0
2895,BSESN,2015-04-24,27437.939452999995,27829.109375,27344.699219,27804.580077999995,12000.0,-297.08007800000627,297.08007800000627,0.0,26.594708798282014,27344.699219,29094.609375,5.328286922634275,-94.67171307736572,-205.68970200298645,-104.53862441995649,-0.04991247606857174,3801900.0
2896,BSESN,2015-04-27,27176.990234,27567.279297000005,27141.550781,27565.490234,12100.0,-260.94921899999827,260.94921899999827,0.0,22.583265650832175,27141.550781,29094.609375,1.8145616884650968,-98.1854383115349,-262.62385193501177,-136.15566992296758,-0.0642962733717729,3789800.0
2897,BSESN,2015-04-28,27396.380859,27482.140625,27073.25,27215.609375,10300.0,219.390625,0.0,219.390625,32.46522037858155,27073.25,29094.609375,15.985819394436025,-84.01418060556398,-286.7362688112662,-166.27178970062732,-0.048726518259516016,3800100.0
2898,BSESN,2015-04-29,27225.929688,27438.960938,27176.539063,27395.710938,9500.0,-170.45117099999698,170.45117099999698,0.0,29.131696161169188,27073.25,29094.609375,7.553317331313249,-92.44668266868675,-315.95735813811916,-196.20890338812572,-0.05023747340311091,3790600.0
2899,BSESN,2015-04-30,27011.310547000005,27242.050781,26897.539063,27242.050781,10900.0,-214.61914099999558,214.61914099999558,0.0,25.350053343070115,26897.539063,29094.609375,5.178326946507137,-94.82167305349286,-352.3713355749642,-227.44138982549347,-0.05030532491164075,3779700.0
2900,BSESN,2015-05-04,27490.589844,27537.849609,27159.449219,27204.630859,8300.0,479.2792969999937,0.0,479.2792969999937,44.061058007629725,26897.539063,29094.609375,26.99279935470714,-73.00720064529285,-338.65207100753105,-249.683526061901,-0.014186979180484394,3788000.0
2901,BSESN,2015-05-05,27440.140625,27603.710938,27338.230469,27561.320313,11300.0,-50.44921899999825,50.44921899999825,0.0,42.759353466950884,26897.539063,29094.609375,24.696595235774133,-75.30340476422587,-328.06851571387597,-265.360523992296,-0.008523562113170069,3776700.0
2902,BSESN,2015-05-06,26717.369141,27501.150391000006,26677.640625,27473.359375,14200.0,-722.7714840000008,722.7714840000008,0.0,28.728916118208858,26677.640625,28876.230469,1.8069998871512685,-98.19300011284872,-373.6948683731025,-287.0273928684573,-0.0420493444053367,3762500.0
2903,BSESN,2015-05-07,26599.109375,26850.369141000006,26423.990234,26721.339844,12500.0,-118.25976599999922,118.25976599999922,0.0,27.053046708822336,26423.990234,28696.189452999995,7.707032884073869,-92.29296711592613,-414.6172072785048,-312.5453557504668,-0.04095580876481342,3750000.0
2904,BSESN,2015-05-08,27105.390625,27196.279297000005,26814.380859,26814.380859,8800.0,506.28125,0.0,506.28125,43.370908830098266,26423.990234,28539.460938,32.21034400105781,-67.7896559989422,-401.5667781328375,-330.34964022694095,-0.01212003651256821,3758800.0
2905,BSESN,2015-05-11,27507.300781,27544.240234,27231.279297000005,27249.419922000005,11300.0,401.9101560000017,0.0,401.9101560000017,53.00098829433542,26423.990234,28087.779297000005,65.1110510996308,-34.8889489003692,-354.70461432773664,-335.22063504710013,0.012154051797345966,3770100.0
2906,BSESN,2015-05-12,26877.480469,27502.910156,26837.390625,27502.910156,12400.0,-629.8203120000035,629.8203120000035,0.0,40.53655132311946,26423.990234,28087.779297000005,27.25647409788247,-72.74352590211754,-364.1891021690062,-341.0143284714814,-0.018940472198521685,3757700.0
2907,BSESN,2015-05-13,27251.099609,27299.800781,26750.009766,27023.710938,13600.0,373.6191399999989,0.0,373.6191399999989,48.781303075729575,26423.990234,28087.779297000005,49.71239404042158,-50.28760595957842,-337.665289712244,-340.344520719634,0.0009244834350357056,3771300.0
2908,BSESN,2015-05-14,27206.060547000005,27293.990234,26948.619141000006,27290.169922000005,8900.0,-45.03906199999256,45.03906199999256,0.0,47.8583213979554,26423.990234,27829.109375,55.65864773882575,-44.34135226117426,-316.6293471240424,-335.6014860005157,0.007209942652028456,3762400.0
2909,BSESN,2015-05-15,27324.0,27379.570313,27159.759766000006,27233.900391000006,9300.0,117.93945299999541,0.0,117.93945299999541,50.6779903683241,26423.990234,27603.710938,76.2900712811428,-23.7099287188572,-287.1316084224709,-325.90751048490677,-0.00605988612631958,3771700.0
2910,BSESN,2015-05-18,27687.300781,27725.970702999995,27370.279297000005,27416.970702999995,7800.0,363.3007810000017,0.0,363.3007810000017,58.62964476184874,26423.990234,27725.970702999995,97.02991535428372,-2.9700846457162817,-231.76743051756057,-307.0794944914376,0.009007248154363268,3779500.0
2911,BSESN,2015-05-19,27645.529297000005,27872.230469,27574.070313,27663.080077999995,10600.0,-41.77148399999715,41.77148399999715,0.0,57.40190999201993,26423.990234,27872.230469,84.34643876607984,-15.653561233920149,-189.08191173146406,-283.4799779394429,0.03473995329037338,3768900.0
2912,BSESN,2015-05-20,27837.210938,27903.009766000006,27743.990234,27749.300781,16400.0,191.68164099999558,0.0,191.68164099999558,61.65358959423285,26423.990234,27903.009766000006,95.55118600015851,-4.448813999841489,-138.19321867988765,-254.42262608753185,0.04654673002561771,3785300.0
2913,BSESN,2015-05-21,27809.349609,27911.439452999995,27712.730469,27885.359375,8400.0,-27.861329000003025,27.861329000003025,0.0,60.63853748603851,26423.990234,27911.439452999995,93.13658290340634,-6.863417096593668,-98.97086468586713,-223.3322738071989,0.0259711801884428,3776900.0
2914,BSESN,2015-05-22,27957.5,28071.160156,27828.609375,27849.539063,17800.0,148.15039100000288,0.0,148.15039100000288,64.2497869075927,26423.990234,28071.160156,93.09967025976317,-6.900329740236823,-55.29496224968534,-189.7248114956962,0.016366535654816605,3794700.0
2915,BSESN,2015-05-25,27643.880859,27903.289063,27614.320313,27893.25,8300.0,-313.61914100000286,313.61914100000286,0.0,52.487543291659094,26423.990234,28071.160156,74.05979241770049,-25.940207582299497,-45.463859483454144,-160.8726210932478,0.028514592016314788,3786400.0
2916,BSESN,2015-05-26,27531.410156,27675.939452999995,27473.539063,27633.660156,7100.0,-112.47070299999541,112.47070299999541,0.0,48.79141808353651,26423.990234,28071.160156,67.23167459586482,-32.76832540413518,-46.215343772204506,-137.94116562903915,0.010286210502398418,3779300.0
2917,BSESN,2015-05-27,27564.660156,27595.800781,27363.720702999995,27447.400391000006,8600.0,33.25,0.0,33.25,49.99264339245344,26750.009766,28071.160156,61.662199562307286,-38.337800437692714,-43.625021277381165,-119.07793675870755,0.013180872268533594,3787900.0
2918,BSESN,2015-05-28,27506.710938,27666.369141000006,27354.349609,27619.310547000005,9000.0,-57.94921800000157,57.94921800000157,0.0,47.74061644060224,26750.009766,28071.160156,57.27592995677044,-42.72407004322956,-45.721144732691755,-104.40657835350439,0.006686829819938511,3778900.0
2919,BSESN,2015-05-29,27828.439452999995,27888.320313,27467.230469,27553.029297000005,12500.0,321.72851499999524,0.0,321.72851499999524,59.44402175096837,26750.009766,28071.160156,81.62807922268365,-18.37192077731634,-21.177415249152546,-87.76074573263402,0.005097595938165611,3791400.0
2920,BSESN,2015-06-01,27848.990234,27959.429688,27737.580077999995,27770.789063,9600.0,20.550781000001734,0.0,20.550781000001734,60.10255801954679,26750.009766,28071.160156,83.1836009222235,-16.81639907777649,-0.0672809557945584,-70.22205277726613,0.0073596325400098195,3801000.0
2921,BSESN,2015-06-02,27188.380859,27902.529297000005,27146.679688,27890.730469,14500.0,-660.609375,660.609375,0.0,37.51094855988107,26948.619141000006,28071.160156,21.35883810000433,-78.64116189999567,-36.22541897717383,-63.42272601724767,-0.02330801316428921,3786500.0
2922,BSESN,2015-06-03,26837.199219,27276.220702999995,26698.259766,27230.679688,14000.0,-351.1816399999989,351.1816399999989,0.0,30.48275902393334,26698.259766,28071.160156,10.120140835563372,-89.87985916443662,-92.15610900557658,-69.16940261491345,-0.03495768163112245,3772500.0
2923,BSESN,2015-06-04,26813.419922,26948.839844,26551.970703,26940.640625,11600.0,-23.779296999997314,23.779296999997314,0.0,30.042970986380567,26551.970703,28071.160156,17.209783709576705,-82.79021629042329,-136.82316210469435,-82.70015451286963,-0.04092211671286772,3760900.0
2924,BSESN,2015-06-05,26768.490234,27014.419922000005,26718.439453,26819.820313,11900.0,-44.92968800000017,44.92968800000017,0.0,29.12682520283444,26551.970703,28071.160156,14.252306094702815,-85.74769390529718,-173.8436128677713,-100.92884618384998,-0.031666705173018395,3749000.0
2925,BSESN,2015-06-08,26523.089844,26827.060547,26472.869141,26814.310547,7900.0,-245.4003900000025,245.4003900000025,0.0,24.431537037419332,26472.869141,28071.160156,3.1421501171361443,-96.85784988286386,-220.44321522780592,-124.83171999264118,-0.03662436127632418,3741100.0
2926,BSESN,2015-06-09,26481.25,26604.650391,26438.320313,26510.289063,11000.0,-41.839843999998266,41.839843999998266,0.0,23.680564814643176,26438.320313,28071.160156,2.629142544753533,-97.37085745524647,-257.7783531768073,-151.4210466294744,-0.03930431755256647,3730100.0
2927,BSESN,2015-06-10,26840.5,26934.740234,26493.289063,26517.320313,8400.0,359.25,0.0,359.25,41.496529400055316,26438.320313,28071.160156,24.630687983524385,-75.3693120164756,-255.43376492401512,-172.22359028838255,-0.024219941798989897,3738500.0
2928,BSESN,2015-06-11,26370.980469,27000.140625,26348.929688,26959.980469,11300.0,-469.5195310000017,469.5195310000017,0.0,30.692030919211973,26348.929688,27959.429688,1.3691885128840793,-98.63081148711592,-288.14046019120724,-195.40696426894752,-0.05237300447484772,3727200.0
2929,BSESN,2015-06-12,26425.300781,26489.580078,26307.070313,26340.320313,9600.0,54.32031200000347,0.0,54.32031200000347,33.020089477205616,26307.070313,27959.429688,7.155251441594028,-92.84474855840598,-306.1484676604741,-217.5552649472529,-0.05112176208320329,3736800.0
2930,BSESN,2015-06-15,26586.550781,26728.599609,26307.839844,26498.669922,11000.0,161.25,0.0,161.25,39.93116031314695,26307.070313,27959.429688,16.91402440827992,-83.08597559172007,-303.90518613172026,-234.82524918414637,-0.022135561551867022,3747800.0
2931,BSESN,2015-06-16,26686.509766,26731.349609,26379.929688,26586.859375,13100.0,99.95898499999748,0.0,99.95898499999748,44.05969229524237,26307.070313,27959.429688,22.963494427475805,-77.03650557252419,-290.7103862885997,-246.00227660503705,-0.00561494706546406,3760900.0
2932,BSESN,2015-06-17,26832.660156,26983.480469,26728.890625,26815.410156,23000.0,146.15039000000255,0.0,146.15039000000255,49.87205082153864,26307.070313,27959.429688,31.80844621043782,-68.19155378956218,-265.40092069882303,-249.88200542379428,0.000717559865767603,3783900.0
2933,BSESN,2015-06-18,27115.830077999995,27175.390625,26910.259766000006,26916.990234,10500.0,283.16992199999373,0.0,283.16992199999373,59.32116506179454,26307.070313,27959.429688,48.945754612249246,-51.05424538775076,-219.95800179288563,-243.89720469761258,0.012975697955457388,3794400.0
2934,BSESN,2015-06-19,27316.169922000005,27404.599609,27202.380859,27207.759766000006,8100.0,200.33984400000918,0.0,200.33984400000918,64.74601246018511,26307.070313,27902.529297000005,63.24823258508798,-36.75176741491202,-165.86640538745996,-228.29104483558206,0.029901496494738833,3802500.0
2935,BSESN,2015-06-22,27730.210938,27782.310547000005,27417.029297000005,27427.189452999995,8100.0,414.04101599999564,0.0,414.04101599999564,73.25214166791096,26307.070313,27782.310547000005,96.46839831240636,-3.531601687593634,-88.567821110988,-200.34640009066325,0.0471639721689876,3810600.0
2936,BSESN,2015-06-23,27804.369141000006,27882.660156,27666.589844,27760.109375,8600.0,74.15820300000269,0.0,74.15820300000269,74.52255025563426,26307.070313,27882.660156,95.03100281156134,-4.968997188438664,-21.08117824924193,-164.493355722379,0.03591099796948671,3819200.0
2937,BSESN,2015-06-24,27729.669922000005,27948.240234,27647.289063,27852.320313,9400.0,-74.69921899999827,74.69921899999827,0.0,70.62392895243501,26307.070313,27948.240234,86.68204253543615,-13.317957464563849,26.07430143160309,-126.37982429158258,0.0515221439945015,3809800.0
2938,BSESN,2015-06-25,27895.970702999995,27968.75,27635.759766000006,27660.220702999995,10100.0,166.30078099999082,0.0,166.30078099999082,74.10395799394878,26307.070313,27968.75,95.62013680678733,-4.3798631932126755,75.98849395157231,-85.9061606429516,0.05565385742202844,3819900.0
2939,BSESN,2015-06-26,27811.839844,27921.859375,27675.160156,27880.720702999995,9600.0,-84.13085899999714,84.13085899999714,0.0,69.31103466791156,26307.070313,27968.75,90.55713581699445,-9.442864183005552,107.51779570423241,-47.2213693735148,0.04608680054411751,3810300.0
2940,BSESN,2015-06-29,27645.150391000006,27695.320313,27209.189452999995,27451.070313,10900.0,-166.6894529999954,166.6894529999954,0.0,60.38266688056248,26307.070313,27968.75,80.52575285527978,-19.47424714472023,117.69780173034087,-14.237535152743657,0.03592229307638295,3799400.0
2941,BSESN,2015-06-30,27780.830077999995,27814.529297000005,27570.949219,27627.390625,9500.0,135.67968699999255,0.0,135.67968699999255,64.65839934690933,26307.070313,27968.75,88.69096592621436,-11.309034073785643,135.15575525245004,15.64112292829509,0.03533641154054479,3808900.0
2942,BSESN,2015-07-01,28020.869141000006,28099.25,27799.910156,27823.650391000006,18400.0,240.03906300000745,0.0,240.03906300000745,71.03890696502287,26307.070313,28099.25,95.62650667404907,-4.373493325950943,166.4418178210217,45.801261906840416,0.03337677881874246,3827300.0
2943,BSESN,2015-07-02,27945.800781,28115.960938,27906.349609,28100.380859,6800.0,-75.06836000000112,75.06836000000112,0.0,66.6940167947921,26307.839844,28115.960938,90.58911720212484,-9.410882797875166,183.06855814886876,73.2547211552461,0.02304974895081835,3820500.0
2944,BSESN,2015-07-03,28092.789063,28135.429688,27897.449219,27973.119141000006,6000.0,146.98828199999843,0.0,146.98828199999843,70.73759822806433,26379.929688,28135.429688,97.57102677299915,-2.4289732270008546,205.73451613622456,99.7506801514418,0.0130752025583456,3826500.0
2945,BSESN,2015-07-06,28208.759766000006,28235.310547000005,27774.800781,27857.199219,8300.0,115.97070300000269,0.0,115.97070300000269,73.64991999308955,26728.890625,28235.310547000005,98.23749137858269,-1.7625086214173167,230.39941660909608,125.88042744297267,0.014544139554085067,3834800.0
2946,BSESN,2015-07-07,28171.689452999995,28335.230469,28084.359375,28220.109375,8000.0,-37.07031300000745,37.07031300000745,0.0,71.04213801303425,26910.259766000006,28335.230469,88.52320151876107,-11.476798481238937,244.1409584883113,149.53253365204043,0.015940309864608482,3826800.0
2947,BSESN,2015-07-08,27687.720702999995,28031.449219,27635.720702999995,28031.449219,13700.0,-483.96875,483.96875,0.0,46.330372795311995,27202.380859,28335.230469,42.842389644287884,-57.157610355712116,213.51769690093352,162.32956630181906,-0.007465235829832717,3813100.0
2948,BSESN,2015-07-09,27573.660156,27798.130859,27540.599609,27681.490234,8200.0,-114.06054699999369,114.06054699999369,0.0,42.326619013567495,27209.189452999995,28335.230469,32.36744468640256,-67.63255531359744,177.9930158749121,165.46225621643768,-0.008563967336788103,3804900.0
2949,BSESN,2015-07-10,27661.400391000006,27729.460938,27530.900391000006,27705.359375,10800.0,87.74023500000112,0.0,87.74023500000112,46.4352039787857,27209.189452999995,28335.230469,40.15936645064534,-59.84063354935466,155.13109916364192,163.39602480587854,0.0005878065327975524,3815700.0
2950,BSESN,2015-07-13,27961.189452999995,28005.169922000005,27635.060547000005,27739.320313,7800.0,299.7890619999925,0.0,299.7890619999925,58.18042877329938,27209.189452999995,28335.230469,66.78264728502555,-33.21735271497445,159.366262251242,162.59007229495126,0.006492224116183998,3823500.0
2951,BSESN,2015-07-14,27932.900391000006,28018.589844,27853.960938,27986.919922000005,6900.0,-28.28906199999256,28.28906199999256,0.0,56.8237945146565,27209.189452999995,28335.230469,64.27038870847039,-35.729611291529615,158.6115929181433,161.79437641958967,-0.0031394011926376697,3816600.0
2952,BSESN,2015-07-15,28198.289063,28218.369141000006,27986.480469,28022.140625,6000.0,265.3886719999973,0.0,265.3886719999973,65.52535919670908,27209.189452999995,28335.230469,87.83868402179074,-12.161315978209247,177.38339456409085,164.91218004848992,0.00903492742894163,3822600.0
2953,BSESN,2015-07-16,28446.119141000006,28478.429688,28245.810547000005,28259.699219,8500.0,247.83007800000266,0.0,247.83007800000266,71.67607726818915,27209.189452999995,28478.429688,97.4543395246217,-2.545660475378292,209.8391041321156,173.89756486521506,0.012577251664391165,3831100.0
2954,BSESN,2015-07-17,28463.310547000005,28576.320313,28417.460938,28480.919922000005,7300.0,17.191406000001734,0.0,17.191406000001734,72.07485128750774,27530.900391000006,28576.320313,89.19001220258014,-10.809987797419865,234.2474320029978,185.96753829277162,0.009023820370394509,3838400.0
2955,BSESN,2015-07-20,28420.119141000006,28549.130859,28319.830077999995,28544.279297000005,6600.0,-43.19140600000173,43.19140600000173,0.0,69.2485529133638,27530.900391000006,28576.320313,85.05852349731722,-14.941476502682777,247.2558111154758,198.2251928573125,0.008818416389775763,3831800.0
2956,BSESN,2015-07-21,28182.140625,28518.060547000005,28138.300781,28381.820313,11700.0,-237.97851600000286,237.97851600000286,0.0,55.429875623624966,27530.900391000006,28576.320313,62.294607199957056,-37.705392800042944,235.6457899287816,205.70931227160634,0.017857010596991296,3820100.0
2957,BSESN,2015-07-22,28504.929688,28546.419922000005,28070.910156,28159.419922000005,9500.0,322.78906300000017,0.0,322.78906300000017,66.03687199504895,27530.900391000006,28576.320313,93.17110536181265,-6.828894638187355,249.61375225910888,214.49020026910688,0.033773881549684415,3829600.0
2958,BSESN,2015-07-23,28370.839844,28578.330077999995,28315.369141000006,28540.970702999995,8900.0,-134.0898440000019,134.0898440000019,0.0,59.27530503935142,27530.900391000006,28578.330077999995,80.19053340045352,-19.80946659954649,247.01608559188026,220.9953773336616,0.02564727175674064,3820700.0
2959,BSESN,2015-07-24,28112.310547000005,28402.640625,28083.759766000006,28390.5,9300.0,-258.52929699999373,258.52929699999373,0.0,48.278296064257674,27530.900391000006,28578.330077999995,55.50827546861428,-44.49172453138573,221.54245883445765,221.1047936338208,0.005404673297394247,3811400.0
2960,BSESN,2015-07-27,27561.380859,28117.650391000006,27529.570313,28117.650391000006,9500.0,-550.9296880000074,550.9296880000074,0.0,33.15409895751415,27529.570313,28578.330077999995,3.0331585041309017,-96.96684149586909,155.11098174719154,207.90603125649494,-0.013300428054356606,3801900.0
2961,BSESN,2015-07-28,27459.230469,27676.650391000006,27416.390625,27630.210938,11800.0,-102.15038999999888,102.15038999999888,0.0,31.071640536543015,27416.390625,28578.330077999995,3.6869256732259728,-96.31307432677403,93.14713261333236,184.95425152786245,-0.026209341721010526,3790100.0
2962,BSESN,2015-07-29,27563.429688,27609.289063,27470.089844,27540.460938,8600.0,104.1992190000019,0.0,104.1992190000019,35.81661692651265,27416.390625,28578.330077999995,12.654623493535919,-87.34537650646408,51.850639991491335,158.33352922058825,-0.031030224144978913,3798700.0
2963,BSESN,2015-07-30,27705.349609,27854.460938,27649.970702999995,27685.820313,9400.0,141.91992099999698,0.0,141.91992099999698,42.08237551555005,27416.390625,28578.330077999995,24.868678247729825,-75.13132175227017,30.22619485481482,132.71206234743357,-0.0266294019716512,3808100.0
2964,BSESN,2015-07-31,28114.560547000005,28161.169922000005,27814.509766000006,27814.509766000006,15000.0,409.2109380000074,0.0,409.2109380000074,56.28166088460454,27416.390625,28578.330077999995,60.08660091516897,-39.91339908483103,45.58311528784907,115.28627293551666,-0.010751488847884239,3823100.0
2965,BSESN,2015-08-03,28187.060547000005,28263.349609,28071.369141000006,28089.089844,10200.0,72.5,0.0,72.5,58.368168359647974,27416.390625,28578.330077999995,66.32616871819117,-33.67383128180882,62.878900638082996,104.80479847602993,0.00017457588000402424,3833300.0
2966,BSESN,2015-08-04,28071.929688,28264.720702999995,27866.119141000006,28225.039063,13600.0,-115.13085900000442,115.13085900000442,0.0,53.67436540461001,27416.390625,28578.330077999995,56.417661118870946,-43.582338881129054,66.52893287957704,97.14962535673936,-0.015190354957524521,3819700.0
2967,BSESN,2015-08-05,28223.080077999995,28315.710938,28135.679688,28138.039063,9800.0,151.15038999999524,0.0,151.15038999999524,58.704885596104745,27416.390625,28578.330077999995,69.42611776519121,-30.573882234808785,80.68806124109688,93.85731253361088,-0.0052081562199947085,3829500.0
2968,BSESN,2015-08-06,28298.130859,28359.960938,28163.689452999995,28291.880859,7500.0,75.05078100000173,0.0,75.05078100000173,61.12353090187698,27416.390625,28578.330077999995,75.88521344407816,-24.11478655592184,96.84883025092859,94.45561607707444,0.006609926697036528,3837000.0
2969,BSESN,2015-08-07,28236.390625,28335.669922000005,28193.929688,28327.109375,10300.0,-61.74023399999714,61.74023399999714,0.0,57.90434803137843,27416.390625,28578.330077999995,70.57166342728559,-29.428336572714407,103.48156416745769,96.2608056951511,0.024491144672803333,3826700.0
2970,BSESN,2015-08-10,28101.720702999995,28417.589844,28017.849609,28250.779297000005,8700.0,-134.6699220000046,134.6699220000046,0.0,51.12730340131061,27416.390625,28578.330077999995,58.98156536733056,-41.01843463266944,96.75597372408447,96.3598393009378,0.023397969390487328,3818000.0
2971,BSESN,2015-08-11,27866.089844,28205.119141000006,27825.830077999995,28193.259766000006,14700.0,-235.63085899999714,235.63085899999714,0.0,41.35555115322553,27416.390625,28578.330077999995,38.70246576436716,-61.297534235632845,71.58724062202236,91.40531956515471,0.010980496963763686,3803300.0
2972,BSESN,2015-08-12,27512.259766000006,27883.330077999995,27479.429688,27880.759766000006,18200.0,-353.83007799999535,353.83007799999535,0.0,31.06744233249806,27416.390625,28417.589844,9.575431061138957,-90.42456893886104,22.826577517873375,77.68957115569845,-0.00696940647654809,3785100.0
2973,BSESN,2015-08-13,27549.529297000005,27791.099609,27496.289063,27635.25,15900.0,37.26953100000173,0.0,37.26953100000173,33.090447298819925,27416.390625,28417.589844,13.297920081578171,-86.70207991842183,-12.663285147977149,59.61899989496332,-0.020097459786199368,3801000.0
2974,BSESN,2015-08-14,28067.310547000005,28100.640625,27643.199219,27668.060547000005,13200.0,517.78125,0.0,517.78125,54.49720618638018,27416.390625,28417.589844,65.01402614458149,-34.98597385541851,0.9800650157958444,47.89121291912983,-0.004248403262920086,3814200.0
2975,BSESN,2015-08-17,27878.269531,28095.970702999995,27739.130859,28093.539063,12300.0,-189.04101600000286,189.04101600000286,0.0,48.0245344228086,27470.089844,28417.589844,43.07965034300828,-56.92034965699172,-3.4220643660446513,37.62855746209493,-0.006898711957189829,3801900.0
2976,BSESN,2015-08-18,27831.539063,28040.730469,27747.400391000006,27949.130859,11800.0,-46.73046800000157,46.73046800000157,0.0,46.45092934891126,27479.429688,28417.589844,37.53190462716696,-62.46809537283304,-10.559814869011461,27.99088299587365,-0.013873078838946507,3790100.0
2977,BSESN,2015-08-19,27931.640625,28021.390625,27721.25,27851.810547000005,10900.0,100.10156199999984,0.0,100.10156199999984,50.46284911693974,27479.429688,28417.589844,48.20189112785139,-51.79810887214861,-8.046419976821198,20.78342240133468,-0.012951040329345354,3801000.0
2978,BSESN,2015-08-20,27607.820313,27964.599609,27564.160156,27959.189452999995,14400.0,-323.82031199999983,323.82031199999983,0.0,39.434950981839975,27479.429688,28417.589844,13.685363227043748,-86.31463677295625,-31.817358611406235,10.263266198786495,-0.022261000718819757,3786600.0
2979,BSESN,2015-08-21,27366.070313,27442.820313,27131.439452999995,27440.099609,14000.0,-241.75,241.75,0.0,33.18746413368211,27131.439452999995,28417.589844,18.242879032021712,-81.7571209679783,-69.36362268566518,-5.662111578103844,-0.026178126164404625,3772600.0
2980,BSESN,2015-08-24,25741.560547,26730.400391,25624.720703,26730.400391,26000.0,-1624.5097659999994,1624.5097659999994,0.0,14.893183511681102,25624.720703,28417.589844,4.18350585370308,-95.81649414629692,-227.58026535711542,-50.045742333906176,-0.07624066773966287,3746600.0
2981,BSESN,2015-08-25,26032.380859,26124.830078,25298.419922,25916.259766,21200.0,290.82031199999983,0.0,290.82031199999983,23.59326329579511,25298.419922,28417.589844,23.530649350753787,-76.46935064924621,-325.7463250073197,-105.18585886858891,-0.05378979842393239,3767800.0
2982,BSESN,2015-08-26,25714.660156,26156.609375,25657.560547,26063.269531,13400.0,-317.72070299999905,317.72070299999905,0.0,20.900027198907324,25298.419922,28417.589844,13.34458347601369,-86.6554165239863,-424.2900879354529,-169.00670468196174,-0.06660255865786457,3754400.0
2983,BSESN,2015-08-27,26231.189453,26302.769531,25943.75,26137.029297,18600.0,516.5292969999973,0.0,516.5292969999973,34.850656724644494,25298.419922,28417.589844,29.90441541581392,-70.09558458418608,-455.45690883999487,-226.29674551356837,-0.06541849070025207,3773000.0
2984,BSESN,2015-08-28,26392.380859,26687.330078,26270.169922,26542.839844,12100.0,161.1914060000017,0.0,161.1914060000017,38.74095183207634,25298.419922,28205.119141000006,37.635849277048905,-62.364150722951095,-461.82639244509846,-273.4026748998744,-0.05329917161277631,3785100.0
2985,BSESN,2015-08-31,26283.089844,26504.730469,26215.160156,26469.419922,10000.0,-109.29101500000252,109.29101500000252,0.0,37.011913863755844,25298.419922,28100.640625,35.13891396726283,-64.86108603273718,-470.27212133861394,-312.77656418762234,-0.05563649266736215,3775100.0
2986,BSESN,2015-09-01,25696.439453,26141.070313,25579.880859,26127.039063,14000.0,-586.6503909999992,586.6503909999992,0.0,28.99654795042254,25298.419922,28100.640625,14.203718164450313,-85.79628183554969,-518.3282407356528,-353.88689949722846,-0.08002398434123492,3761100.0
2987,BSESN,2015-09-02,25453.560547,25939.369141,25395.089844,25891.949219,16200.0,-242.8789059999981,242.8789059999981,0.0,26.278025745625,25298.419922,28100.640625,5.536345685902245,-94.46365431409775,-569.4471274571406,-396.9989450892109,-0.07803078046641732,3744900.0
2988,BSESN,2015-09-03,25764.779297,25835.410156,25555.769531,25614.689453,11300.0,311.21875,0.0,311.21875,35.25294352652021,25298.419922,28095.970702999995,16.670273804048634,-83.32972619595137,-578.1815443761807,-433.2354649466049,-0.058513736085788026,3756200.0
2989,BSESN,2015-09-04,25201.900391,25775.380859,25119.060547,25772.580078,14100.0,-562.8789060000017,562.8789060000017,0.0,28.111124163003694,25119.060547,28040.730469,2.8353594420854753,-97.16464055791452,-623.3378060378018,-471.2559331648443,-0.020964547002294887,3742100.0
2990,BSESN,2015-09-07,24893.810547,25387.320313,24851.769531,25302.980469,12800.0,-308.08984399999827,308.08984399999827,0.0,24.92242147504662,24851.769531,28021.390625,1.3263735554884353,-98.67362644451157,-676.1900463933489,-512.2427558105453,-0.04373669539358982,3729300.0
2991,BSESN,2015-09-08,25317.869141,25411.0,24833.539063,24972.009766,12600.0,424.0585939999983,0.0,424.0585939999983,36.3829743295665,24833.539063,27964.599609,15.468563155661153,-84.53143684433884,-676.0645913511835,-545.007122918673,-0.015430537000793998,3741900.0
2992,BSESN,2015-09-09,25719.580078,25820.560547,25553.609375,25682.869141,14400.0,401.71093699999983,0.0,401.71093699999983,45.479774392065266,24833.539063,27442.820313,33.95728287243849,-66.04271712756152,-636.2165436645737,-563.2490070678531,-0.019503857265667723,3756300.0
2993,BSESN,2015-09-10,25622.169922,25733.699219,25287.5,25522.960938,14600.0,-97.4101559999981,97.4101559999981,0.0,43.730189042187796,24833.539063,26730.400391,41.575567352175,-58.424432647825,-605.5168430364356,-571.7025742615696,-0.02918307905280748,3741700.0
2994,BSESN,2015-09-11,25610.210938,25875.960938,25530.410156,25793.769531,11800.0,-11.958984000000784,11.958984000000784,0.0,43.49317401223979,24833.539063,26687.330078,41.89640950439068,-58.10359049560931,-575.5178872162542,-572.4656368525065,-0.025601210131449004,3729900.0
2995,BSESN,2015-09-14,25856.699219,25891.730469,25531.070313,25706.869141,8800.0,246.4882809999981,0.0,246.4882809999981,49.9451217333865,24833.539063,26687.330078,55.192853332499226,-44.807146667500774,-525.7929405854447,-563.1310975990941,0.006236652602907178,3738700.0
2996,BSESN,2015-09-15,25705.929688,25909.830078,25649.369141,25908.339844,11200.0,-150.7695309999981,150.7695309999981,0.0,46.22043962544508,24833.539063,26687.330078,47.059815153975194,-52.940184846024806,-492.8699057768572,-549.0788592346468,0.009914885602507306,3727500.0
2997,BSESN,2015-09-16,25963.970703,26006.75,25816.5,25884.050781,9600.0,258.0410149999989,0.0,258.0410149999989,53.12395316083359,24833.539063,26687.330078,60.979454040562366,-39.020545959437634,-440.87428578976323,-527.43794454567,0.007731151262886593,3737100.0
2998,BSESN,2015-09-18,26218.910156,26471.820313,26130.359375,26130.359375,56600.0,254.93945300000266,0.0,254.93945300000266,59.107910040943416,24833.539063,26504.730469,82.89721261288027,-17.10278738711973,-374.7757179162327,-496.90549921978254,0.04035448713078771,3793700.0
2999,BSESN,2015-09-21,26192.980469,26233.460938,25972.539063,26107.980469,8100.0,-25.929687000003465,25.929687000003465,0.0,58.23547474468809,24833.539063,26471.820313,82.97973293657594,-17.020267063424054,-320.7866073723926,-461.68172085030454,0.05218847148961547,3785600.0
3000,BSESN,2015-09-22,25651.839844,26339.099609,25571.339844,26274.369141,13600.0,-541.140625,541.140625,0.0,42.96472314450579,24833.539063,26471.820313,49.948736274678,-50.051263725322,-317.9996719620103,-432.9453110726457,0.013191106294927701,3772000.0
3001,BSESN,2015-09-23,25822.990234,25934.019531,25386.480469,25526.529297,11700.0,171.15039000000255,0.0,171.15039000000255,47.94601969137668,24833.539063,26471.820313,60.395684257510766,-39.604315742489234,-298.53922510815755,-406.0640938797481,0.004020678241494879,3783700.0
3002,BSESN,2015-09-24,25863.5,25949.900391,25670.960938,25798.050781,11800.0,40.50976599999922,0.0,40.50976599999922,49.15869703375802,24833.539063,26471.820313,62.8683833743443,-37.13161662565571,-276.65873156615635,-380.1830214170298,0.009418799373146935,3795500.0
3003,BSESN,2015-09-28,25616.839844,25936.890625,25593.560547,25922.710938,11700.0,-246.6601560000017,246.6601560000017,0.0,42.24440537060146,24833.539063,26471.820313,47.81235096232702,-52.187649037672976,-276.03968232879197,-359.35435359938225,0.0002588383991075638,3783800.0
3004,BSESN,2015-09-29,25778.660156,26054.369141,25287.330078,25496.380859,20700.0,161.82031200000347,0.0,161.82031200000347,47.80195683779959,24833.539063,26471.820313,57.68979489938017,-42.31020510061983,-259.50017803936134,-339.3835184873781,-0.0030181370924039497,3804500.0
3005,BSESN,2015-09-30,26154.830078,26179.699219,25918.210938,25986.519531,27500.0,376.1699219999973,0.0,376.1699219999973,58.51042519015042,25287.330078,26471.820313,73.23825679322711,-26.7617432067729,-213.5767529460536,-314.2221653791132,0.01746291207703554,3832000.0
3006,BSESN,2015-10-01,26220.949219,26431.800781,26168.710938,26344.189453,11000.0,66.11914099999922,0.0,66.11914099999922,60.167718437902415,25287.330078,26471.820313,78.82033244453032,-21.17966755546969,-169.8884769903707,-285.3554277013647,0.009897504466460871,3843000.0
3007,BSESN,2015-10-05,26785.550781,26822.419922,26375.310547,26379.419922,11400.0,564.6015620000035,0.0,564.6015620000035,71.41711483961264,25287.330078,26822.419922,97.59824213910967,-2.4017578608903345,-88.6842788941467,-246.0211979399211,0.02161190612533259,3854400.0
3008,BSESN,2015-10-06,26932.880859,27010.269531,26751.25,26976.660156,13600.0,147.3300779999954,0.0,147.3300779999954,73.65714625080372,25287.330078,27010.269531,95.50833478998632,-4.49166521001367,-12.299282381227385,-199.27681482818235,0.028248041145057634,3868000.0
3009,BSESN,2015-10-07,27035.849609,27082.279297000005,26877.509766000006,26966.859375,17100.0,102.96875,0.0,102.96875,75.2230254234654,25287.330078,27082.279297000005,97.41331467717674,-2.586685322823256,55.90070670874411,-148.24131052079707,0.05395362568208628,3885100.0
3010,BSESN,2015-10-08,26845.810547000005,27120.109375,26762.359375,27116.859375,14900.0,-190.03906199999253,190.03906199999253,0.0,66.77086427007006,25287.330078,27120.109375,85.03372291202854,-14.966277087971452,93.53689028966983,-99.88567035870368,0.03960890290905583,3870200.0
3011,BSESN,2015-10-09,27079.509766000006,27200.439452999995,26910.589844,26974.919922000005,18800.0,233.6992189999983,0.0,233.6992189999983,71.34019408923902,25287.330078,27200.439452999995,93.67889318926215,-6.321106810737841,140.60065398082952,-51.78840549079703,0.04701644270883709,3889000.0
3012,BSESN,2015-10-12,26904.109375,27305.039063,26855.75,27242.599609,18400.0,-175.40039100000286,175.40039100000286,0.0,63.74871969957274,25287.330078,27305.039063,80.12945915488403,-19.870540845115976,161.87963247412335,-9.054797897812946,0.050250910683719896,3870600.0
3013,BSESN,2015-10-13,26846.529297000005,26918.519531,26719.099609,26874.289063,10800.0,-57.5800779999954,57.5800779999954,0.0,61.278751556494484,25287.330078,27305.039063,77.2757236346452,-22.724276365354804,172.11313210876324,27.1787881035023,0.041424540086171024,3859800.0
3014,BSESN,2015-10-14,26779.660156,26869.080077999995,26713.279297,26760.320313,10900.0,-66.86914100000286,66.86914100000286,0.0,58.2542825063205,25287.330078,27305.039063,73.96161136686428,-26.038388633135725,172.83513758765548,56.310058000332944,0.023889663061721578,3848900.0
3015,BSESN,2015-10-15,27010.140625,27037.949219,26836.769531,26842.189453,12700.0,230.4804689999983,0.0,230.4804689999983,65.10398042917765,25287.330078,27305.039063,85.38449101469408,-14.615508985305926,189.81708655729744,83.01146371172587,0.030097743579326375,3861600.0
3016,BSESN,2015-10-16,27214.599609,27239.220702999995,26917.119141000006,27062.800781,10200.0,204.45898399999714,0.0,204.45898399999714,70.12198652247784,25287.330078,27305.039063,95.51771565313224,-4.482284346867759,217.26899303143,109.86296957566671,0.016017920688206955,3871800.0
3017,BSESN,2015-10-19,27364.919922000005,27387.910156,27246.789063,27305.619141000006,8200.0,150.32031300000745,0.0,150.32031300000745,73.370453410135,25287.330078,27387.910156,98.90552927542345,-1.0944707245765433,248.2922610435744,137.54882786924827,0.01604132381017198,3880000.0
3018,BSESN,2015-10-20,27306.830077999995,27432.070313,27216.400391000006,27402.900391000006,9200.0,-58.08984400000919,58.08984400000919,0.0,69.97796420187423,25918.210938,27432.070313,91.72708924829925,-8.27291075170075,265.1347511494605,163.06601252529072,0.01002300548786117,3870800.0
3019,BSESN,2015-10-21,27287.660156,27445.240234,27190.550781,27312.349609,9700.0,-19.16992199999368,19.16992199999368,0.0,68.76723538516657,26168.710938,27445.240234,87.65558467841078,-12.344415321589217,273.779731088267,185.208756237886,0.016458791893298796,3861100.0
3020,BSESN,2015-10-23,27470.810547000005,27555.060547000005,27421.710938,27466.640625,9900.0,183.15039100000286,0.0,183.15039100000286,73.77008907777231,26375.310547,27555.060547000005,92.85865649502016,-7.141343504979847,292.0431541846119,206.57563582723122,0.014450068866878052,3871000.0
3021,BSESN,2015-10-26,27361.960938,27618.140625,27318.199219,27575.039063,11300.0,-108.84960900000442,108.84960900000442,0.0,66.46891211501759,26713.279297,27618.140625,71.68851413218975,-28.311485867810244,294.34081709845486,224.128672081476,0.017017904462782507,3859700.0
3022,BSESN,2015-10-27,27253.439452999995,27296.300781,27209.519531,27291.060547000005,10100.0,-108.52148500000477,108.52148500000477,0.0,59.67469338053753,26713.279297,27618.140625,59.695352125822644,-40.30464787417735,284.1296844856697,236.12887456231473,0.015156899854666284,3849600.0
3023,BSESN,2015-10-28,27039.759766000006,27163.980469,26919.960938,27131.710938,10500.0,-213.67968699999253,213.67968699999253,0.0,48.4282511377266,26713.279297,27618.140625,36.080718547406626,-63.91928145259338,255.8458912023125,240.0722778903143,0.009712580685671268,3839100.0
3024,BSESN,2015-10-29,26838.140625,27099.109375,26794.099609,27083.699219,9900.0,-201.61914100000286,201.61914100000286,0.0,40.18331728784189,26713.279297,27618.140625,13.798946218198772,-86.20105378180124,214.68702320877128,234.99522695400574,-0.006367978693187615,3829200.0
3025,BSESN,2015-10-30,26656.830078,26942.289063,26585.199219,26878.480469,14000.0,-181.31054700000092,181.31054700000092,0.0,34.15044688910682,26585.199219,27618.140625,6.934648817824683,-93.06535118217532,165.5299516786872,221.10217189894206,-0.020495231934830493,3815200.0
3026,BSESN,2015-11-02,26559.150391,26824.300781,26378.259766,26641.689453,8800.0,-97.67968699999984,97.67968699999984,0.0,31.235345765587653,26378.259766,27618.140625,14.589355395476744,-85.41064460452326,117.33808354909706,200.34935422897306,-0.029445345840468096,3806400.0
3027,BSESN,2015-11-03,26590.589844,26732.240234,26514.480469,26660.710938,8500.0,31.43945299999905,0.0,31.43945299999905,33.34828586589808,26378.259766,27618.140625,17.125038785682143,-82.87496121431785,80.75172632449903,176.42982864807826,-0.026229343792527726,3814900.0
3028,BSESN,2015-11-04,26552.919922,26800.060547,26510.310547,26704.019531,8000.0,-37.669921999997314,37.669921999997314,0.0,31.989361937632367,26378.259766,27618.140625,14.086849936603596,-85.9131500633964,48.161945817191736,150.77625208190096,-0.026925732356661847,3806900.0
3029,BSESN,2015-11-05,26304.199219,26557.800781,26243.199219,26557.800781,12300.0,-248.72070300000266,248.72070300000266,0.0,24.41104021108964,26243.199219,27618.140625,4.436552694813522,-95.56344730518647,2.2388201568610384,121.06876569689298,-0.04246730637976781,3794600.0
3030,BSESN,2015-11-06,26265.240234,26438.859375,26190.179688,26284.009766,15600.0,-38.958984999997476,38.958984999997476,0.0,23.408759296091247,26190.179688,27618.140625,5.256484547658227,-94.74351545234178,-36.87418957880436,89.4801746417535,-0.04008194831083489,3779000.0
3031,BSESN,2015-11-09,26121.400391,26193.169922,25656.900391,25809.0,13300.0,-143.83984300000157,143.83984300000157,0.0,19.923819726434445,25656.900391,27618.140625,23.68399301357591,-76.31600698642409,-78.57247027108679,55.869645659185444,-0.04153747507547656,3765700.0
3032,BSESN,2015-11-10,25743.259766,26094.089844,25709.230469,26094.089844,12800.0,-378.140625,378.140625,0.0,13.725567848114366,25656.900391,27618.140625,4.403304271596947,-95.59669572840305,-140.51171474200964,16.593373578946416,-0.047947911195211024,3752900.0
3033,BSESN,2015-11-13,25610.529297,25724.089844,25540.730469,25724.089844,11500.0,-132.7304689999983,132.7304689999983,0.0,12.189696910787447,25540.730469,27618.140625,3.3598963497125904,-96.64010365028741,-198.02652529054467,-26.330606194951812,-0.04574129576087205,3741400.0
3034,BSESN,2015-11-16,25760.099609,25866.419922,25451.419922,25580.150391,11300.0,149.57031199999986,0.0,149.57031199999986,23.34289672862087,25451.419922,27618.140625,14.246399481604065,-85.75360051839593,-228.89973914720395,-66.84443278540225,-0.03363980137083422,3752700.0
3035,BSESN,2015-11-17,25864.470703,25948.199219,25732.789063,25897.880859,10700.0,104.37109399999828,0.0,104.37109399999828,30.45506844477613,25451.419922,27296.300781,22.389021978573084,-77.61097802142692,-242.15371128962943,-101.9062884862477,-0.02615594541892441,3763400.0
3036,BSESN,2015-11-18,25482.519531,25890.359375,25453.320313,25837.710938,16100.0,-381.9511719999973,381.9511719999973,0.0,21.8823393989354,25451.419922,27163.980469,1.815971356719619,-98.18402864328039,-280.2473304064624,-137.57449687029066,-0.04167152062066892,3747300.0
3037,BSESN,2015-11-19,25841.919922,25884.519531,25603.099609,25640.339844,9900.0,359.40039099999916,0.0,359.40039099999916,40.16803186724166,25451.419922,27099.109375,23.699854319574882,-76.30014568042512,-278.2289400574664,-165.70538550772582,-0.026776716161107106,3757200.0
3038,BSESN,2015-11-20,25868.490234,26058.759766,25769.810547,25856.130859,10000.0,26.570311999999827,0.0,26.570311999999827,41.33935053567651,25451.419922,26942.289063,27.974977852197696,-72.0250221478023,-271.3573108774035,-186.8357705816614,-0.01656423681148511,3767200.0
3039,BSESN,2015-11-23,25819.339844,25958.039063,25747.009766,25945.140625,10100.0,-49.150390000002524,49.150390000002524,0.0,39.68127022256227,25451.419922,26824.300781,26.799115129916533,-73.20088487008346,-266.8019936465571,-202.82901519464056,-0.016976825112864913,3757100.0
3040,BSESN,2015-11-24,25775.740234,25901.560547,25703.859375,25785.609375,7500.0,-43.599609999997476,43.599609999997476,0.0,38.11647266245011,25451.419922,26800.060547,24.047941756166498,-75.95205824383349,-263.6705659170184,-214.99732533911617,-0.013232834068080623,3749600.0
3041,BSESN,2015-11-26,25958.630859,26016.039063,25769.810547,25769.810547,8400.0,182.890625,0.0,182.890625,48.03486724768032,25451.419922,26800.060547,37.609050743225225,-62.390949256774775,-243.62280982216907,-220.72242223572675,0.008366115828285725,3758000.0
3042,BSESN,2015-11-27,26128.199219,26184.650391,25937.320313,26003.199219,10400.0,169.56835999999745,0.0,169.56835999999745,55.64078247948759,25451.419922,26557.800781,61.170553656514116,-38.82944634348588,-211.61272935102534,-218.90048365878647,0.02021316763885217,3768400.0
3043,BSESN,2015-11-30,26145.669922,26231.060547,26089.130859,26142.529297,8300.0,17.470703000002686,0.0,17.470703000002686,56.39943863930646,25451.419922,26438.859375,70.30810829876783,-29.69189170123217,-182.7283910861479,-211.66606514425874,0.01496773377635896,3776700.0
3044,BSESN,2015-12-01,26169.410156,26246.019531,26121.519531,26201.269531,11000.0,23.740234000000786,0.0,23.740234000000786,57.53807056621769,25451.419922,26246.019531,90.35874494118963,-9.641255058810371,-156.12202886625164,-200.55725788865735,0.011789897288121631,3787700.0
3045,BSESN,2015-12-02,26117.849609,26256.419922,26041.679688,26239.390625,10100.0,-51.56054700000095,51.56054700000095,0.0,54.00382879480583,25451.419922,26256.419922,82.78629652173912,-17.213703478260893,-137.610512028823,-187.9679087166905,0.024931996117067978,3777600.0
3046,BSESN,2015-12-03,25886.619141,26123.859375,25857.349609,26123.859375,9500.0,-231.2304680000016,231.2304680000016,0.0,40.978869311429996,25451.419922,26256.419922,54.06201478260848,-45.93798521739152,-139.984711247027,-178.3712692227578,0.0017297174178589891,3768100.0
3047,BSESN,2015-12-04,25638.109375,25810.060547,25623.710938,25810.060547,10500.0,-248.5097659999992,248.5097659999992,0.0,31.544350948732827,25451.419922,26256.419922,23.19123639751541,-76.80876360248459,-160.07371235249593,-174.71175784870545,-0.008905848656648785,3757600.0
3048,BSESN,2015-12-07,25530.109375,25785.529297,25477.689453,25746.029297,8700.0,-108.0,108.0,0.0,28.27952471891362,25453.320313,26256.419922,9.561586276404196,-90.4384137235958,-182.60414099806803,-176.290234478578,-0.011202086139596279,3748900.0
3049,BSESN,2015-12-08,25310.330078,25542.470703,25256.789063,25488.419922,12600.0,-219.77929700000092,219.77929700000092,0.0,22.75058377393637,25256.789063,26256.419922,5.356078648228169,-94.64392135177184,-215.7074789739636,-184.17368337765512,-0.018056131532009023,3736300.0
3050,BSESN,2015-12-09,25036.050781,25316.949219,25012.220703,25299.339844,11600.0,-274.2792969999973,274.2792969999973,0.0,17.752679694011988,25012.220703,26256.419922,1.9152944027047047,-98.0847055972953,-261.0647677018169,-199.5519002424875,-0.035540398220969216,3724700.0
3051,BSESN,2015-12-10,25252.320313,25289.580078,25034.140625,25136.710938,10900.0,216.26953199999843,0.0,216.26953199999843,31.453087364403828,25012.220703,26256.419922,19.297521356184095,-80.7024786438159,-276.37373759740876,-214.9162677134718,-0.0335223602154362,3735600.0
3052,BSESN,2015-12-11,25044.429688,25316.140625,24930.429688,25281.769531,14900.0,-207.890625,207.890625,0.0,26.548149988003757,24930.429688,26256.419922,8.597348387409008,-91.40265161259099,-301.8022540387101,-232.29346497851947,-0.04211941163815325,3720700.0
3053,BSESN,2015-12-14,25150.349609,25194.150391,24867.730469,24935.599609,11600.0,105.91992100000058,0.0,105.91992100000058,32.71650522363919,24867.730469,26256.419922,20.35150043009666,-79.64849956990334,-309.83608656635624,-247.80198929608687,-0.0389409062307946,3732300.0
3054,BSESN,2015-12-15,25320.439453,25342.779297,25075.539063,25186.679688,9700.0,170.0898439999983,0.0,170.0898439999983,41.77624078773523,24867.730469,26256.419922,32.59972796812189,-67.4002720318781,-299.0310836228673,-258.04780816144296,-0.030531233158078264,3742000.0
3055,BSESN,2015-12-16,25494.369141,25572.900391,25372.470703,25402.470703,10800.0,173.92968800000014,0.0,173.92968800000014,49.7582937071818,24867.730469,26256.419922,45.12446397906068,-54.87553602093932,-273.283130893662,-261.0948727078868,-0.015152616023880183,3752800.0
3056,BSESN,2015-12-17,25803.779297,25831.310547,25448.320313,25596.630859,22700.0,309.41015600000173,0.0,309.41015600000173,60.79153179114609,24867.730469,26256.419922,67.40519458672671,-32.59480541327328,-225.3136041355283,-253.9386189934151,0.006461861893823917,3775500.0
3057,BSESN,2015-12-18,25519.220703,25789.509766,25481.509766,25764.669922,10400.0,-284.55859400000185,284.55859400000185,0.0,49.30230329238207,24867.730469,26256.419922,46.9140334142078,-53.0859665857922,-207.86279603573712,-244.72345440187954,-0.00042650314732550765,3765100.0
3058,BSESN,2015-12-21,25735.900391,25757.839844,25413.539063,25425.320313,8100.0,216.67968800000014,0.0,216.67968800000014,56.52189716341599,24867.730469,26256.419922,62.517211470461085,-37.482788529538915,-174.5367143389085,-230.68610638928533,0.016814095734370094,3773200.0
3059,BSESN,2015-12-22,25590.650391,25787.210938,25485.169922,25731.070313,8100.0,-145.25,145.25,0.0,50.91391204110769,24867.730469,26123.859375,57.551412004525595,-42.44858799547441,-158.02440857256806,-216.15376682594186,0.022152040465618805,3765100.0
3060,BSESN,2015-12-23,25850.300781,25875.269531,25689.699219,25697.660156,6900.0,259.6503900000025,0.0,259.6503900000025,59.252807960419986,24867.730469,25875.269531,97.5218082413166,-2.4781917586833884,-122.57371729042643,-197.43775691883877,0.023680218712106127,3772000.0
3061,BSESN,2015-12-24,25838.710938,25922.470703,25763.400391,25893.839844,4900.0,-11.589843000001563,11.589843000001563,0.0,58.73886823657352,24867.730469,25922.470703,92.05873045324648,-7.94126954675352,-94.32665356463986,-176.815536247999,0.031714886699160116,3767100.0
3062,BSESN,2015-12-28,26034.130859,26073.410156,25856.859375,25858.519531,6900.0,195.4199210000006,0.0,195.4199210000006,64.69634207948911,24867.730469,26073.410156,96.74214491431498,-3.257855085685029,-55.531762035156135,-152.55878140543044,0.03513991907626379,3774000.0
3063,BSESN,2015-12-29,26079.480469,26133.779297,25994.449219,26075.679688,6000.0,45.349609999997476,0.0,45.349609999997476,66.01041509964801,24867.730469,26133.779297,95.71115846410288,-4.288841535897111,-20.88643069968748,-126.22431126428185,0.029977402936032682,3780000.0
3064,BSESN,2015-12-30,25960.029297,26130.199219,25939.25,26123.869141,6500.0,-119.45117199999731,119.45117199999731,0.0,59.30180613060694,24867.730469,26133.779297,86.27620071538034,-13.723799284619664,-3.0334990072296932,-101.58614881287143,0.018265215876674734,3773500.0
3065,BSESN,2015-12-31,26117.539063,26147.630859,25941.910156,25980.859375,6200.0,157.50976599999922,0.0,157.50976599999922,64.75208175101946,24867.730469,26147.630859,97.64889547381101,-2.3511045261889914,23.553292045351554,-76.55826064122684,0.012159450070807098,3779700.0
3066,BSESN,2016-01-04,25623.349609,26116.519531,25596.570313,26116.519531,9100.0,-494.1894539999994,494.1894539999994,0.0,43.6094897892258,24867.730469,26147.630859,59.03733961671822,-40.96266038328178,4.692464863797795,-60.30811554022191,0.004080410887616237,3770600.0
3067,BSESN,2016-01-05,25580.339844,25766.759766,25513.75,25744.699219,10300.0,-43.009765000002524,43.009765000002524,0.0,42.22498179732899,25075.539063,26147.630859,47.085593125833206,-52.91440687416679,-13.568990276886325,-50.96029048755479,-0.006044496001173627,3760300.0
3068,BSESN,2016-01-06,25406.330078,25632.570313,25357.699219,25628.230469,13400.0,-174.00976599999925,174.00976599999925,0.0,36.77470980739435,25357.699219,26147.630859,6.156337654736887,-93.84366234526311,-41.60288671728631,-49.0888097335011,-0.007202642769283618,3746900.0
3069,BSESN,2016-01-07,24851.830078,25230.349609,24825.699219,25224.699219,11800.0,-554.5,554.5,0.0,24.93882875190394,24825.699219,26147.630859,1.9767178732480246,-98.02328212675198,-107.32627695729389,-60.73630317825966,-0.038625109682819625,3735100.0
3070,BSESN,2016-01-08,24934.330078,25083.550781,24887.220703,24969.019531,15900.0,82.5,0.0,82.5,28.86899213323572,24825.699219,26147.630859,8.217585214920838,-91.78241478507915,-151.0146735617709,-78.79197725496192,-0.03500100535859019,3751000.0
3071,BSESN,2016-01-11,24825.039063,24961.880859,24598.900391,24787.109375,10600.0,-109.29101499999888,109.29101499999888,0.0,26.72971059986044,24598.900391,26147.630859,14.601551184825063,-85.39844881517494,-192.24088094634135,-101.48175799323782,-0.046442564284108534,3740400.0
3072,BSESN,2016-01-12,24682.029297,24882.300781,24597.109375,24862.929688,10300.0,-143.00976599999922,143.00976599999922,0.0,24.040031345954603,24597.109375,26147.630859,5.476862002642261,-94.52313799735774,-233.7580232682012,-127.93701104823053,-0.053584317895485345,3730100.0
3073,BSESN,2016-01-13,24854.109375,24956.539063,24387.689453,24804.640625,14000.0,172.08007799999905,0.0,172.08007799999905,33.35133511947791,24387.689453,26147.630859,26.50201423808086,-73.49798576191914,-249.89460407002116,-152.32852965258868,-0.04260087341765073,3744100.0
3074,BSESN,2016-01-14,24772.970703,25018.460938,24473.220703,24606.199219,14900.0,-81.13867200000095,81.13867200000095,0.0,31.266146775222396,24387.689453,26147.630859,21.89170893340523,-78.10829106659477,-266.1620232159439,-175.09522836525974,-0.05148143386544468,3729200.0
3075,BSESN,2016-01-15,24455.039063,24912.640625,24421.529297,24881.759766,12700.0,-317.9316399999989,317.9316399999989,0.0,24.375755167413047,24387.689453,26147.630859,3.826809788689127,-96.17319021131088,-301.23603487481887,-200.3233896671716,-0.045595543277044515,3716500.0
3076,BSESN,2016-01-18,24188.369141,24524.849609,24141.990234,24400.779297,13600.0,-266.6699220000009,266.6699220000009,0.0,20.090729402485096,24141.990234,26147.630859,2.3124235928357524,-97.68757640716424,-346.5555986431682,-229.56983146237098,-0.05441564543273625,3702900.0
3077,BSESN,2016-01-19,24479.839844,24563.339844,24247.230469,24257.279297,9400.0,291.47070299999905,0.0,291.47070299999905,34.591698073170434,24141.990234,26147.630859,16.84497241373925,-83.15502758626076,-354.8618036509288,-254.62822590008255,-0.03646690534034558,3712300.0
3078,BSESN,2016-01-20,24062.039063,24325.769531,23839.759766,24325.769531,12800.0,-417.8007809999981,417.8007809999981,0.0,26.60615848177632,23839.759766,26147.630859,9.631356693803037,-90.36864330619696,-390.65434219944655,-281.8334491599554,-0.03177999417029487,3699500.0
3079,BSESN,2016-01-21,23962.210938,24351.830078,23862.0,24194.75,13200.0,-99.828125,99.828125,0.0,25.01413507156792,23839.759766,26116.519531,5.378308852888606,-94.62169114711139,-422.20852519672917,-309.9084643673102,-0.03898717699489018,3686300.0
3080,BSESN,2016-01-22,24435.660156,24472.880859,24120.039063,24122.060547,10100.0,473.4492180000016,0.0,473.4492180000016,43.511045997089106,23839.759766,25766.759766,30.92373585884808,-69.07626414115192,-404.35094149150245,-328.7969597921487,-0.01568492625577944,3696400.0
3081,BSESN,2016-01-25,24485.949219,24650.570313,24433.669922,24540.970703,8900.0,50.28906299999653,0.0,50.28906299999653,45.16870927313597,23839.759766,25632.570313,36.043376366861516,-63.956623633138484,-381.7403060245415,-339.3856290386273,-0.007944244601631456,3705300.0
3082,BSESN,2016-01-27,24492.390625,24645.699219,24458.130859,24643.130859,8500.0,6.4414060000017335,0.0,6.4414060000017335,45.4054848117903,23839.759766,25230.349609,46.93194490706488,-53.06805509293512,-359.1612594561266,-343.3407551221272,-0.014553679817786658,3713800.0
3083,BSESN,2016-01-28,24469.570313,24587.199219,24400.519531,24481.859375,8400.0,-22.820311999999827,22.820311999999827,0.0,44.61788401775303,23839.759766,25083.550781,50.63636410012173,-49.363635899878275,-339.1985411993264,-342.51231233756704,-0.012247234844679267,3705400.0
3084,BSESN,2016-01-29,24870.689453,24911.900391,24340.060547,24347.310547,12400.0,401.1191399999989,0.0,401.1191399999989,59.03087785395828,23839.759766,25018.460938,87.46319351246042,-12.536806487539575,-287.6946163975663,-331.5487731495669,0.01699651302658811,3717800.0
3085,BSESN,2016-02-01,24824.830078,25002.320313,24788.580078,24982.220703,10100.0,-45.859375,45.859375,0.0,57.07155059257246,23839.759766,25018.460938,83.5725233333355,-16.427476666664496,-247.72226515518923,-314.7834715506914,0.02631268496399697,3707700.0
3086,BSESN,2016-02-02,24539.0,24928.75,24460.529297,24868.210938,12700.0,-285.83007799999905,285.83007799999905,0.0,46.073685339215004,23839.759766,25018.460938,59.322943813955945,-40.677056186044055,-236.38310997492226,-299.10339923553755,0.0024166888499681516,3695000.0
3087,BSESN,2016-02-03,24223.320313,24409.259766,24187.539063,24393.589844,12200.0,-315.67968699999983,315.67968699999983,0.0,36.99004050313021,23839.759766,25018.460938,32.54094897939074,-67.45905102060927,-249.98775704480067,-289.2802707973902,0.006702725798829023,3682800.0
3088,BSESN,2016-02-04,24338.429688,24514.009766,24224.740234,24386.449219,12200.0,115.109375,0.0,115.109375,41.81640081922597,23839.759766,25002.320313,42.89410330385145,-57.10589669614855,-248.61529099362087,-281.1472748366363,0.01570050238575349,3695000.0
3089,BSESN,2016-02-05,24616.970703,24672.900391,24345.789063,24360.359375,13400.0,278.5410149999989,0.0,278.5410149999989,52.06743293726542,23839.759766,25002.320313,66.85337284200813,-33.146627157991865,-222.48697832111793,-269.41521553353266,0.007419916050660724,3708400.0
3090,BSESN,2016-02-08,24287.419922,24698.949219,24196.839844,24637.410156,11700.0,-329.55078099999815,329.55078099999815,0.0,41.972321817856134,23839.759766,25002.320313,38.506394970583955,-61.493605029416045,-225.76956512959805,-260.6860854527457,-0.008107886495408834,3696700.0
3091,BSESN,2016-02-09,24020.980469,24111.189453,23919.470703,24076.849609,11500.0,-266.4394530000027,266.4394530000027,0.0,35.54352714876137,23839.759766,25002.320313,15.588065797316181,-84.41193420268382,-247.02294916325627,-257.9534581948478,-0.019247208784871406,3685200.0
3092,BSESN,2016-02-10,23758.900391,23938.320313,23636.720703,23938.320313,19400.0,-262.08007799999905,262.08007799999905,0.0,30.279701116260412,23636.720703,25002.320313,8.946962719182388,-91.05303728081762,-281.7660574156798,-262.7159780390142,-0.029043007821941247,3665800.0
3093,BSESN,2016-02-11,22951.830078,23758.460938,22909.119141,23758.460938,23200.0,-807.0703130000003,807.0703130000003,0.0,19.83968691586277,22909.119141,25002.320313,2.040460208570904,-97.9595397914291,-370.1571095631298,-284.2042043438373,-0.0771534451679039,3642600.0
3094,BSESN,2016-02-12,22986.119141,23161.150391,22600.390625,23060.390625,25100.0,34.28906300000017,0.0,34.28906300000017,21.172047882922683,22600.390625,25002.320313,16.05910938721863,-83.94089061278137,-432.45573388876073,-313.854510252822,-0.074067412796895,3667700.0
3095,BSESN,2016-02-15,23554.119141,23622.640625,23197.669922,23223.429688,20400.0,568.0,0.0,568.0,40.17715043324818,22600.390625,25002.320313,39.70676247372313,-60.29323752627687,-431.02638560954074,-337.2888853241658,-0.040135329842291845,3688100.0
3096,BSESN,2016-02-16,23191.970703,23692.080078,23164.539063,23688.609375,22200.0,-362.14843800000017,362.14843800000017,0.0,34.12453710800075,22600.390625,25002.320313,24.629367002519807,-75.37063299748019,-453.883878329696,-360.6078839252719,-0.042576723449695875,3665900.0
3097,BSESN,2016-02-17,23381.869141,23434.910156,22920.839844,23237.230469,16600.0,189.89843800000014,0.0,189.89843800000014,39.62737292855418,22600.390625,25002.320313,32.53544514247243,-67.46455485752757,-451.47111115227017,-378.7805293706716,-0.03930247593054992,3682500.0
3098,BSESN,2016-02-18,23649.220703,23735.349609,23448.210938,23536.470703,15700.0,267.35156199999983,0.0,267.35156199999983,46.84093026543028,22600.390625,25002.320313,43.666144069076466,-56.33385593092353,-423.10860643887645,-387.64614478431264,-0.039312310668755956,3698200.0
3099,BSESN,2016-02-19,23709.150391,23774.480469,23508.359375,23640.320313,11600.0,59.92968800000017,0.0,59.92968800000017,48.43451698442567,22600.390625,24928.75,47.61978661477029,-52.38021338522971,-391.2848044846396,-388.3738767243781,-0.02380942614971604,3709800.0
3100,BSESN,2016-02-22,23788.789063,23855.039063,23674.859375,23783.470703,9500.0,79.63867200000095,0.0,79.63867200000095,50.70057030214272,22600.390625,24698.949219,56.62927122443745,-43.37072877556255,-355.5395977286462,-381.80702092523177,-0.009666191865051021,3719300.0
3101,BSESN,2016-02-23,23410.179688,23851.509766,23361.939453,23850.410156,16700.0,-378.609375,378.609375,0.0,40.85261340387362,22600.390625,24698.949219,38.58787004162157,-61.41212995837842,-353.68481781749506,-376.18258030368446,-0.014677476535576384,3702600.0
3102,BSESN,2016-02-24,23088.929688,23338.890625,23057.449219,23332.939453,14000.0,-321.25,321.25,0.0,34.32513772188625,22600.390625,24698.949219,23.27974374395765,-76.72025625604235,-373.82782708576997,-375.7116296601016,0.005973362888017197,3688600.0
3103,BSESN,2016-02-25,22976.0,23142.960938,22948.099609,23105.160156,15900.0,-112.92968800000016,112.92968800000016,0.0,32.23594401107081,22600.390625,24698.949219,17.89844591777933,-82.10155408222067,-394.35787695594627,-379.44087911927056,-0.0004402283368465376,3672700.0
3104,BSESN,2016-02-26,23154.300781,23227.910156,23021.939453,23141.080078,11500.0,178.3007810000017,0.0,178.3007810000017,38.99974885470598,22600.390625,24111.189453,36.66339592897818,-63.33660407102182,-391.7251428775271,-381.8977318709219,-0.01697445604340364,3684200.0
3105,BSESN,2016-02-29,23002.0,23343.220703,22494.609375,23238.5,58900.0,-152.3007810000017,152.3007810000017,0.0,35.50674306900693,22494.609375,23938.320313,35.1448902716563,-64.85510972834369,-397.34770534170093,-384.98772656507776,-0.008191227275715085,3625300.0
3106,BSESN,2016-03-01,23779.349609,23821.490234,23133.179688,23153.320313,15700.0,777.3496090000008,0.0,777.3496090000008,57.77778945691667,22494.609375,23855.039063,94.43635678729768,-5.563643212702321,-335.2138728752652,-375.0329558271153,0.016999516403204185,3641000.0
3107,BSESN,2016-03-02,24242.980469,24280.419922,24043.890625,24044.960938,22800.0,463.6308599999975,0.0,463.6308599999975,65.885061761967,22494.609375,24280.419922,97.90350364640317,-2.0964963535968337,-245.72862073916622,-349.1720888095255,0.025106948489202363,3663800.0
3108,BSESN,2016-03-03,24606.990234,24640.509766,24383.279297,24386.669922,19500.0,364.0097650000025,0.0,364.0097650000025,70.94002136551326,22494.609375,24640.509766,98.43797353593014,-1.562026464069853,-143.78095053864672,-308.09386115534977,0.03786891677657178,3683300.0
3109,BSESN,2016-03-04,24646.480469,24719.050781,24531.800781,24704.589844,17500.0,39.490234999997476,0.0,39.490234999997476,71.46921117186976,22494.609375,24719.050781,96.73759390540658,-3.2624060945934135,-59.11867222725414,-258.29882336973066,0.0360544373960594,3700800.0
3110,BSESN,2016-03-08,24659.230469,24793.619141,24509.210938,24655.189453,26000.0,12.75,0.0,12.75,71.66145926267106,22494.609375,24793.619141,94.15449755858057,-5.845502441419424,8.90298368312142,-204.85846195916022,0.05335502749858256,3726800.0
3111,BSESN,2016-03-09,24793.960938,24820.759766,24451.599609,24527.269531,11900.0,134.7304690000019,0.0,134.7304690000019,73.81294494841924,22494.609375,24820.759766,98.8479322702571,-1.1520677297428898,72.84257505811183,-149.3182545557058,0.07384626628605284,3738700.0
3112,BSESN,2016-03-10,24623.339844,24817.480469,24471.390625,24815.699219,14400.0,-170.6210940000019,170.6210940000019,0.0,66.44207157810925,22494.609375,24820.759766,91.5130198475632,-8.4869801524368,108.4967821689097,-97.7552472107827,0.07169828708217252,3724300.0
3113,BSESN,2016-03-11,24717.990234,24817.800781,24552.259766,24620.390625,14800.0,94.65039000000252,0.0,94.65039000000252,68.45816636346719,22494.609375,24820.759766,95.5819910699833,-4.418008930016704,142.74501791475632,-49.65519418567489,0.06753343440554826,3739100.0
3114,BSESN,2016-03-14,24804.279297,24960.509766,24734.039063,24801.699219,30100.0,86.28906300000017,0.0,86.28906300000017,70.33303228004647,22494.609375,24960.509766,93.66436415800875,-6.335635841991248,174.8344154146107,-4.757272265617759,0.07835315611685933,3769200.0
3115,BSESN,2016-03-15,24551.169922,24840.769531,24517.279297,24832.039063,12100.0,-253.109375,253.109375,0.0,58.553308613302704,22494.609375,24960.509766,83.3999846265486,-16.60001537345141,177.79220501803866,31.752623191113535,0.032457587179250735,3757100.0
3116,BSESN,2016-03-16,24682.480469,24706.849609,24354.550781,24537.609375,11000.0,131.31054699999729,0.0,131.31054699999729,62.32999343437034,22494.609375,24960.509766,88.7250394211077,-11.274960578892298,188.5583549806288,63.1137695490166,0.018128959042886583,3768100.0
3117,BSESN,2016-03-17,24677.369141,24948.300781,24576.519531,24852.179688,14600.0,-5.111327999999048,5.111327999999048,0.0,62.07593932579481,22494.609375,24960.509766,88.51775902897774,-11.482240971022259,194.4368183304614,89.37837930530557,0.0028601184594592155,3753500.0
3118,BSESN,2016-03-18,24952.740234,24986.939453,24681.640625,24729.410156,14100.0,275.3710930000016,0.0,275.3710930000016,69.74241705160765,22494.609375,24986.939453,98.62782143898686,-1.3721785610131483,218.79357260932375,115.26141796610922,0.012426105438673618,3767600.0
3119,BSESN,2016-03-21,25285.369141,25327.449219,24988.269531,25007.560547,12400.0,332.62890699999843,0.0,332.62890699999843,76.39361745194566,23133.179688,25327.449219,98.08227396837516,-1.9177260316248308,261.9176254077611,144.5926594544396,0.025391654974275868,3780000.0
3120,BSESN,2016-03-22,25330.490234,25381.330078,25083.699219,25331.009766,12000.0,45.12109300000157,0.0,45.12109300000157,77.17880204321713,24043.890625,25381.330078,96.1987180888107,-3.8012819111893137,296.31886364689854,174.9379002929314,0.021639515257027675,3792000.0
3121,BSESN,2016-03-23,25337.560547,25367.810547,25156.820313,25322.099609,9500.0,7.070313000000169,0.0,7.070313000000169,77.31522383883917,24354.550781,25381.330078,95.73720164324678,-4.262798356753215,320.4585611545226,204.04203246524966,0.029005841917664865,3801500.0
3122,BSESN,2016-03-28,24966.400391,25432.939453,24895.490234,25417.109375,10100.0,-371.1601560000017,371.1601560000017,0.0,56.76221973317141,24354.550781,25432.939453,56.737392174683286,-43.262607825316714,306.11126258466174,224.4558784891321,0.01004977162982712,3791400.0
3123,BSESN,2016-03-29,24900.460938,25079.349609,24835.560547,24957.240234,11000.0,-65.93945299999905,65.93945299999905,0.0,53.82891094696954,24354.550781,25432.939453,50.62276442384586,-49.37723557615414,286.1219268551722,236.78908816234016,0.003877622883065701,3780400.0
3124,BSESN,2016-03-30,25338.580078,25358.839844,25055.419922,25062.060547,10700.0,438.1191399999989,0.0,438.1191399999989,66.93043217698393,24354.550781,25432.939453,91.24996604192813,-8.750033958071866,302.14979263001806,249.86122905587575,0.032072205051801195,3791100.0
3125,BSESN,2016-03-31,25341.859375,25479.619141,25223.220703,25364.75,11500.0,3.279297000000952,0.0,3.279297000000952,67.01127724660302,24354.550781,25479.619141,87.755431501069,-12.244568498930992,311.5255311871733,262.1940894821353,0.026714450633442244,3802600.0
3126,BSESN,2016-04-01,25269.640625,25354.939453,25119.349609,25301.699219,11400.0,-72.21875,72.21875,0.0,63.091911202984875,24354.550781,25479.619141,81.33637710689867,-18.66362289310133,309.56000690930887,271.66727296757006,0.024000592632704043,3791200.0
3127,BSESN,2016-04-04,25399.650391,25424.150391,25223.490234,25333.980469,7800.0,130.00976599999922,0.0,130.00976599999922,67.09014195476337,24354.550781,25479.619141,92.89209857434795,-7.107901425652054,314.8634662937802,280.3065116328121,0.017910263674810745,3799000.0
3128,BSESN,2016-04-05,24883.589844,25372.439453,24837.509766,25372.439453,14800.0,-516.060547000001,516.060547000001,0.0,44.841653683352035,24354.550781,25479.619141,47.02283717231171,-52.977162827688296,274.263187517583,279.0978468097663,-0.015889793609875302,3784200.0
3129,BSESN,2016-04-06,24900.630859,25000.650391,24834.160156,24978.859375,10300.0,17.041015000002517,0.0,17.041015000002517,45.529898091007254,24354.550781,25479.619141,48.53750202343263,-51.46249797656738,240.68774309158107,271.4158260661292,-0.01697003773037986,3794500.0
3130,BSESN,2016-04-07,24685.419922,25013.130859,24647.480469,24998.789063,19200.0,-215.21093699999986,215.21093699999986,0.0,38.525149220298275,24576.519531,25479.619141,12.058513788971686,-87.94148621102832,194.47149116703804,256.02695908631097,-0.025738098337853343,3775300.0
3131,BSESN,2016-04-08,24673.839844,24736.029297,24608.509766,24665.800781,9700.0,-11.580078000002684,11.580078000002684,0.0,38.16064159944187,24608.509766,25479.619141,7.499641247690516,-92.50035875230948,155.12221074561967,235.8460094181727,-0.011718170918442183,3765600.0
3132,BSESN,2016-04-11,25022.160156,25049.919922,24523.199219,24789.400391,25900.0,348.3203120000035,0.0,348.3203120000035,53.447560199386196,24523.199219,25479.619141,52.16965116709509,-47.8303488329049,150.3114636719074,218.73910026891966,0.0048874283212274605,3791500.0
3133,BSESN,2016-04-12,25145.589844,25180.019531,24996.439453,25056.470703,11500.0,123.4296879999965,0.0,123.4296879999965,57.72091806429231,24523.199219,25479.619141,65.07503771967637,-34.924962280323626,154.67565160364757,205.92641053586524,-0.007616458120617509,3803000.0
3134,BSESN,2016-04-13,25626.75,25671.5,25358.419922,25358.419922,14600.0,481.1601560000017,0.0,481.1601560000017,70.07637784327154,24523.199219,25671.5,96.10293742367489,-3.8970625763251077,194.715348021924,203.68419803307702,0.011241899056588123,3817600.0
3135,BSESN,2016-04-18,25816.359375,25870.029297,25634.119141,25833.160156,8500.0,189.609375,0.0,189.609375,73.58617997751324,24523.199219,25870.029297,96.01509330117582,-3.984906698824174,238.99203640636188,210.74576570773405,0.02163539870286546,3826100.0
3136,BSESN,2016-04-20,25844.179688,25956.339844,25716.810547,25942.339844,11300.0,27.820313000000173,0.0,27.820313000000173,74.10047274895717,24523.199219,25956.339844,92.17382062559297,-7.826179374407037,273.1774777855535,223.23210812329796,0.017501394316731034,3837400.0
3137,BSESN,2016-04-21,25880.380859,26080.070313,25783.119141,25979.679688,18100.0,36.20117100000061,0.0,36.20117100000061,74.83611293754356,24523.199219,26080.070313,87.17366808532967,-12.826331914670334,299.73565230445456,238.53281695952927,0.04005816770205084,3855500.0
3138,BSESN,2016-04-22,25838.140625,25922.019531,25771.880859,25892.490234,13400.0,-42.24023400000078,42.24023400000078,0.0,72.07973726410965,24523.199219,26080.070313,84.46051899014833,-15.539481009851666,313.7579566676468,253.57784490115282,0.03765004072823119,3842100.0
3139,BSESN,2016-04-25,25678.929688,25891.029297,25585.929688,25891.029297,8200.0,-159.21093699999986,159.21093699999986,0.0,62.12779956938881,24523.199219,26080.070313,74.23417863264667,-25.765821367353325,308.46791574800955,264.5558590705242,0.040246824608989984,3833900.0
3140,BSESN,2016-04-26,26007.300781,26055.0,25549.050781,25604.919922,11200.0,328.3710930000016,0.0,328.3710930000016,71.49411710571607,24523.199219,26080.070313,95.32591154910361,-4.674088450896394,327.00283793635026,277.0452548436894,0.05404351108018823,3845100.0
3141,BSESN,2016-04-27,26064.119141,26092.929688,25885.240234,25956.419922,11200.0,56.818359999997476,0.0,56.818359999997476,72.8354086789794,24523.199219,26092.929688,98.16461822147373,-1.8353817785262672,342.33049129831124,290.1023021346138,0.041641448160507855,3856300.0
3142,BSESN,2016-04-28,25603.099609,26100.539063,25561.169922,26078.279297,14600.0,-461.0195319999984,461.0195319999984,0.0,50.561829241887985,24523.199219,26100.539063,68.46339386580544,-31.53660613419455,313.6616474616858,294.8141712000282,0.018194433609962424,3841700.0
3143,BSESN,2016-04-29,25606.619141,25755.429688,25424.029297,25612.910156,14600.0,3.519531999998435,0.0,3.519531999998435,50.69464665851362,24523.199219,26100.539063,68.68652472840213,-31.313475271597866,287.90657125394864,293.4326512108123,-0.0007855408508687933,3856300.0
3144,BSESN,2016-05-02,25436.970703,25565.439453,25341.140625,25565.439453,7700.0,-169.64843800000014,169.64843800000014,0.0,44.10458828303167,24523.199219,26100.539063,57.93117364503725,-42.06882635496275,250.91389744726257,284.92890045810236,-0.014695668993800592,3848600.0
3145,BSESN,2016-05-03,25229.699219,25705.960938,25192.939453,25500.140625,11000.0,-207.2714840000008,207.2714840000008,0.0,37.273831831335286,24523.199219,26100.539063,44.79060125739138,-55.20939874260863,202.53713836285533,268.45054803905293,-0.023776358020189625,3837600.0
3146,BSESN,2016-05-04,25101.730469,25245.699219,25061.039063,25210.869141,15800.0,-127.96875,127.96875,0.0,33.5700200634797,24996.439453,26100.539063,9.536369277405967,-90.46363072259403,152.11867026695109,245.18417248463257,-0.030086512027863943,3821800.0
3147,BSESN,2016-05-05,25262.210938,25394.099609,25162.939453,25187.660156,11300.0,160.4804690000019,0.0,160.4804690000019,41.920877602917756,25061.039063,26100.539063,19.352753727753726,-80.64724627224628,123.68533614888293,220.88440521748265,-0.022289904500432667,3833100.0
3148,BSESN,2016-05-06,25228.5,25260.480469,25057.929688,25223.669922,11300.0,-33.71093800000017,33.71093800000017,0.0,40.68134261494284,25057.929688,26100.539063,16.359944202496724,-83.64005579750328,97.30979628830028,196.16948343164617,-0.017540827965680017,3821800.0
3149,BSESN,2016-05-09,25688.859375,25709.679688,25302.859375,25321.830078,11700.0,460.359375,0.0,460.359375,59.534597835875545,25057.929688,26100.539063,60.51448434366896,-39.48551565633104,112.26008077031656,179.38760289938025,-0.012244308191822983,3833500.0
3150,BSESN,2016-05-10,25772.529297,25809.929688,25614.240234,25682.980469,10500.0,83.66992200000095,0.0,83.66992200000095,62.06317545238217,25057.929688,26100.539063,68.53953418556215,-31.46046581443786,129.36847315058185,169.3837769496206,-0.011187404508956278,3844000.0
3151,BSESN,2016-05-11,25597.019531,25762.490234,25409.240234,25548.970703,9300.0,-175.50976599999925,175.50976599999925,0.0,53.90975862517142,25057.929688,26100.539063,51.70583115080867,-48.29416884919133,127.29742062628065,160.9665056849526,-0.00023747429384923802,3834700.0
3152,BSESN,2016-05-12,25790.220703,25827.029297,25620.269531,25684.599609,9800.0,193.20117199999734,0.0,193.20117199999734,60.500751758624155,25057.929688,26100.539063,70.23637352196252,-29.763626478037487,139.63617757588509,156.70044006313913,0.0071700821177922425,3844500.0
3153,BSESN,2016-05-13,25489.570313,25743.689453,25400.269531,25739.939453,12500.0,-300.6503899999989,300.6503899999989,0.0,48.13993206611223,25057.929688,26100.539063,41.400032970162,-58.599967029838,123.72849247855993,150.1060505462233,0.002067840963224432,3832000.0
3154,BSESN,2016-05-16,25653.230469,25688.460938,25351.619141,25528.800781,12900.0,163.6601559999981,0.0,163.6601559999981,54.03805710417292,25057.929688,26100.539063,57.097202008182414,-42.902797991817586,122.91070614329146,144.66698166563694,0.01678701146310324,3844900.0
3155,BSESN,2016-05-17,25773.609375,25927.310547,25733.759766,25756.140625,11400.0,120.37890600000172,0.0,120.37890600000172,58.08396869016072,25057.929688,26100.539063,68.64312792123127,-31.35687207876873,130.4721742379552,141.8280201801006,0.026766238559917443,3856300.0
3156,BSESN,2016-05-18,25704.609375,25747.0,25503.400391,25671.480469,9800.0,-69.0,69.0,0.0,54.88842066177629,25057.929688,25927.310547,74.38393430283692,-25.61606569716308,129.40526548890557,139.34346924186158,0.017512261222335512,3846500.0
3157,BSESN,2016-05-19,25399.720703,25714.560547,25351.990234,25713.839844,14400.0,-304.88867200000095,304.88867200000095,0.0,42.864914439060975,25057.929688,25927.310547,39.31430183465755,-60.68569816534245,102.77306097624023,132.0293875887373,0.006786796797272787,3832100.0
3158,BSESN,2016-05-20,25301.900391,25506.060547,25251.900391,25428.419922,13600.0,-97.82031199999984,97.82031199999984,0.0,39.64959028198196,25057.929688,25927.310547,28.062580453016256,-71.93741954698373,72.93284097371361,120.21007826573256,-0.01506329955531549,3818500.0
3159,BSESN,2016-05-23,25230.359375,25519.259766,25207.779297,25447.720703,11300.0,-71.54101599999922,71.54101599999922,0.0,37.28922035842633,25057.929688,25927.310547,19.83361897320075,-80.16638102679924,43.0156321059294,104.77118903377195,-0.02103673705254494,3807200.0
3160,BSESN,2016-05-24,25305.470703,25340.470703,25181.470703,25256.970703,10700.0,75.11132799999905,0.0,75.11132799999905,41.507540122752,25057.929688,25927.310547,28.473253400670817,-71.52674659932919,25.07780366415318,88.8325119598482,-0.01138995216403671,3817900.0
3161,BSESN,2016-05-25,25881.169922,25897.869141,25430.589844,25432.099609,9500.0,575.6992190000019,0.0,575.6992190000019,63.32504223050606,25057.929688,25927.310547,94.692702913534,-5.307297086465986,56.662886558329774,82.39858687954452,0.003526500220660145,3827400.0
3162,BSESN,2016-05-26,26366.679688,26398.939453,25941.509766,26008.25,13900.0,485.50976599999916,0.0,485.50976599999916,73.09162852870557,25181.470703,26398.939453,97.3502592982367,-2.6497407017633003,119.49342700751367,89.81755490513837,0.034410520233550734,3841300.0
3163,BSESN,2016-05-27,26653.599609,26677.429688,26405.279297,26415.929688,20800.0,286.9199210000006,0.0,286.9199210000006,77.22691560573979,25181.470703,26677.429688,98.40703660735728,-1.5929633926427045,190.24608428242936,109.90326078059658,0.03899583489919034,3862100.0
3164,BSESN,2016-05-30,26725.599609,26794.960938,26623.330078,26694.75,14800.0,72.0,0.0,72.0,78.19709556982133,25181.470703,26794.960938,95.70116214555216,-4.298837854447835,249.2546210729488,137.77353283906706,0.03693662847716683,3876900.0
3165,BSESN,2016-05-31,26667.960938,26837.199219,26561.580078,26817.75,26500.0,-57.63867100000061,57.63867100000061,0.0,75.23643891117528,25181.470703,26837.199219,89.77862135219769,-10.221378647802318,288.04791550343725,167.82840937194112,0.03747777485920256,3850400.0
3166,BSESN,2016-06-01,26713.929688,26857.25,26671.859375,26684.460938,13400.0,45.96875,0.0,45.96875,76.07018425344329,25181.470703,26857.25,91.44754251012806,-8.552457489871934,318.8259477153224,198.0279170406174,0.05174108016253798,3863800.0
3167,BSESN,2016-06-02,26843.140625,26885.160156,26641.019531,26694.279297,11100.0,129.21093699999986,0.0,129.21093699999986,78.42597146476226,25181.470703,26885.160156,97.53361559373334,-2.4663844062666547,349.6138716566529,228.34510796382455,0.0609140108127304,3874900.0
3168,BSESN,2016-06-03,26843.029297,27008.140625,26792.070313,26919.230469,13000.0,-0.1113279999990482,0.1113279999990482,0.0,78.41829666333247,25181.470703,27008.140625,90.9610747945518,-9.0389252054482,369.7423799564822,256.62456236235613,0.06391783398844275,3861900.0
3169,BSESN,2016-06-06,26777.449219,26901.419922000005,26729.539063,26897.839844,8700.0,-65.58007800000269,65.58007800000269,0.0,73.52757537137786,25181.470703,27008.140625,87.37093093713284,-12.629069062867156,376.06753117763947,280.5131561254128,0.0581683910675288,3853200.0
3170,BSESN,2016-06-07,27009.669922000005,27082.630859,26829.529297,26833.539063,14800.0,232.2207030000063,0.0,232.2207030000063,78.90339801647032,25181.470703,27082.630859,96.16229401979976,-3.8377059802002353,395.262192559705,303.4629634122713,0.043603129356247994,3868000.0
3171,BSESN,2016-06-08,27020.660156,27105.410156,26973.710938,27085.240234,12500.0,10.990233999997145,0.0,10.990233999997145,79.13477923648104,25181.470703,27105.410156,95.5949757219309,-4.405024278069102,406.6730462971136,324.1049799892398,0.02480329247894053,3880500.0
3172,BSESN,2016-06-09,26763.460938,26994.910156,26692.349609,26994.480469,10100.0,-257.1992180000016,257.1992180000016,0.0,61.05325520731358,25181.470703,27105.410156,82.22661230493509,-17.77338769506491,390.46140666349675,337.3762653240912,0.004121819589534947,3870400.0
3173,BSESN,2016-06-10,26635.75,26972.060547000005,26620.5,26742.259766,10100.0,-127.71093800000016,127.71093800000016,0.0,53.98593710146137,25181.470703,27105.410156,75.58862077142501,-24.41137922857498,363.12250982617843,342.5255142245087,-0.0033619305203443917,3860300.0
3174,BSESN,2016-06-13,26396.769531,26468.269531,26262.269531,26468.269531,9100.0,-238.9804689999983,238.9804689999983,0.0,43.190976541041174,25430.589844,27105.410156,57.68855799499054,-42.31144200500946,318.50102891002825,337.72061716161267,-0.010169184199365189,3851200.0
3175,BSESN,2016-06-14,26395.710938,26485.449219,26264.810547,26482.5,7800.0,-1.0585930000015649,1.0585930000015649,0.0,43.1468800199318,25941.509766,27105.410156,39.02405875128197,-60.97594124871804,279.82709166905624,326.1419120631014,-0.011912090572842371,3843400.0
3176,BSESN,2016-06-15,26726.339844,26752.589844,26446.589844,26500.789063,12300.0,330.62890599999815,0.0,330.62890599999815,58.438724720278216,26262.269531,27105.410156,55.04067758566331,-44.95932241433669,272.7130411279104,315.4561378760632,-0.004351233807985189,3855700.0
3177,BSESN,2016-06-16,26525.460938,26686.029297,26314.910156,26686.029297,12600.0,-200.8789059999981,200.8789059999981,0.0,49.16771524725466,26262.269531,27105.410156,31.215600244620926,-68.78439975537907,248.00698576799914,301.96630745445043,-0.011830570815474006,3843100.0
3178,BSESN,2016-06-17,26625.910156,26730.550781,26538.509766,26653.849609,9300.0,100.44921800000157,0.0,100.44921800000157,53.43045142907775,26262.269531,27105.410156,43.129297084931714,-56.87070291506829,233.8371422835371,288.34047442026775,-0.005659204570257259,3852400.0
3179,BSESN,2016-06-20,26866.919922000005,26885.490234,26447.880859,26497.109375,9500.0,241.00976600000286,0.0,241.00976600000286,62.20490784723637,26262.269531,27105.410156,71.71406205222324,-28.285937947776755,239.2964525987445,278.5316700559631,-0.005285144187701762,3861900.0
3180,BSESN,2016-06-21,26812.779297,26925.640625,26754.599609,26907.419922000005,7000.0,-54.140625000003645,54.140625000003645,0.0,59.308424021620986,26262.269531,27105.410156,65.29275777691285,-34.707242223087135,236.52775466794628,270.13088697835974,-0.007693404150743488,3854900.0
3181,BSESN,2016-06-22,26765.650391,26887.289063,26617.449219,26791.679688,7700.0,-47.12890600000173,47.12890600000173,0.0,56.658557662472745,26262.269531,27105.410156,59.70307266359007,-40.29692733640993,227.90350305073298,261.6854101928344,8.180754369058185e-05,3847200.0
3182,BSESN,2016-06-23,27002.220702999995,27060.980469,26736.519531,26753.199219,9300.0,236.5703119999962,0.0,236.5703119999962,65.56865366535129,26262.269531,27105.410156,87.76129984247808,-12.238700157521922,237.4211256406561,256.83255328239875,0.013758602742554471,3856500.0
3183,BSESN,2016-06-24,26397.710938,26435.849609,25911.330078,26367.480469,24400.0,-604.5097649999952,604.5097649999952,0.0,40.82385157545524,25911.330078,27105.410156,40.73268359142661,-59.26731640857339,193.94929740608495,244.255902107136,3.566372009622398e-05,3832100.0
3184,BSESN,2016-06-27,26402.960938,26493.509766,26262.720703,26347.810547,18300.0,5.25,0.0,5.25,41.04679723004082,25911.330078,27105.410156,41.17235259660701,-58.82764740339299,158.0987277361928,227.02446723294736,0.00027466583556057245,3850400.0
3185,BSESN,2016-06-28,26524.550781,26583.330078,26378.460938,26410.660156,8100.0,121.58984300000157,0.0,121.58984300000157,46.43923327881801,25911.330078,27060.980469,53.33975509429485,-46.660244905705156,137.90845432831702,209.20126465202128,-0.007550194459017834,3858500.0
3186,BSESN,2016-06-29,26740.390625,26776.169922,26606.310547,26627.150391,7700.0,215.8398439999983,0.0,215.8398439999983,54.89059885732508,25911.330078,27060.980469,72.11414474263434,-27.885855257365673,137.736250987924,194.90826191920183,0.008102769165910795,3866200.0
3187,BSESN,2016-06-30,26999.720702999995,27069.230469,26872.589844,26926.169922000005,8600.0,259.3300779999954,0.0,259.3300779999954,62.98717670288534,25911.330078,27069.230469,93.99691315934594,-6.00308684065406,156.7189896245036,187.27040746026222,0.014039352826245466,3874800.0
3188,BSESN,2016-07-01,27144.910156,27243.359375,27061.400391000006,27064.330077999995,10000.0,145.18945300000632,0.0,145.18945300000632,66.83285228174802,25911.330078,27243.359375,92.60908005389027,-7.390919946109728,181.38759888535787,186.09384574528139,0.010346933508085687,3884800.0
3189,BSESN,2016-07-04,27278.759766000006,27385.660156,27251.060547000005,27314.439452999995,8300.0,133.84961000000112,0.0,133.84961000000112,70.13374320345731,25911.330078,27385.660156,92.74922274223621,-7.250777257763784,209.32522347565464,190.74012129135605,0.017379043919260706,3893100.0
3190,BSESN,2016-07-05,27166.869141000006,27348.660156,27127.300781,27340.720702999995,10400.0,-111.890625,111.890625,0.0,63.990947325667335,25911.330078,27385.660156,85.15997073757082,-14.840029262429171,219.9024552945375,196.57258809199237,0.014990061670046906,3882700.0
3191,BSESN,2016-07-07,27201.490234,27288.220702999995,27146.949219,27209.970702999995,8800.0,34.62109299999429,0.0,34.62109299999429,65.08282295314109,25911.330078,27385.660156,87.50823002608506,-12.491769973914932,228.44524598688804,202.94711967097155,0.007379746028735479,3891500.0
3192,BSESN,2016-07-08,27126.900391000006,27294.820313,27034.140625,27292.199219,13900.0,-74.5898429999943,74.5898429999943,0.0,60.52084400415202,25911.330078,27385.660156,82.44899369135744,-17.55100630864256,226.58476408503338,207.67464855378392,0.02762320773617999,3877600.0
3193,BSESN,2016-07-11,27626.689452999995,27647.480469,27358.230469,27358.230469,23900.0,499.7890619999926,0.0,499.7890619999926,74.39624449496506,25911.330078,27647.480469,98.80246457289755,-1.1975354271024592,262.41417193874076,218.62255323077534,0.046348154582873446,3901500.0
3194,BSESN,2016-07-12,27808.140625,27828.740234,27667.810547000005,27667.810547000005,12200.0,181.4511720000046,0.0,181.4511720000046,77.68212288868268,25911.330078,27828.740234,98.92565453794327,-1.0743454620567245,301.9699078020276,235.29202414502578,0.04839251961693747,3913700.0
3195,BSESN,2016-07-13,27815.179688,27928.759766000006,27752.140625,27912.140625,17600.0,7.039063000000169,0.0,7.039063000000169,77.80959524694337,25911.330078,27928.759766000006,94.37006014754324,-5.629939852456752,330.081137133071,254.24984674263487,0.040193469051090114,3931300.0
3196,BSESN,2016-07-14,27942.109375,27967.769531,27763.150391000006,27857.800781,10500.0,126.92968699999984,0.0,126.92968699999984,80.16658115346475,25911.330078,27967.769531,98.75220464368314,-1.2477953563168533,358.46944127410825,275.09376564892955,0.03490364520308886,3941800.0
3197,BSESN,2016-07-15,27836.5,28048.699219,27735.869141000006,27966.140625,16300.0,-105.609375,105.609375,0.0,72.74832337601379,26262.720703,28048.699219,88.118601814133,-11.881398185866999,368.201188777497,293.71525027464304,0.025477698766563472,3925500.0
3198,BSESN,2016-07-18,27746.660156,28013.5,27697.689452999995,27920.660156,20500.0,-89.83984399999827,89.83984399999827,0.0,66.6908791533076,26378.460938,28048.699219,81.91640878814243,-18.083591211857566,364.4630411316866,307.86480844605177,0.017152553635637835,3905000.0
3199,BSESN,2016-07-19,27787.619141000006,27826.689452999995,27637.980469,27790.050781,16800.0,40.958985000001114,0.0,40.958985000001114,68.08866152537342,26606.310547,28048.699219,81.89946419656906,-18.100535803430954,360.64825142478,318.42149704179747,0.022849522953057866,3921800.0
3200,BSESN,2016-07-20,27915.890625,27935.179688,27759.710938,27775.699219,12500.0,128.27148399999714,0.0,128.27148399999714,72.29045433904372,26872.589844,28048.699219,88.70780245247188,-11.292197547528117,363.7819875413079,327.4935951416996,0.026263281344308442,3934300.0
3201,BSESN,2016-07-21,27710.519531,27988.759766000006,27687.539063,27980.070313,12200.0,-205.3710939999983,205.3710939999983,0.0,58.146514395502216,27034.140625,28048.699219,66.66730832502346,-33.33269167497655,345.70865093128305,331.1366062996163,0.02151440568542151,3922100.0
3202,BSESN,2016-07-22,27803.240234,27832.449219,27646.210938,27721.720702999995,9500.0,92.72070299999541,0.0,92.72070299999541,62.01779724101613,27034.140625,28048.699219,75.80632735737312,-24.19367264262688,335.0054529612462,331.9103756319423,0.00639058767067846,3931600.0
3203,BSESN,2016-07-25,28095.339844,28110.369141000006,27736.509766000006,27753.960938,15300.0,292.0996100000011,0.0,292.0996100000011,71.5749195069498,27034.140625,28110.369141000006,98.60352176358724,-1.396478236412771,346.1034239766195,334.7489853008778,0.010327882862538607,3946900.0
3204,BSESN,2016-07-26,27976.519531,28149.529297000005,27927.130859,28121.369141000006,11100.0,-118.8203129999965,118.8203129999965,0.0,64.01470116338481,27034.140625,28149.529297000005,84.48883601356836,-15.511163986431642,341.3756734618655,336.0743229330754,0.005800424257895731,3935800.0
3205,BSESN,2016-07-27,28024.330077999995,28210.880859,27899.929688,27976.140625,10400.0,47.810546999993676,0.0,47.810546999993676,65.6969385422122,27034.140625,28210.880859,84.14681714707093,-15.853182852929057,337.59522112737613,336.3785025719356,0.002942537440411064,3946200.0
3206,BSESN,2016-07-28,28208.619141000006,28240.199219,28064.900391000006,28108.779297000005,14600.0,184.28906300000745,0.0,184.28906300000745,71.60142881197481,27358.230469,28240.199219,96.41936542536322,-3.580634574636774,345.4872111202676,338.200244281602,0.013368029062561959,3960800.0
3207,BSESN,2016-07-29,28051.859375,28233.470702999995,28037.869141000006,28232.869141000006,11500.0,-156.75976600000288,156.75976600000288,0.0,61.25329701964334,27637.980469,28240.199219,68.72567584453353,-31.274324155466477,335.22816540962594,337.6058285072068,0.010999493895267998,3949300.0
3208,BSESN,2016-08-01,28003.119141000006,28284.849609,27873.529297000005,28083.080077999995,13700.0,-48.74023399999714,48.74023399999714,0.0,58.233920973566164,27637.980469,28284.849609,56.44706934079539,-43.552930659204605,319.4820777057357,333.9810783469126,0.0077552523987933775,3935600.0
3209,BSESN,2016-08-02,27981.710938,28175.220702999995,27943.910156,28069.119141000006,10100.0,-21.408203000002686,21.408203000002686,0.0,56.81457583344463,27637.980469,28284.849609,53.13755870314058,-46.86244129685943,301.79680102940256,327.5442228834106,0.0023578080987698424,3925500.0
3210,BSESN,2016-08-03,27697.509766000006,28015.429688,27647.140625,28008.519531,11800.0,-284.2011719999973,284.2011719999973,0.0,41.369609632716866,27637.980469,28284.849609,9.202680004182607,-90.79731999581739,261.83021668151196,314.4014216430309,-0.0004694883105833547,3913700.0
3211,BSESN,2016-08-04,27714.369141000006,27921.910156,27627.970702999995,27899.880859,14600.0,16.859375,0.0,16.859375,42.440651810503375,27627.970702999995,28284.849609,13.152871436552168,-86.84712856344782,228.87845297098465,297.29682790862165,-0.003196429346077334,3928300.0
3212,BSESN,2016-08-05,28078.349609,28110.369141000006,27795.740234,27810.550781,13700.0,363.9804679999943,0.0,363.9804679999943,60.44193154496597,27627.970702999995,28284.849609,68.56346000551913,-31.436539994480857,229.48872155138451,283.73520663717426,-0.0006047349878782748,3942000.0
3213,BSESN,2016-08-08,28182.570313,28226.380859,28128.060547000005,28181.919922000005,20300.0,104.22070400000301,0.0,104.22070400000301,64.14654079779274,27627.970702999995,28284.849609,84.42950518493285,-15.570494815067143,235.66549843287794,274.121264996315,0.0073651328133108596,3962300.0
3214,BSESN,2016-08-09,28085.160156,28289.960938,27956.769531,28289.220702999995,14200.0,-97.41015699999843,97.41015699999843,0.0,58.26226720004429,27627.970702999995,28289.960938,69.06286963583429,-30.937130364165714,230.04859601885983,265.30673120082395,0.002170616668826675,3948100.0
3215,BSESN,2016-08-10,27774.880859,28143.279297000005,27736.619141000006,28133.359375,15400.0,-310.2792970000046,310.2792970000046,0.0,43.57215485856017,27627.970702999995,28289.960938,22.192193816877726,-77.80780618312228,198.27462774555534,251.90031050977024,-0.015376090542822296,3932700.0
3216,BSESN,2016-08-11,27859.599609,27902.390625,27697.330077999995,27805.939452999995,9900.0,84.71875,0.0,84.71875,47.72465177054483,27627.970702999995,28289.960938,34.98977685071196,-65.01022314928804,177.87914402435126,237.09607721268648,-0.0068537262870832505,3942600.0
3217,BSESN,2016-08-12,28152.400391000006,28203.269531,27900.910156,27919.949219,21000.0,292.8007820000057,0.0,292.8007820000057,59.58503367174876,27627.970702999995,28289.960938,79.22015465983533,-20.779845340164677,183.22999102313406,226.322859974776,0.005330879365557317,3963600.0
3218,BSESN,2016-08-16,28064.609375,28199.099609,27942.650391000006,28190.039063,14600.0,-87.79101600000286,87.79101600000286,0.0,55.24845132787174,27627.970702999995,28289.960938,65.95847626060548,-34.04152373939452,178.3308870703513,216.7244653938911,0.0029625935734838293,3949000.0
3219,BSESN,2016-08-17,28005.369141000006,28174.300781,27960.140625,28061.789063,11600.0,-59.24023399999714,59.24023399999714,0.0,52.2856178095,27627.970702999995,28289.960938,57.00966842811637,-42.99033157188363,167.73458026893059,206.92648836889902,0.011115056104354704,3937400.0
3220,BSESN,2016-08-18,28123.439452999995,28214.169922000005,28077.0,28077.640625,12500.0,118.07031199999255,0.0,118.07031199999255,57.52405823628742,27627.970702999995,28289.960938,74.8453260794695,-25.154673920530502,166.9398396550714,198.92915862613353,0.01476022455783843,3949900.0
3221,BSESN,2016-08-19,28077.0,28212.300781,28026.119141000006,28167.660156,15600.0,-46.4394529999954,46.4394529999954,0.0,54.79395155765838,27627.970702999995,28289.960938,67.83019948927212,-32.16980051072787,160.71015956551855,191.28535881401055,-4.806582362548717e-05,3934300.0
3222,BSESN,2016-08-22,27985.539063,28143.279297000005,27918.050781,28088.070313,12600.0,-91.46093699999984,91.46093699999984,0.0,49.459649636236556,27627.970702999995,28289.960938,54.01414418144736,-45.98585581855264,146.70187210429867,182.3686614720682,-0.006991244865593882,3921700.0
3223,BSESN,2016-08-23,27990.210938,28028.980469,27854.429688,28012.560547000005,12400.0,4.671875,0.0,4.671875,49.747987651189376,27627.970702999995,28289.960938,54.719875890616755,-45.28012410938325,134.42758708933252,172.78044659552108,-0.0033807611376471813,3934100.0
3224,BSESN,2016-08-24,28059.939452999995,28108.390625,27959.869141000006,28065.25,8100.0,69.72851499999524,0.0,69.72851499999524,54.24354115710177,27627.970702999995,28289.960938,65.2530395708929,-34.7469604291071,128.84143236718955,163.99264374985478,0.010263179721529792,3942200.0
3225,BSESN,2016-08-25,27835.910156,28154.210938,27803.240234,28103.599609,6700.0,-224.0292969999937,224.0292969999937,0.0,40.73426909791266,27697.330077999995,28289.960938,23.383878119341475,-76.61612188065853,105.12525403653854,152.21916580719153,-0.0008503156302485104,3935500.0
3226,BSESN,2016-08-26,27782.25,27935.880859,27696.990234,27882.75,9100.0,-53.66015600000173,53.66015600000173,0.0,38.1110766477075,27696.990234,28289.960938,14.37841118032693,-85.62158881967306,81.06561179986238,137.9884550057257,-0.013148093443511089,3926400.0
3227,BSESN,2016-08-29,27902.660156,27952.849609,27698.710938,27827.259766000006,11800.0,120.41015600000172,0.0,120.41015600000172,46.95550275798632,27696.990234,28289.960938,34.68466833396902,-65.31533166603099,70.89700868223372,124.57016574102731,-0.005770585182071408,3938200.0
3228,BSESN,2016-08-30,28343.009766000006,28478.019531,28010.660156,28012.460938,10600.0,440.3496100000011,0.0,440.3496100000011,66.9098598762672,27696.990234,28478.019531,82.71386675012332,-17.286133249876677,97.24981548543292,119.10609568990844,0.012056281897234289,3948800.0
3229,BSESN,2016-08-31,28452.169922000005,28532.25,28363.099609,28372.25,10400.0,109.16015600000172,0.0,109.16015600000172,70.12446433093635,27696.990234,28532.25,90.41255412271403,-9.587445877285976,125.49627410918401,120.38413137376355,0.011688843021828266,3959200.0
3230,BSESN,2016-09-01,28423.480469,28548.849609,28386.609375,28459.089844,16800.0,-28.689453000006324,28.689453000006324,0.0,68.11770643881503,27696.990234,28548.849609,85.28288310497229,-14.717116895027718,143.90791610661472,125.08888832033381,0.01234036645653025,3942400.0
3231,BSESN,2016-09-02,28532.109375,28581.580077999995,28427.630859,28498.720702999995,12000.0,108.62890600000172,0.0,108.62890600000172,71.66081039075488,27696.990234,28581.580077999995,94.40749819415791,-5.592501805842088,165.3585692486813,133.1428245060033,0.01953045502427453,3954400.0
3232,BSESN,2016-09-06,28978.019531,29013.400391000006,28631.269531,28631.269531,18200.0,445.9101560000017,0.0,445.9101560000017,81.4335020570505,27696.990234,29013.400391000006,97.31232246941676,-2.6876775305832443,215.85138892125542,149.68453738905373,0.035291216460928254,3972600.0
3233,BSESN,2016-09-07,28926.359375,29067.839844,28911.310547000005,29035.669922000005,19800.0,-51.66015600000173,51.66015600000173,0.0,77.84499566042568,27696.990234,29067.839844,89.67935884666454,-10.320641153335451,248.8304074006628,169.51371139137555,0.03087746940620617,3952800.0
3234,BSESN,2016-09-08,29045.279297000005,29077.279297000005,28854.560547000005,28929.460938,15000.0,118.91992200000459,0.0,118.91992200000459,80.16643914299819,27696.990234,29077.279297000005,97.68164503669621,-2.3183549633037925,281.31948508794085,191.87486613068864,0.04344636601506369,3967800.0
3235,BSESN,2016-09-09,28797.25,29062.900391000006,28755.080077999995,29062.900391000006,11700.0,-248.0292970000046,248.0292970000046,0.0,64.02233179626096,27696.990234,29077.279297000005,79.71227154467398,-20.287728455326015,283.78215775930585,210.2563244564121,0.036534118007000904,3956100.0
3236,BSESN,2016-09-12,28353.539063,28481.109375,28251.310547000005,28481.089844,13700.0,-443.71093699999983,443.71093699999983,0.0,45.22350580276499,27696.990234,29077.279297000005,47.56603863635755,-52.43396136364245,247.08187319403078,217.62143420393585,0.016158993604165284,3942400.0
3237,BSESN,2016-09-14,28372.230469,28416.410156,28259.380859,28345.490234,11500.0,18.691405999998093,0.0,18.691405999998093,45.9942827594267,27696.990234,29077.279297000005,48.92020469483323,-51.07979530516676,217.00339347828776,217.49782605880625,0.0010309668324302024,3953900.0
3238,BSESN,2016-09-15,28412.890625,28454.019531,28311.109375,28398.330077999995,9600.0,40.66015600000173,0.0,40.66015600000173,47.83664482663397,27696.990234,29077.279297000005,51.86597577206169,-48.13402422793832,194.20820508015822,212.83990186307662,-0.0013805378327096385,3963500.0
3239,BSESN,2016-09-16,28599.029297000005,28778.640625,28494.589844,28520.300781,13400.0,186.1386720000046,0.0,186.1386720000046,55.80119495927424,27696.990234,29077.279297000005,65.35146058749879,-34.64853941250121,188.98419706361892,208.06876090318508,0.006176190427891859,3976900.0
3240,BSESN,2016-09-19,28634.5,28714.769531,28552.550781,28626.599609,12600.0,35.47070299999541,0.0,35.47070299999541,57.236838526052864,27698.710938,29077.279297000005,67.88122300143382,-32.118776998566176,185.56721897585885,203.56845251771986,0.0035886104197300206,3989500.0
3241,BSESN,2016-09-20,28523.199219,28698.810547000005,28480.529297000005,28690.660156,8000.0,-111.30078100000172,111.30078100000172,0.0,51.21400122515062,28010.660156,29077.279297000005,48.05267815834136,-51.94732184165864,171.89667846863085,197.2340977079021,-0.01569535528518251,3981500.0
3242,BSESN,2016-09-21,28507.419922000005,28689.359375,28462.330077999995,28554.380859,12300.0,-15.779296999993674,15.779296999993674,0.0,50.347359610962876,28251.310547000005,29077.279297000005,31.007150694260528,-68.99284930573947,157.96845718839904,189.3809696040015,-0.01448296508969149,3969200.0
3243,BSESN,2016-09-22,28773.130859,28871.919922000005,28693.070313,28766.939452999995,10700.0,265.7109369999925,0.0,265.7109369999925,62.63323315193102,28251.310547000005,29077.279297000005,63.1767620748359,-36.823237925164094,166.4521368327878,184.79520304975878,-0.009369799312899496,3979900.0
3244,BSESN,2016-09-23,28668.220702999995,28825.089844,28627.380859,28810.320313,13300.0,-104.91015600000172,104.91015600000172,0.0,56.288158420303674,28251.310547000005,29077.279297000005,50.47529413188947,-49.52470586811053,162.83310260736835,180.4027829612807,-0.004480611759803632,3966600.0
3245,BSESN,2016-09-26,28294.279297000005,28630.919922000005,28272.029297000005,28630.919922000005,16600.0,-373.9414059999908,373.9414059999908,0.0,39.73343435711033,28251.310547000005,29077.279297000005,5.202224660436609,-94.7977753395634,128.31194536969997,169.98461544296458,-0.0020900306613690356,3950000.0
3246,BSESN,2016-09-27,28223.699219,28432.740234,28179.339844,28373.019531,8800.0,-70.58007800000631,70.58007800000631,0.0,37.341635129235804,28179.339844,29077.279297000005,4.940129855280976,-95.05987014471903,94.17289065222212,154.8222704848161,-0.005235092466991165,3941200.0
3247,BSESN,2016-09-28,28292.810547000005,28378.560547000005,28198.300781,28198.880859,10800.0,69.11132800000632,0.0,69.11132800000632,41.33176172231899,28179.339844,29077.279297000005,12.636787772371722,-87.36321222762827,71.86572704561695,138.2309617969763,-0.004226253484196363,3952000.0
3248,BSESN,2016-09-29,27827.529297000005,28475.570313,27719.919922000005,28423.140625,13600.0,-465.28125,465.28125,0.0,27.65263529986612,27719.919922000005,29062.900391000006,8.012728217866574,-91.98727178213343,16.453168925963837,113.8754032227738,-0.02697644007382194,3938400.0
3249,BSESN,2016-09-30,27865.960938,27955.210938,27716.779297000005,27807.820313,10500.0,38.43164099999558,0.0,38.43164099999558,29.86487067386669,27716.779297000005,28871.919922000005,12.91458700104116,-87.08541299895884,-24.082957030179386,86.28373117218315,-0.026839618711693936,3948900.0
3250,BSESN,2016-10-03,28243.289063,28273.019531,27919.890625,27997.289063,10900.0,377.328125,0.0,377.328125,47.90941768318409,27716.779297000005,28871.919922000005,45.57971164766156,-54.42028835233844,-25.467331132233085,63.933518711299904,-0.009813420782530669,3959800.0
3251,BSESN,2016-10-04,28334.550781,28404.699219,28242.25,28377.640625,18300.0,91.26171800000157,0.0,91.26171800000157,51.398996318750854,27716.779297000005,28871.919922000005,53.48019718378419,-46.51980281621581,-18.9815916722182,47.35049663459628,-0.0060640051422751196,3978100.0
3252,BSESN,2016-10-05,28220.980469,28477.650391000006,28188.900391000006,28425.740234,11300.0,-113.5703120000035,113.5703120000035,0.0,46.88869072272098,27716.779297000005,28871.919922000005,43.64846678299395,-56.35153321700606,-22.743597420954757,33.331677823486075,-0.01918979177850899,3966800.0
3253,BSESN,2016-10-06,28106.210938,28328.560547000005,28031.220702999995,28298.349609,9100.0,-114.7695309999981,114.7695309999981,0.0,42.536364919992266,27716.779297000005,28871.919922000005,33.71292053727187,-66.28707946272814,-34.58725570933166,19.747891116922524,-0.01960392906216124,3957700.0
3254,BSESN,2016-10-07,28061.140625,28155.679688,27964.910156,28129.220702999995,12700.0,-45.07031300000017,45.07031300000017,0.0,40.819512444650705,27716.779297000005,28871.919922000005,29.81120398219874,-70.18879601780125,-47.067671009801415,6.384778691577733,-0.008239781248809641,3945000.0
3255,BSESN,2016-10-10,28082.339844,28216.640625,28068.320313,28144.279297000005,6900.0,21.199218999998266,0.0,21.199218999998266,42.08809190161867,27716.779297000005,28871.919922000005,31.646410756265595,-68.3535892437344,-54.61828466105726,-5.81583397894927,-0.005008534632655048,3951900.0
3256,BSESN,2016-10-13,27643.109375,28042.619141000006,27563.839844,28042.619141000006,11900.0,-439.2304689999983,439.2304689999983,0.0,27.827580770844776,27563.839844,28871.919922000005,6.059990694239543,-93.94000930576046,-94.9499050241684,-23.642648187993103,-0.02296347232526519,3940000.0
3257,BSESN,2016-10-14,27673.599609,27763.539063,27548.179688,27712.220702999995,14000.0,30.490233999997145,0.0,30.490233999997145,29.73450813403707,27548.179688,28825.089844,9.822141394261163,-90.17785860573883,-123.0344333083849,-43.52100521207147,-0.005531561438930854,3954000.0
3258,BSESN,2016-10-17,27529.970702999995,27803.210938,27488.300781,27776.140625,17100.0,-143.6289060000017,143.6289060000017,0.0,26.000512559813856,27488.300781,28630.919922000005,3.646877643194809,-96.35312235680519,-155.09345585232586,-65.83549534012236,-0.012057371204515888,3936900.0
3259,BSESN,2016-10-18,28050.880859,28064.390625,27652.759766000006,27656.890625,16200.0,520.9101560000017,0.0,520.9101560000017,51.49200424980161,27488.300781,28477.650391000006,56.86362761087017,-43.13637238912983,-136.88939034855503,-80.0462743418089,-0.006812528228238968,3953100.0
3260,BSESN,2016-10-19,27984.369141000006,28131.070313,27926.169922000005,28112.359375,15200.0,-66.51171799999429,66.51171799999429,0.0,49.00492559499541,27488.300781,28477.650391000006,50.14085566779597,-49.859144332204025,-126.37273088721122,-89.31156565088936,-0.0123588209570209,3937900.0
3261,BSESN,2016-10-20,28129.839844,28212.5,28031.570313,28031.570313,11300.0,145.4707029999954,0.0,145.4707029999954,54.54546697449559,27488.300781,28477.650391000006,64.84452578901744,-35.15547421098256,-105.08853727063251,-92.466959974838,-0.0032295343211096172,3949200.0
3262,BSESN,2016-10-21,28077.179688,28163.410156,27957.919922000005,28163.410156,8500.0,-52.6601559999981,52.6601559999981,0.0,52.17757245028855,27488.300781,28477.650391000006,59.521821310466336,-40.478178689533664,-91.41610699814919,-92.25678937950025,-0.001032912264980923,3940700.0
3263,BSESN,2016-10-24,28179.080077999995,28256.650391000006,28075.949219,28156.589844,15100.0,101.90038999999523,0.0,101.90038999999523,56.4032771580546,27488.300781,28477.650391000006,69.82155650720784,-30.178443492792162,-71.5335039413767,-88.11213229187554,0.004202945795258373,3955800.0
3264,BSESN,2016-10-25,28091.419922000005,28211.410156,28013.689452999995,28159.089844,11000.0,-87.6601559999908,87.6601559999908,0.0,51.85513918101372,27488.300781,28477.650391000006,60.961174382026584,-39.03882561797341,-62.13360226509394,-82.91642628651923,0.0003233376581313063,3944800.0
3265,BSESN,2016-10-26,27836.509766000006,28050.550781,27759.560547000005,28050.550781,14100.0,-254.9101560000017,254.9101560000017,0.0,40.81285187947128,27488.300781,28477.650391000006,35.19574693115845,-64.80425306884156,-74.3956449943289,-81.21227002808116,0.006996332734367172,3930700.0
3266,BSESN,2016-10-27,27915.900391000006,27958.130859,27665.599609,27808.630859,13600.0,79.390625,0.0,79.390625,45.020127426264814,27488.300781,28328.560547000005,50.88897830197945,-49.11102169802055,-76.82168963980439,-80.33415395042582,0.008755665523223266,3944300.0
3267,BSESN,2016-10-28,27941.509766000006,28000.140625,27789.839844,27983.140625,11300.0,25.609375,0.0,25.609375,46.43727116365158,27488.300781,28256.650391000006,58.98473547738274,-41.01526452261726,-75.8040629131574,-79.42813574297213,0.014948765018306664,3955600.0
3268,BSESN,2016-11-01,27876.609375,28029.800781,27845.630859,27966.179688,10100.0,-64.90039100000286,64.90039100000286,0.0,43.18254365801784,27488.300781,28256.650391000006,50.53800886291799,-49.461991137082,-79.3201522194795,-79.4065390382736,-0.006212692031882683,3945500.0
3269,BSESN,2016-11-02,27527.220702999995,27679.320313,27500.810547000005,27679.320313,13000.0,-349.38867200000465,349.38867200000465,0.0,30.084631930811668,27488.300781,28256.650391000006,5.065392302339222,-94.93460769766078,-109.04245069913668,-85.33372137044623,-0.01633584933419996,3932500.0
3270,BSESN,2016-11-03,27430.279297000005,27600.740234,27399.259766000006,27518.060547000005,10800.0,-96.9414059999908,96.9414059999908,0.0,27.421831059876666,27399.259766000006,28256.650391000006,3.6178994842634413,-96.38210051573655,-138.8197203490272,-96.03092116616243,-0.024868984355387536,3921700.0
3271,BSESN,2016-11-04,27274.150391000006,27498.910156,27193.609375,27465.550781,24300.0,-156.1289060000017,156.1289060000017,0.0,23.54854191703727,27193.609375,28256.650391000006,7.576473041751947,-92.42352695824805,-173.02222644681024,-111.429182222292,-0.028600782055870244,3897400.0
3272,BSESN,2016-11-07,27458.990234,27591.150391000006,27274.150391000006,27552.269531,11300.0,184.83984299999432,0.0,184.83984299999432,35.91391895948985,27193.609375,28256.650391000006,24.964310408131908,-75.03568959186809,-183.1022397434026,-125.76379372651414,-0.025554057904189187,3908700.0
3273,BSESN,2016-11-08,27591.140625,27646.839844,27406.759766000006,27537.259766000006,10200.0,132.15039100000286,0.0,132.15039100000286,43.45811004220632,27193.609375,28256.650391000006,37.39566432684076,-62.60433567315924,-178.3711393148842,-136.28526284418817,-0.017808971507638383,3918900.0
3274,BSESN,2016-11-09,27252.529297000005,27397.380859,25902.449219,26251.380859,21100.0,-338.6113279999954,338.6113279999954,0.0,32.23798318830501,25902.449219,28256.650391000006,57.347693733966146,-42.652306266033854,-199.64344703254028,-148.9568996818586,-0.020978940029086734,3897800.0
3275,BSESN,2016-11-10,27517.679688,27743.460938,27252.529297000005,27605.050781,16600.0,265.1503909999956,0.0,265.1503909999956,45.05516394881613,25902.449219,28256.650391000006,68.61055411113338,-31.389445888866618,-192.88304784799766,-157.74212931508643,-0.01426501375282141,3914400.0
3276,BSESN,2016-11-11,26818.820313,27344.849609,26777.179688,27344.849609,17100.0,-698.859375,698.859375,0.0,28.602033836371433,25902.449219,28256.650391000006,38.924927270404005,-61.075072729595995,-241.13780720087016,-174.4212648922432,-0.04017998534804035,3897300.0
3277,BSESN,2016-11-15,26304.630859,26809.609375,26253.630859,26809.609375,16400.0,-514.1894539999994,514.1894539999994,0.0,21.83333355674212,25902.449219,28211.410156,17.41829554390603,-82.58170445609397,-317.2141955348852,-202.97985102077163,-0.05639059237274979,3880900.0
3278,BSESN,2016-11-16,26298.689453,26621.400391,26239.210938,26508.939453,14200.0,-5.9414060000017335,5.9414060000017335,0.0,21.764662413879293,25902.449219,28050.550781,18.446066098992027,-81.55393390100798,-373.67718521497954,-237.11931785961323,-0.04462968721960758,3866700.0
3279,BSESN,2016-11-17,26227.619141,26449.869141,26155.400391,26304.900391,11000.0,-71.07031199999983,71.07031199999983,0.0,20.859143360861992,25902.449219,28029.800781,15.285199108994304,-84.7148008910057,-419.32556742912493,-273.56056777351563,-0.04384425484619614,3855700.0
3280,BSESN,2016-11-18,26150.240234,26349.019531,26106.779297,26270.199219,9600.0,-77.37890699999843,77.37890699999843,0.0,19.823051091352923,25902.449219,28029.800781,11.647863918037357,-88.35213608196264,-456.4840068455742,-310.14525558792735,-0.041207888821016225,3846100.0
3281,BSESN,2016-11-21,25765.140625,26270.279297,25717.929688,26246.699219,9900.0,-385.09960900000084,385.09960900000084,0.0,15.423697596319329,25717.929688,28029.800781,2.042109404064416,-97.95789059593558,-511.1148440653451,-350.33917328341096,-0.061686522139574484,3836200.0
3282,BSESN,2016-11-22,25960.779297,26039.699219,25765.509766,25928.160156,8100.0,195.63867200000092,0.0,195.63867200000092,25.159754390646953,25717.929688,27743.460938,11.989427909344808,-88.01057209065519,-532.4856077211261,-386.76846017095403,-0.05909003002662194,3844300.0
3283,BSESN,2016-11-23,26051.810547,26130.490234,25877.160156,26101.330078,8900.0,91.03125,0.0,91.03125,29.515965009882734,25717.929688,27743.460938,16.483619248036817,-83.51638075196318,-535.8991193292568,-416.5945920026146,-0.044058983917216854,3853200.0
3284,BSESN,2016-11-24,25860.169922,26049.140625,25810.970703,26049.140625,8600.0,-191.640625,191.640625,0.0,25.859667101044792,25717.929688,27743.460938,7.022366798833677,-92.97763320116633,-547.7539817649267,-442.8264699550771,-0.060234357867128274,3844600.0
3285,BSESN,2016-11-25,26316.339844,26343.949219,25874.449219,25953.240234,11500.0,456.1699219999973,0.0,456.1699219999973,44.6808546888076,25717.929688,27743.460938,29.54336823981353,-70.45663176018647,-514.4101453738949,-457.1432050388406,-0.01873611378634843,3856100.0
3286,BSESN,2016-11-28,26350.169922,26413.990234,26183.220703,26303.519531,10900.0,33.830078000002686,0.0,33.830078000002686,45.85699492523495,25717.929688,27743.460938,31.213551210330664,-68.78644878966934,-479.7251374735242,-461.6595915257774,0.0017312184779973983,3867000.0
3287,BSESN,2016-11-29,26394.009766,26587.070313,26354.660156,26408.619141,9600.0,43.839843999998266,0.0,43.839843999998266,47.52519593403255,25717.929688,27743.460938,33.37791396701478,-66.62208603298522,-443.5861250675516,-458.04489823413223,0.0036245271145678437,3876600.0
3288,BSESN,2016-11-30,26652.810547,26680.550781,26395.5,26441.019531,7800.0,258.80078100000173,0.0,258.80078100000173,56.62773609657302,25717.929688,27743.460938,46.154847475199446,-53.845152524800554,-389.5718949253496,-444.35029757237567,0.016211589916498514,3884400.0
3289,BSESN,2016-12-01,26559.919922,26769.320313,26540.820313,26756.660156,11300.0,-92.890625,92.890625,0.0,52.83226884264391,25717.929688,27344.849609,51.75363723387591,-48.24636276612409,-350.22356623929227,-425.524951305759,0.015666383342335166,3873100.0
3290,BSESN,2016-12-02,26230.660156,26463.060547,26182.929688,26437.369141,9600.0,-329.2597659999992,329.2597659999992,0.0,41.4654873715946,25717.929688,26809.609375,46.96711628014396,-53.03288371985604,-341.66968816059307,-408.75389867672584,0.018067804782260888,3863500.0
3291,BSESN,2016-12-05,26349.099609,26390.800781,26125.349609,26253.480469,12800.0,118.43945299999905,0.0,118.43945299999905,46.26402613759784,25717.929688,26769.320313,60.031914494196734,-39.968085505803266,-321.6260986783018,-391.3283386770411,0.014957960527975045,3876300.0
3292,BSESN,2016-12-06,26392.759766,26502.429688,26356.019531,26403.619141,7600.0,43.660156999998435,0.0,43.660156999998435,48.074589574393,25717.929688,26769.320313,64.18452494761394,-35.81547505238607,-298.77431549213725,-372.81753404006037,0.013087352158687393,3883900.0
3293,BSESN,2016-12-07,26236.869141,26540.830078,26164.820313,26456.210938,10500.0,-155.890625,155.890625,0.0,42.21463472956044,25717.929688,26769.320313,49.35743582457748,-50.64256417542252,-289.9013806255716,-356.2343033571627,0.014566772768168423,3873400.0
3294,BSESN,2016-12-08,26694.279297,26733.869141,26357.349609,26366.519531,8200.0,457.4101560000017,0.0,457.4101560000017,59.095191303615096,25717.929688,26769.320313,92.86268925976022,-7.137310740239787,-243.15737213893954,-333.6189171135181,0.014361398858670382,3881600.0
3295,BSESN,2016-12-09,26747.179688,26803.759766,26707.810547,26787.140625,9800.0,52.90039099999922,0.0,52.90039099999922,60.629935537677106,25765.509766,26803.759766,94.55043794847107,-5.449562051528924,-199.54357507233,-306.8038487052805,0.015066687128591605,3891400.0
3296,BSESN,2016-12-12,26515.240234,26725.310547,26468.589844,26725.310547,8500.0,-231.9394539999994,231.9394539999994,0.0,50.95754550741758,25810.970703,26803.759766,70.93848605380956,-29.061513946190438,-181.6015130164742,-281.7633815675192,0.004593105370301442,3882900.0
3297,BSESN,2016-12-13,26697.820313,26724.970703,26494.230469,26607.650391,7000.0,182.5800789999994,0.0,182.5800789999994,57.16448302891262,25810.970703,26803.759766,89.32910756693147,-10.670892433068536,-150.9100163514413,-255.59270852430365,0.0016887437038066722,3889900.0
3298,BSESN,2016-12-14,26602.839844,26736.339844,26547.050781,26707.910156,9900.0,-94.9804690000019,94.9804690000019,0.0,53.12839441079914,25874.449219,26803.759766,78.37967914508123,-21.620320854918777,-132.72098923950398,-231.01836466734375,0.001615965790787044,3880000.0
3299,BSESN,2016-12-15,26519.070313,26737.859375,26407.580078,26497.710938,12700.0,-83.7695309999981,83.7695309999981,0.0,49.566949080002466,26125.349609,26803.759766,58.03579146589934,-41.96420853410066,-123.6403067758547,-209.54275308904596,0.010995154345516012,3867300.0
3300,BSESN,2016-12-16,26489.560547,26594.550781,26455.210938,26548.669922,7600.0,-29.509765999999214,29.509765999999214,0.0,48.25219580622541,26125.349609,26803.759766,53.68595004688307,-46.31404995311693,-117.47086103053516,-191.12837467734383,0.00533076803702337,3859700.0
3301,BSESN,2016-12-19,26374.699219,26505.660156,26340.380859,26505.660156,7400.0,-114.86132800000269,114.86132800000269,0.0,43.115947814731435,26125.349609,26803.759766,36.754993631381915,-63.245006368618085,-120.46127744055411,-176.9949552299859,-0.0006842992987519114,3852300.0
3302,BSESN,2016-12-20,26307.980469,26435.560547,26241.429688,26374.589844,7300.0,-66.71875,66.71875,0.0,40.2447685333628,26125.349609,26803.759766,26.920419471254746,-73.07958052874525,-126.75371163711316,-166.94670651141135,0.002710358755758424,3845000.0
3303,BSESN,2016-12-21,26242.380859,26396.0,26213.509766,26368.880859,6100.0,-65.59960999999747,65.59960999999747,0.0,37.417915520934365,26125.349609,26803.759766,17.250810412026343,-82.74918958797366,-135.47221202886794,-160.65180761490268,-0.01692866224153078,3838900.0
3304,BSESN,2016-12-22,25979.599609,26248.449219,25940.140625,26224.070313,7600.0,-262.78125,262.78125,0.0,28.247088414110337,25940.140625,26803.759766,4.569026104992364,-95.43097389500763,-161.72170991951134,-160.8657880758244,-0.02869760804517163,3831300.0
3305,BSESN,2016-12-23,26040.699219,26143.189453,25872.380859,25959.990234,7500.0,61.099609999997476,0.0,61.099609999997476,32.67402726801423,25872.380859,26803.759766,18.071953179845607,-81.92804682015439,-175.57053043303677,-163.8067365472669,-0.017896915540350555,3838800.0
3306,BSESN,2016-12-26,25807.099609,26008.570313,25753.740234,25992.410156,5400.0,-233.59960999999748,233.59960999999748,0.0,25.683628430500093,25753.740234,26803.759766,5.081750707852555,-94.91824929214745,-203.05466889312083,-171.6563230164377,-0.03336304962567593,3833400.0
3307,BSESN,2016-12-27,26213.439453,26249.029297,25803.189453,25815.429688,8700.0,406.3398439999983,0.0,406.3398439999983,48.0087829961545,25753.740234,26803.759766,43.78006360742621,-56.2199363925738,-189.8592380354312,-175.29690602023643,-0.014637549723392596,3842100.0
3308,BSESN,2016-12-28,26210.679688,26415.050781,26191.720703,26243.189453,8500.0,-2.759764999998879,2.759764999998879,0.0,47.896026891093776,25753.740234,26803.759766,43.517233734657815,-56.482766265342185,-177.57745165934102,-175.75301514805736,-0.011629013436750157,3833600.0
3309,BSESN,2016-12-29,26366.150391,26429.630859,26166.669922,26429.410156,6700.0,155.47070299999902,0.0,155.47070299999902,54.79700908300504,25753.740234,26737.859375,62.22926996193837,-37.77073003806163,-153.5290734711307,-171.30822681267205,-0.004658822322893497,3840300.0
3310,BSESN,2016-12-30,26626.460938,26678.599609,26406.529297,26441.509766,8600.0,260.3105470000009,0.0,260.3105470000009,64.00683146873277,25753.740234,26737.859375,88.6803911885299,-11.319608811470108,-112.17261873710595,-159.48110519755883,0.009545576876897055,3848900.0
3311,BSESN,2017-01-02,26595.449219,26720.980469,26447.060547,26711.150391,8000.0,-31.011719000001907,31.011719000001907,0.0,62.26303282035734,25753.740234,26737.859375,85.52917527289495,-14.470824727105052,-80.96638684307618,-143.7781615266623,0.010927055018105092,3840900.0
3312,BSESN,2017-01-03,26643.240234,26724.400391,26488.369141,26616.919922,9800.0,47.791015000002524,0.0,47.791015000002524,64.00668622144978,25753.740234,26737.859375,90.38539775744498,-9.61460224255503,-51.78197733244815,-125.37892468781948,0.015275267025267825,3850700.0
3313,BSESN,2017-01-04,26633.130859,26723.369141,26606.060547,26677.220703,8100.0,-10.109375,10.109375,0.0,63.292890312149105,25753.740234,26724.400391,90.59716922119442,-9.402830778805582,-29.13303709098909,-106.12974716845342,0.0251555551215501,3842600.0
3314,BSESN,2017-01-05,26878.240234,26917.210938,26738.419922,26738.419922,9800.0,245.10937499999642,0.0,245.10937499999642,72.02167750938413,25753.740234,26917.210938,96.6504782745265,-3.3495217254734944,8.496744147658319,-83.20444890523108,0.03216276982259014,3852400.0
3315,BSESN,2017-01-06,26759.230469,27009.609375,26733.330078,26929.689452999995,7800.0,-119.00976499999888,119.00976499999888,0.0,63.5548107088204,25753.740234,27009.609375,80.06329657876339,-19.936703421236615,28.3882810252544,-60.885902919133976,0.03689414441861372,3844600.0
3316,BSESN,2017-01-09,26726.550781,26860.880859,26701.179688,26860.810547000005,6400.0,-32.67968799999653,32.67968799999653,0.0,61.272532738824026,25753.740234,27009.609375,77.4611394802957,-22.538860519704293,41.042378612834,-40.500246612740376,0.019574361041785338,3838200.0
3317,BSESN,2017-01-10,26899.560547000005,26914.949219,26804.169922,26811.630859,8600.0,173.00976600000286,0.0,173.00976600000286,68.23955648788963,25753.740234,27009.609375,91.23723767013115,-8.762762329868847,64.29018707474461,-19.542159875243375,0.026282449261145757,3846800.0
3318,BSESN,2017-01-11,27140.410156,27174.869141000006,26978.439452999995,26978.439452999995,12000.0,240.84960899999714,0.0,240.84960899999714,75.35981031475463,25753.740234,27174.869141000006,97.57523861274855,-2.4247613872514537,100.98470454120252,4.563213008045811,0.02936567354422337,3858800.0
3319,BSESN,2017-01-12,27247.160156,27278.929688,27166.689452999995,27171.660156,11700.0,106.75,0.0,106.75,77.89426076505396,25753.740234,27278.929688,97.91701077419079,-2.0829892258092184,137.09881703439896,31.07033381331645,0.023311367569475605,3870500.0
3320,BSESN,2017-01-13,27238.060547000005,27459.75,27143.070313,27378.009766000006,10200.0,-9.099608999997145,9.099608999997145,0.0,77.11411386847452,25803.189453,27459.75,86.61748564509334,-13.382514354906661,163.1050751981893,57.47728209029103,0.024162454362339547,3860300.0
3321,BSESN,2017-01-16,27288.169922000005,27335.080077999995,27172.679688,27238.349609,12600.0,50.109375,0.0,50.109375,78.48338376472964,26166.669922,27459.75,86.73090082206065,-13.269099177939353,185.61893045245597,83.10561176272402,0.024206128171189834,3872900.0
3322,BSESN,2017-01-17,27235.660156,27381.429688,27179.189452999995,27331.820313,8100.0,-52.50976600000286,52.50976600000286,0.0,73.18876436896923,26166.669922,27459.75,82.67007219331714,-17.32992780668286,196.95386214794053,105.87526183976733,0.022623299535825758,3864800.0
3323,BSESN,2017-01-18,27257.640625,27422.669922000005,27217.650391000006,27261.759766000006,9500.0,21.980468999998266,0.0,21.980468999998266,74.03480910102688,26406.529297,27459.75,80.81034920560234,-19.189650794397668,205.34344590767796,125.76889865334947,0.014115521987189794,3874300.0
3324,BSESN,2017-01-19,27308.599609,27348.189452999995,27219.890625,27253.339844,10800.0,50.95898399999714,0.0,50.95898399999714,76.05598960801014,26447.060547,27459.75,85.07435911846123,-14.92564088153877,213.64148950396338,143.34341682347227,0.02053007991528144,3885100.0
3325,BSESN,2017-01-20,27034.5,27264.410156,27009.810547000005,27232.689452999995,8800.0,-274.09960899999714,274.09960899999714,0.0,51.28130202323694,26488.369141,27459.75,56.222114522847555,-43.777885477152445,195.8426489881931,153.84326325641644,0.011522220787985926,3876300.0
3326,BSESN,2017-01-23,27117.339844,27167.789063,26963.580077999995,26990.929688,6600.0,82.83984399999827,0.0,82.83984399999827,56.25091432575306,26606.060547,27459.75,59.890548630216934,-40.10945136978307,186.27417005431562,160.3294446159963,0.00809601690776618,3882900.0
3327,BSESN,2017-01-24,27375.580077999995,27393.349609,27140.849609,27170.880859,6800.0,258.24023399999714,0.0,258.24023399999714,67.99416910352656,26701.179688,27459.75,88.90413707622075,-11.095862923779254,197.25507650721556,167.71457099424015,0.008664936183656158,3889700.0
3328,BSESN,2017-01-25,27708.140625,27736.830077999995,27439.679688,27462.830077999995,12200.0,332.5605470000046,0.0,332.5605470000046,77.11996742550951,26701.179688,27736.830077999995,97.22981294875044,-2.7701870512495574,230.13947617820668,180.19955203103348,0.01691847760870191,3901900.0
3329,BSESN,2017-01-27,27882.460938,27980.390625,27759.480469,27761.029297000005,14300.0,174.32031300000014,0.0,174.32031300000014,80.4853054749278,26701.179688,27980.390625,92.34452394304382,-7.655476056956183,267.1868287959005,197.5970073840069,0.02365808644444667,3916200.0
3330,BSESN,2017-01-30,27849.560547000005,27947.369141000006,27813.320313,27866.800781,8600.0,-32.90039099999558,32.90039099999558,0.0,77.98728035187975,26804.169922,27980.390625,88.87708083471853,-11.122919165281477,290.5431356525369,216.1862330377129,0.020572674041706263,3907600.0
3331,BSESN,2017-01-31,27655.960938,27867.919922000005,27624.539063,27867.919922000005,10700.0,-193.59960900000442,193.59960900000442,0.0,64.41330357393775,26963.580077999995,27980.390625,68.0933987204208,-31.90660127957921,290.08736012822555,230.96645845581543,0.015432002734378614,3896900.0
3332,BSESN,2017-02-01,28141.640625,28159.539063,27590.099609,27669.080077999995,18200.0,485.67968699999983,0.0,485.67968699999983,76.33582416087381,26963.580077999995,28159.539063,98.50342376080731,-1.4965762391926924,325.16811091540876,249.8067889477341,0.032431273570656005,3915100.0
3333,BSESN,2017-02-02,28226.609375,28299.919922000005,28070.810547000005,28167.830077999995,17200.0,84.96875,0.0,84.96875,77.83484728166967,26963.580077999995,28299.919922000005,94.5140790848107,-5.485920915189302,355.72554402883543,270.9905399639544,0.03361614213632014,3932300.0
3334,BSESN,2017-02-03,28240.519531,28280.580077999995,28127.179688,28270.669922000005,10800.0,13.910156000001733,0.0,13.910156000001733,78.09693252382483,26963.580077999995,28299.919922000005,95.55499364426625,-4.445006355733748,376.72234259885954,292.13690049093543,0.0446103878747528,3943100.0
3335,BSESN,2017-02-06,28439.279297000005,28487.279297000005,28340.390625,28340.390625,10000.0,198.75976600000286,0.0,198.75976600000286,81.67025798784522,26963.580077999995,28487.279297000005,96.84977196276952,-3.150228037230471,404.7351736084347,314.6565551144353,0.04874886182069593,3953100.0
3336,BSESN,2017-02-07,28335.160156,28483.410156,28239.119141000006,28443.230469,10800.0,-104.11914100000286,104.11914100000286,0.0,74.33967833398823,26963.580077999995,28487.279297000005,90.01645868796616,-9.983541312033838,413.7643812585775,334.47812034326375,0.03505241077142185,3942300.0
3337,BSESN,2017-02-08,28289.919922000005,28391.640625,28149.080077999995,28386.080077999995,10900.0,-45.24023399999714,45.24023399999714,0.0,71.13841960754638,26963.580077999995,28487.279297000005,87.04735340551495,-12.952646594485051,412.5143756367943,350.0853714019699,0.020996692086768354,3931400.0
3338,BSESN,2017-02-09,28329.699219,28469.480469,28152.179688,28349.220702999995,10200.0,39.77929699999368,0.0,39.77929699999368,72.34659205170883,26963.580077999995,28487.279297000005,89.65805875365449,-10.341941246345508,410.0072852307021,362.0697541677164,0.016040129384364166,3941600.0
3339,BSESN,2017-02-10,28334.25,28456.179688,28286.800781,28367.169922000005,13700.0,4.5507810000017335,0.0,4.5507810000017335,72.49855616907037,26963.580077999995,28487.279297000005,89.9567253765191,-10.043274623480901,403.73361818056947,370.40252697028706,0.01740384564352504,3955300.0
3340,BSESN,2017-02-13,28351.619141000006,28458.800781,28197.380859,28450.419922000005,9400.0,17.369141000002855,0.0,17.369141000002855,73.14839104622304,27140.849609,28487.279297000005,89.92445300270312,-10.075546997296877,395.60297156087836,375.4426158884054,0.025154005841979465,3964700.0
3341,BSESN,2017-02-14,28339.310547000005,28393.419922000005,28263.449219,28386.119141000006,11700.0,-12.308593999998267,12.308593999998267,0.0,71.7618925027059,27439.679688,28487.279297000005,85.8754481455711,-14.124551854428896,383.7426287157032,377.102618453865,0.00702410796278885,3953000.0
3342,BSESN,2017-02-15,28155.560547000005,28382.320313,28102.230469,28270.109375,17800.0,-183.75,183.75,0.0,54.09872837535668,27590.099609,28487.279297000005,63.026497987324184,-36.973502012675816,355.41908228468674,372.76591122002935,-0.002517086875582164,3935200.0
3343,BSESN,2017-02-16,28301.269531,28327.839844,28146.189452999995,28223.849609,9700.0,145.70898399999712,0.0,145.70898399999712,62.5358988998125,27590.099609,28487.279297000005,79.2672785075355,-20.732721492464513,340.80141833691596,366.3730126434067,0.002151164391055671,3944900.0
3344,BSESN,2017-02-17,28468.75,28726.259766000006,28410.910156,28670.429688,15000.0,167.4804689999983,0.0,167.4804689999983,69.87883324626853,27590.099609,28726.259766000006,77.33508217010947,-22.664917829890527,338.82532110903776,360.86347433653293,0.0010362675752864092,3959900.0
3345,BSESN,2017-02-20,28661.580077999995,28696.529297000005,28419.269531,28481.910156,8900.0,192.8300779999954,0.0,192.8300779999954,76.1015789325358,27590.099609,28726.259766000006,94.3071680870419,-5.692831912958092,348.79829592926035,358.4504386550785,0.01151996036736258,3968800.0
3346,BSESN,2017-02-21,28761.589844,28801.0,28597.330077999995,28716.699219,8400.0,100.00976600000286,0.0,100.00976600000286,78.73106862624977,28070.810547000005,28801.0,94.60274921281258,-5.397250787187415,360.6149578661352,358.88334249728985,0.01667272029402933,3977200.0
3347,BSESN,2017-02-22,28864.710938,28963.519531,28789.300781,28822.400391000006,16300.0,103.1210940000019,0.0,103.1210940000019,81.19299425216695,28102.230469,28963.519531,88.52782447154762,-11.472175528452395,373.9896383025334,361.9046016583386,0.0188851888212489,3993500.0
3348,BSESN,2017-02-23,28892.970702999995,29065.310547000005,28860.460938,28927.669922000005,18400.0,28.259764999995237,0.0,28.259764999995237,81.85705230629475,28102.230469,29065.310547000005,82.10534638429017,-17.894653615709828,382.4607265840168,366.01582664347427,0.019718916258591568,4011900.0
3349,BSESN,2017-02-27,28812.880859,28961.830077999995,28791.189452999995,28910.5,12000.0,-80.08984399999827,80.08984399999827,0.0,73.38391792247819,28102.230469,29065.310547000005,73.78933551151682,-26.210664488483182,378.35015888905764,368.482693092591,0.016269325420393832,3999900.0
3350,BSESN,2017-02-28,28743.320313,28876.539063,28721.119141000006,28825.189452999995,10700.0,-69.56054599999698,69.56054599999698,0.0,66.48695519840156,28102.230469,29065.310547000005,66.56661877289893,-33.433381227101066,365.26895649683865,367.83994577344055,0.0142561607252214,3989200.0
3351,BSESN,2017-03-01,28984.490234,29029.169922000005,28824.169922000005,28849.039063,14600.0,241.16992099999698,0.0,241.16992099999698,75.64424021614784,28102.230469,29065.310547000005,91.60814195556402,-8.391858044435976,370.09616818957875,368.29119025666824,0.029441064958243945,4003800.0
3352,BSESN,2017-03-02,28839.789063,29145.619141000006,28784.310547000005,29117.380859,10800.0,-144.70117099999698,144.70117099999698,0.0,63.611016487746284,28102.230469,29145.619141000006,70.68876764650135,-29.31123235349865,358.11743814612055,366.25643983455876,0.019028105131825512,3993000.0
3353,BSESN,2017-03-03,28832.449219,28860.130859,28716.210938,28827.5,9300.0,-7.339844000001904,7.339844000001904,0.0,63.02423500551348,28102.230469,29145.619141000006,69.98530553339131,-30.014694466608677,344.06576821297494,361.81830551024206,0.01277538420197577,3983700.0
3354,BSESN,2017-03-06,29048.189452999995,29070.199219,28856.119141000006,28859.210938,12100.0,215.74023399999714,0.0,215.74023399999714,71.83550108100091,28102.230469,29145.619141000006,90.66218652601871,-9.337813473981276,346.3456948441235,358.7237833770184,0.013488766981718303,3995800.0
3355,BSESN,2017-03-07,28999.560547000005,29098.169922000005,28957.679688,29092.160156,9700.0,-48.62890599999081,48.62890599999081,0.0,67.64316283890936,28102.230469,29145.619141000006,86.00151622117662,-13.998483778823386,340.3057736936571,355.04018144034615,0.008273906424878907,3986100.0
3356,BSESN,2017-03-08,28901.939452999995,29022.320313,28815.480469,29021.060547000005,16300.0,-97.6210940000092,97.6210940000092,0.0,59.58802039642551,28146.189452999995,29145.619141000006,75.61812592463149,-24.381874075368508,323.90807556502114,348.8137602652812,0.0012897588020182038,3969800.0
3357,BSESN,2017-03-09,28929.130859,28986.720702999995,28815.019531,28909.699219,401500.0,27.19140600000173,0.0,27.19140600000173,61.07766975093449,28410.910156,29145.619141000006,70.5341452983586,-29.465854701641398,309.5387310646329,340.95875442515154,0.0012515208758459018,4371300.0
3358,BSESN,2017-03-10,28946.230469,29076.630859,28851.039063,29006.0,15900.0,17.099610000001118,0.0,17.099610000001118,62.0916085270065,28419.269531,29145.619141000006,72.54921469566055,-27.450785304339455,296.1172621704354,331.9904559742083,0.004628124853344628,4387200.0
3359,BSESN,2017-03-14,29442.630859,29561.929688,29356.050781,29437.230469,29200.0,496.4003899999989,0.0,496.4003899999989,79.75609474823275,28597.330077999995,29561.929688,87.63229553866408,-12.367704461335912,321.8262021288756,329.9576052051418,0.024329497719291604,4416400.0
3360,BSESN,2017-03-15,29398.109375,29500.080077999995,29358.910156,29452.859375,392500.0,-44.52148399999715,44.52148399999715,0.0,76.08697894712553,28716.210938,29561.929688,80.62945713335549,-19.370542866644517,334.74942756492965,330.9159696770994,0.014270361067616921,4023900.0
3361,BSESN,2017-03-16,29585.849609,29614.789063,29482.830077999995,29482.830077999995,18400.0,187.74023399999714,0.0,187.74023399999714,80.4606266614451,28716.210938,29614.789063,96.77941703733336,-3.2205829626666445,356.0360823702176,335.93999221572307,0.025869140178877315,4042300.0
3362,BSESN,2017-03-17,29648.990234,29824.619141000006,29601.859375,29755.740234,14500.0,63.140625,0.0,63.140625,81.75553746709225,28716.210938,29824.619141000006,84.15485319175279,-15.845146808247208,373.6931286436484,343.4906195013082,0.02832020994116302,4056800.0
3363,BSESN,2017-03-20,29518.740234,29699.480469,29482.400391000006,29653.539063,400800.0,-130.25,130.25,0.0,70.6164000839374,28716.210938,29824.619141000006,72.40376729691128,-27.59623270308872,372.8780722636402,349.3681100537746,0.016198971084285807,3656000.0
3364,BSESN,2017-03-21,29485.449219,29585.050781,29380.140625,29525.880859,11500.0,-33.29101499999888,33.29101499999888,0.0,67.88850394082749,28716.210938,29824.619141000006,69.40026958642002,-30.59973041357998,365.3344790626288,352.5613838555455,0.01675503569140324,3644500.0
3365,BSESN,2017-03-22,29167.679688,29341.410156,29137.480469,29341.410156,14700.0,-317.76953099999815,317.76953099999815,0.0,47.62579129906529,28716.210938,29824.619141000006,40.731271094715765,-59.26872890528424,329.9117642064193,348.0314599257203,0.009194546803066528,3629800.0
3366,BSESN,2017-03-23,29332.160156,29373.789063,29198.080077999995,29201.009766000006,26000.0,164.48046800000157,0.0,164.48046800000157,55.54949199897663,28716.210938,29824.619141000006,55.57061165127429,-44.4293883487257,311.5201957212812,340.7292070848325,0.013931607519228839,3655800.0
3367,BSESN,2017-03-24,29421.400391000006,29539.849609,29350.169922000005,29350.599609,21000.0,89.24023500000112,0.0,89.24023500000112,59.39524802514893,28815.019531,29824.619141000006,60.061518843098796,-39.93848115690121,300.67963863780824,332.7192933954277,0.0164156062568801,3676800.0
3368,BSESN,2017-03-27,29237.150391000006,29420.699219,29163.539063,29395.679688,15100.0,-184.25,184.25,0.0,49.24528706103186,28815.019531,29824.619141000006,41.8117098916077,-58.1882901083923,274.0617703970529,320.98778879575275,-0.006979011793614376,3661700.0
3369,BSESN,2017-03-28,29409.519531,29442.179688,29301.220702999995,29301.220702999995,33500.0,172.3691399999989,0.0,172.3691399999989,57.1496514928447,28815.019531,29824.619141000006,58.88472956125619,-41.11527043874381,263.8343489503386,309.55710082666997,0.0003881255033939546,3695200.0
3370,BSESN,2017-03-29,29531.429688,29554.390625,29439.419922000005,29463.009766000006,41600.0,121.91015699999843,0.0,121.91015699999843,61.98150523712226,28815.019531,29824.619141000006,70.95982901578132,-29.040170984218676,262.53977944137296,300.15363654961055,-0.001839390171963995,3736800.0
3371,BSESN,2017-03-30,29647.419922000005,29684.539063,29521.650391000006,29538.029297000005,15700.0,115.99023400000442,0.0,115.99023400000442,66.16942405100046,28851.039063,29824.619141000006,81.79921477398999,-18.200785226010012,267.7863914620757,293.6801875321036,-5.296342261917886e-05,3752500.0
3372,BSESN,2017-03-31,29620.5,29687.640625,29552.609375,29633.910156,11800.0,-26.919922000004593,26.919922000004593,0.0,64.2734379647946,29137.480469,29824.619141000006,70.29433077811052,-29.70566922188947,266.69782999154995,288.2837160239929,0.003447293657972361,3740700.0
3373,BSESN,2017-04-03,29910.220702999995,29926.939452999995,29705.720702999995,29737.730469,10100.0,289.7207029999954,0.0,289.7207029999954,73.64949712659151,29137.480469,29926.939452999995,97.88225223363851,-2.117747766361483,285.91729996203867,287.8104328116021,0.014406139138157803,3750800.0
3374,BSESN,2017-04-05,29974.240234,30007.480469,29817.689452999995,29996.029297000005,11200.0,64.01953100000172,0.0,64.01953100000172,75.30210535675843,29137.480469,30007.480469,96.17928333333361,-3.820716666666377,302.8239435803698,290.81313496535563,0.027652544001703028,3762000.0
3375,BSESN,2017-04-06,29927.339844,29954.25,29817.589844,29946.890625,11300.0,-46.900389999998886,46.900389999998886,0.0,71.5110010485611,29137.480469,30007.480469,90.78843390804597,-9.211566091954023,308.8775626707393,294.4260205064324,0.02029102816957895,3750700.0
3376,BSESN,2017-04-07,29706.609375,29886.119141000006,29668.449219,29850.710938,14700.0,-220.7304689999983,220.7304689999983,0.0,56.15770276163892,29137.480469,30007.480469,65.4171156321841,-34.58288436781589,292.492325825071,294.03928157016014,0.009693929595793183,3736000.0
3377,BSESN,2017-04-10,29575.740234,29831.320313,29553.039063,29752.619141000006,10700.0,-130.86914100000286,130.86914100000286,0.0,48.96578917087054,29137.480469,30007.480469,50.3746856321842,-49.625314367815804,265.8819401160654,288.4078132793412,0.011580808610685223,3725300.0
3378,BSESN,2017-04-11,29788.349609,29804.509766000006,29570.580077999995,29630.060547000005,10800.0,212.609375,0.0,212.609375,58.84552364757549,29137.480469,30007.480469,74.81254482758649,-25.187455172413504,258.9636457273482,282.51897976894264,0.012881205951041919,3736100.0
3379,BSESN,2017-04-12,29643.480469,29838.820313,29549.740234,29838.820313,8500.0,-144.86913999999888,144.86913999999888,0.0,51.07215241539358,29163.539063,30007.480469,56.86904358381477,-43.13095641618523,239.0356643603809,273.8223166872303,0.003794289073838053,3727600.0
3380,BSESN,2017-04-13,29461.449219,29660.480469,29442.259766000006,29637.119141000006,10700.0,-182.03125,182.03125,0.0,42.86302858362009,29163.539063,30007.480469,35.29986251201885,-64.70013748798115,206.17750899468592,260.2933551487214,-0.006272744929888718,3716900.0
3381,BSESN,2017-04-17,29413.660156,29494.080077999995,29363.279297000005,29470.269531,6700.0,-47.78906299999653,47.78906299999653,0.0,40.87291122313848,29163.539063,30007.480469,29.637258134482636,-70.36274186551736,174.2721057880044,243.08910527657798,-0.006982996370756722,3710200.0
3382,BSESN,2017-04-18,29319.099609,29701.189452999995,29286.380859,29487.779297000005,12100.0,-94.56054700000459,94.56054700000459,0.0,36.955458235788214,29286.380859,30007.480469,4.537341241940225,-95.46265875805977,139.74569661138958,222.42042354354032,-0.019763180615404274,3698100.0
3383,BSESN,2017-04-19,29336.570313,29388.25,29241.480469,29369.900391000006,11600.0,17.470704000003025,0.0,17.470704000003025,38.217808477039455,29241.480469,30007.480469,12.41381775456944,-87.58618224543056,112.49622197317512,200.43558322946728,-0.021273931082886555,3709700.0
3384,BSESN,2017-04-20,29422.390625,29453.060547000005,29341.679688,29358.589844,14600.0,85.82031199999983,0.0,85.82031199999983,44.51485224609381,29241.480469,30007.480469,23.61751383812033,-76.38248616187967,96.71097502901466,179.6906615893768,-0.016872505930433768,3724300.0
3385,BSESN,2017-04-21,29365.300781,29584.339844,29259.419922000005,29575.660156,11300.0,-57.08984399999825,57.08984399999825,0.0,41.2850020000364,29241.480469,30007.480469,16.164531592689748,-83.83546840731026,78.68732134878883,159.4899935412592,-0.01148931504405315,3713000.0
3386,BSESN,2017-04-24,29655.839844,29681.330077999995,29392.990234,29407.679688,8900.0,290.5390629999965,0.0,290.5390629999965,58.82712710336437,29241.480469,30007.480469,54.0939131853786,-45.90608681462141,86.8464088603032,144.961276605068,0.0027082875818578156,3721900.0
3387,BSESN,2017-04-25,29943.240234,29961.820313,29780.839844,29825.140625,8600.0,287.4003899999989,0.0,287.4003899999989,69.29705905521803,29241.480469,30007.480469,91.61354634464784,-8.386453655352152,115.17568051336639,139.00415738672768,0.005199704818598105,3730500.0
3388,BSESN,2017-04-26,30133.349609,30167.089844,29968.570313,30030.199219,10900.0,190.109375,0.0,190.109375,74.28752077832505,29241.480469,30167.089844,96.3548084201289,-3.6451915798710965,151.22385567728998,141.44809704484015,0.016525358434624104,3741400.0
3389,BSESN,2017-04-27,30029.740234,30184.220702999995,29973.400391000006,30141.390625,10700.0,-103.609375,103.609375,0.0,67.39854440205042,29241.480469,30184.220702999995,83.61367602350627,-16.38632397649373,169.478243846439,147.05412640515993,0.019289309591515424,3730700.0
3390,BSESN,2017-04-28,29918.400391000006,30067.640625,29848.210938,30064.599609,11300.0,-111.33984299999427,111.33984299999427,0.0,60.44797987186478,29241.480469,30184.220702999995,71.8034403950145,-28.196559604985495,172.96692808327498,152.23668674078294,0.017160062104581097,3719400.0
3391,BSESN,2017-05-02,29921.179688,30069.240234,29804.119141000006,30021.490234,11700.0,2.7792969999973143,0.0,2.7792969999973143,60.56511372132966,29241.480469,30184.220702999995,72.09825087405827,-27.901749125941734,173.9508049174583,156.57951037611804,0.020535421859107172,3731100.0
3392,BSESN,2017-05-03,29894.800781,30020.589844,29846.570313,29984.949219,11300.0,-26.378906999998435,26.378906999998435,0.0,58.66252786300161,29241.480469,30184.220702999995,69.30014106091556,-30.69985893908444,170.63500296227357,159.39060889334917,0.019028484313063476,3719800.0
3393,BSESN,2017-05-04,30126.210938,30169.949219,30007.400391000006,30069.720702999995,22300.0,231.41015699999843,0.0,231.41015699999843,68.63565711217963,29241.480469,30184.220702999995,93.84668619118303,-6.1533138088169705,184.5526634935377,164.42301981338687,0.02392124834349696,3742100.0
3394,BSESN,2017-05-05,29858.800781,30176.550781,29823.599609,30142.140625,15900.0,-267.41015699999843,267.41015699999843,0.0,51.930416749036866,29241.480469,30184.220702999995,65.48148575146155,-34.518514248538445,172.02178485001423,165.94277282071235,0.016805548959992533,3726200.0
3395,BSESN,2017-05-08,29926.150391000006,30016.039063,29877.410156,29915.119141000006,10000.0,67.34961000000112,0.0,67.34961000000112,55.10581443004244,29241.480469,30184.220702999995,72.62551202413307,-27.374487975866924,165.6164011281653,165.87749848220295,0.009114917952819157,3736200.0
3396,BSESN,2017-05-09,29933.25,30017.820313,29911.439452999995,29977.5,8400.0,7.099608999997145,0.0,7.099608999997145,55.46365501212501,29241.480469,30184.220702999995,73.37859423532397,-26.621405764676016,159.27692227910666,164.5573832415837,-0.00033363904246597187,3744600.0
3397,BSESN,2017-05-10,30248.169922000005,30271.599609,29987.439452999995,29988.779297000005,11000.0,314.9199220000046,0.0,314.9199220000046,68.36808002204788,29259.419922000005,30271.599609,97.6852245405715,-2.3147754594285077,177.61678963919985,167.16926452110692,0.0038104065591735292,3755600.0
3398,BSESN,2017-05-11,30250.980469,30366.429688,30207.109375,30309.710938,10700.0,2.810546999993676,0.0,2.810546999993676,68.46218104948058,29259.419922000005,30366.429688,89.57107493123937,-10.428925068760627,190.18571180862637,171.77255397861083,0.007367370922160221,3766300.0
3399,BSESN,2017-05-12,30188.150391000006,30299.740234,30111.449219,30285.609375,11100.0,-62.8300779999954,62.8300779999954,0.0,63.5831299351533,29392.990234,30366.429688,81.68563065043038,-18.314369349569613,192.85371341932841,175.98878586675437,0.009016190587553874,3755200.0
3400,BSESN,2017-05-15,30322.119141000006,30357.960938,30273.619141000006,30287.369141000006,8000.0,133.96875,0.0,133.96875,69.01575111930079,29780.839844,30366.429688,92.43317700024977,-7.5668229997502365,203.4332307676632,181.47767484693614,0.013399854456968674,3763200.0
3401,BSESN,2017-05-16,30582.599609,30591.550781,30363.369141000006,30391.480469,13600.0,260.4804679999943,0.0,260.4804679999943,76.78521480028874,29804.119141000006,30591.550781,98.86324456050546,-1.1367554394945327,230.18276766715644,191.21869341098022,0.02300730595392153,3776800.0
3402,BSESN,2017-05-17,30658.769531,30692.449219,30519.140625,30616.529297000005,14900.0,76.16992200000459,0.0,76.16992200000459,78.59613197278138,29804.119141000006,30692.449219,96.20865162239876,-3.791348377601241,254.59344969761878,203.89364466830796,0.01767758295578603,3791700.0
3403,BSESN,2017-05-18,30434.789063,30575.830077999995,30393.720702999995,30466.820313,16200.0,-223.9804680000016,223.9804680000016,0.0,62.147429908141625,29804.119141000006,30692.449219,70.99499810024439,-29.005001899755612,252.94989031182195,213.70489379701078,0.019290402391730188,3775500.0
3404,BSESN,2017-05-19,30464.919922000005,30712.349609,30338.519531,30539.650391000006,13800.0,30.13085900000442,0.0,30.13085900000442,63.33837421682263,29804.119141000006,30712.349609,72.75694928569632,-27.243050714303692,251.1831827894821,221.20055159550506,0.018003302261089704,3789300.0
3405,BSESN,2017-05-22,30570.970702999995,30712.150391000006,30516.869141000006,30638.880859,11400.0,106.0507809999908,0.0,106.0507809999908,67.49207827796025,29823.599609,30712.349609,84.09238751054792,-15.907612489452081,255.39641517751443,228.03972431190695,0.02130475985734903,3800700.0
3406,BSESN,2017-05-23,30365.25,30610.640625,30316.919922000005,30553.890625,18700.0,-205.7207029999954,205.7207029999954,0.0,53.8389430511286,29823.599609,30712.349609,60.94519167369893,-39.05480832630107,239.37611193534758,230.30700183659508,0.0038706499699621144,3782000.0
3407,BSESN,2017-05-24,30301.640625,30534.150391000006,30247.599609,30446.769531,11300.0,-63.609375,63.609375,0.0,50.21482310699017,29823.599609,30712.349609,53.78801867791834,-46.21198132208166,219.02240726486707,228.05008292224946,0.0016746616213618726,3770700.0
3408,BSESN,2017-05-25,30750.029297000005,30793.429688,30352.259766000006,30374.810547000005,10000.0,448.38867200000465,0.0,448.38867200000465,67.82872887330493,29877.410156,30793.429688,95.26206707566192,-4.737932924338086,236.34868761403777,229.70980386060714,0.018612564821709254,3780700.0
3409,BSESN,2017-05-26,31028.210938,31074.070313,30745.570313,30765.769531,14600.0,278.1816409999956,0.0,278.1816409999956,74.33005905311803,29911.439452999995,31074.070313,96.05555154453755,-3.944448455462451,269.4211044048243,237.65206396945058,0.023286360485446744,3795300.0
3410,BSESN,2017-05-29,31109.279297000005,31214.390625,30869.900391000006,30944.380859,14900.0,81.06835900000442,0.0,81.06835900000442,75.96340356677591,29987.439452999995,31214.390625,91.43312868525506,-8.566871314744953,298.72920768643235,249.86749271284697,0.017221547374442592,3810200.0
3411,BSESN,2017-05-30,31159.400391000006,31220.380859,31064.039063,31111.730469,9600.0,50.12109399999825,0.0,50.12109399999825,77.00707596865368,30111.449219,31220.380859,94.50097140343166,-5.499028596568328,322.2853393209043,264.3510620344585,0.016329124347074675,3819800.0
3412,BSESN,2017-05-31,31145.800781,31255.279297000005,31107.480469,31222.509766000006,13000.0,-13.599610000001118,13.599610000001118,0.0,75.97428679081986,30111.449219,31255.279297000005,90.42877800595814,-9.571221994041867,335.9833614354211,278.67752191465104,0.02336180863708992,3806800.0
3413,BSESN,2017-06-01,31137.589844,31213.119141000006,31062.019531,31117.089844,8300.0,-8.210937000003469,8.210937000003469,0.0,75.27101533270739,30247.599609,31255.279297000005,88.320747713632,-11.679252286367996,342.2315563065058,291.388328793022,0.022080147386641658,3798500.0
3414,BSESN,2017-06-02,31273.289063,31332.560547000005,31190.400391000006,31205.369141000006,8500.0,135.6992190000019,0.0,135.6992190000019,78.98120934336356,30247.599609,31332.560547000005,94.53699373645061,-5.46300626354939,354.05179988576856,303.9210230115713,0.022973374539627667,3807000.0
3415,BSESN,2017-06-05,31309.490234,31355.419922000005,31198.220702999995,31274.740234,9000.0,36.201170999996975,0.0,36.201170999996975,79.90907161876689,30247.599609,31355.419922000005,95.85404894087695,-4.145951059123037,362.16573883948513,315.56996617715413,0.03109607969636352,3816000.0
3416,BSESN,2017-06-06,31190.560547000005,31430.320313,31172.550781,31420.849609,13600.0,-118.92968699999255,118.92968699999255,0.0,68.45417220842957,30247.599609,31430.320313,79.72811626708484,-20.271883732915164,354.90830015263055,323.43763297224945,0.02933570274299324,3802400.0
3417,BSESN,2017-06-07,31271.279297000005,31346.990234,31172.980469,31252.710938,9500.0,80.71875,0.0,80.71875,71.63809581516807,30247.599609,31430.320313,86.55295240354602,-13.447047596453988,351.61683622244163,329.0734736222879,0.016951203361970535,3811900.0
3418,BSESN,2017-06-08,31213.359375,31354.509766000006,31193.769531,31316.910156,14000.0,-57.9199220000046,57.9199220000046,0.0,66.11336150451396,30247.599609,31430.320313,81.6557757663131,-18.344224233686898,340.4106318301565,331.34090526386166,0.00596709998426781,3797900.0
3419,BSESN,2017-06-09,31262.060547000005,31289.990234,31087.279297000005,31196.859375,9800.0,48.7011720000046,0.0,48.7011720000046,68.4723120604882,30247.599609,31430.320313,85.7734995734043,-14.2265004265957,331.63651240224135,331.4000266915376,0.0049111150580314344,3807700.0
3420,BSESN,2017-06-12,31095.699219,31225.429688,31044.279297000005,31225.429688,6800.0,-166.36132800000632,166.36132800000632,0.0,53.72993442890167,30247.599609,31430.320313,71.70751362783263,-28.29248637216738,307.71187970627216,326.66239729448455,-0.0020443644999794675,3800900.0
3421,BSESN,2017-06-13,31103.490234,31260.769531,31062.339844,31091.099609,13300.0,7.79101499999888,0.0,7.79101499999888,54.262065545801654,30352.259766000006,31430.320313,69.6835136106691,-30.316486389330905,286.0823267426895,318.54638318412555,-0.0013584671428904516,3814200.0
3422,BSESN,2017-06-14,31155.910156,31190.359375,31054.939452999995,31147.689452999995,12700.0,52.4199220000046,0.0,52.4199220000046,58.010971958697205,30745.570313,31430.320313,59.92549733479395,-40.074502665206055,270.0575445319919,308.8486154536988,0.0005883664115233778,3826900.0
3423,BSESN,2017-06-15,31075.730469,31229.439452999995,31026.480469,31222.890625,12700.0,-80.17968700000347,80.17968700000347,0.0,50.679719921442775,30869.900391000006,31430.320313,36.72783031435383,-63.272169685646176,248.028836491907,296.68465966134045,-0.006317167139088586,3814200.0
3424,BSESN,2017-06-16,31056.400391000006,31182.730469,31017.179688,31160.470702999995,13300.0,-19.33007799999541,19.33007799999541,0.0,48.95858842370128,31017.179688,31430.320313,9.493305820507562,-90.50669417949244,226.40133722982137,282.62799517503663,-0.008083486543806973,3800900.0
3425,BSESN,2017-06-19,31311.570313,31362.150391000006,31163.349609,31168.980469,7500.0,255.16992199999734,0.0,255.16992199999734,66.35987154296191,31017.179688,31430.320313,71.25676033432926,-28.74323966567074,227.2320784549156,271.5488118310124,0.003879691928513118,3808400.0
3426,BSESN,2017-06-20,31297.529297000005,31392.529297000005,31261.490234,31392.529297000005,8100.0,-14.04101599999558,14.04101599999558,0.0,64.95388650596388,31017.179688,31430.320313,67.85815580348807,-32.14184419651192,224.17332368306597,262.0737142014231,0.0008394284017192444,3800300.0
3427,BSESN,2017-06-21,31283.640625,31336.439452999995,31193.609375,31302.179688,35700.0,-13.88867200000459,13.88867200000459,0.0,63.42028183064863,31017.179688,31430.320313,64.49642588404369,-35.50357411595632,218.11425338964546,253.28182203906758,0.0022516400479561938,3764600.0
3428,BSESN,2017-06-22,31290.740234,31522.869141000006,31255.630859,31351.529297000005,10200.0,7.099608999997145,0.0,7.099608999997145,63.92269839033622,31017.179688,31522.869141000006,54.09654964664592,-45.90345035335408,211.4478366026051,244.9150249517751,0.0009173959265058595,3774800.0
3429,BSESN,2017-06-23,31138.210938,31365.390625,31110.390625,31352.570313,89700.0,-152.52929599999698,152.52929599999698,0.0,47.68646011058096,31017.179688,31522.869141000006,23.933908307159907,-76.0660916928401,191.64761936372815,234.26154383416574,0.001367125360346444,3685100.0
3430,BSESN,2017-06-27,30958.25,31294.960938,30847.080077999995,31194.679688,15300.0,-179.96093800000014,179.96093800000014,0.0,35.433998128621226,30847.080077999995,31522.869141000006,16.450387863113843,-83.54961213688615,159.59475189322984,219.32818544597856,-0.004669579938049395,3669800.0
3431,BSESN,2017-06-28,30834.320313,31000.480469,30798.699219,30988.869141000006,9900.0,-123.92968699999984,123.92968699999984,0.0,29.42629027969859,30798.699219,31522.869141000006,4.918886150590703,-95.08111384940929,122.77723395032444,200.01799514684774,-0.010321953086582236,3659900.0
3432,BSESN,2017-06-29,30857.519531,31097.919922000005,30794.609375,30910.970702999995,12300.0,23.199218000001565,0.0,23.199218000001565,31.919491539167538,30794.609375,31522.869141000006,8.6384225707728,-91.3615774292272,94.38307934604745,178.8910119866877,-0.0070219085668050685,3672200.0
3433,BSESN,2017-06-30,30921.609375,30965.449219,30680.660156,30824.970702999995,9200.0,64.08984399999828,0.0,64.08984399999828,38.810104798349414,30680.660156,31522.869141000006,28.609195970522315,-71.39080402947768,76.17393632166204,158.34759685368257,-0.00434020087012621,3681400.0
3434,BSESN,2017-07-03,31221.619141000006,31258.330077999995,31017.109375,31156.039063,8100.0,300.00976600000286,0.0,300.00976600000286,60.43777949111796,30680.660156,31522.869141000006,64.23096816047405,-35.769031839525944,84.97183766355738,143.67244501565753,-0.0028727774142534024,3689500.0
3435,BSESN,2017-07-04,31209.789063,31353.460938,31166.369141000006,31331.210938,8700.0,-11.830078000002684,11.830078000002684,0.0,59.48122406600331,30680.660156,31522.869141000006,62.826319408121186,-37.173680591878814,89.95273035406353,132.92850208333874,-0.0028034236558224235,3680800.0
3436,BSESN,2017-07-05,31245.560547000005,31284.640625,31177.779297000005,31272.720702999995,6500.0,35.77148400000442,0.0,35.77148400000442,61.601596101739254,30680.660156,31522.869141000006,67.07365998950957,-32.92634001049043,95.68360249216857,125.47952216510471,-0.0012172521240882972,3687300.0
3437,BSESN,2017-07-06,31369.339844,31460.699219,31264.859375,31298.419922000005,10100.0,123.77929699999369,0.0,123.77929699999369,68.23787036344322,30680.660156,31522.869141000006,81.77064128566529,-18.229358714334705,108.95732256056726,122.17508224419723,0.0025119127707498023,3697400.0
3438,BSESN,2017-07-07,31360.630859,31426.289063,31286.619141000006,31373.519531,6200.0,-8.708985000001121,8.708985000001121,0.0,67.29369435157989,30680.660156,31522.869141000006,80.73657668232966,-19.26342331767035,117.42054805505904,121.22417540636961,0.007142989731904192,3691200.0
3439,BSESN,2017-07-10,31715.640625,31768.390625,31471.410156,31510.619141000006,37900.0,355.0097660000029,0.0,355.0097660000029,80.18761370417731,30680.660156,31768.390625,95.15045303010629,-4.849546969893705,151.03302174955388,127.18594467500648,0.02446490434698334,3729100.0
3440,BSESN,2017-07-11,31747.089844,31885.109375,31718.480469,31789.5,9100.0,31.449218999998266,0.0,31.449218999998266,80.95506432187042,30680.660156,31885.109375,88.54085927220797,-11.459140727792022,178.15517648171226,137.37979103634765,0.02960238856360209,3738200.0
3441,BSESN,2017-07-12,31804.820313,31865.689452999995,31731.429688,31813.240234,8300.0,57.7304690000019,0.0,57.7304690000019,82.39914219896247,30680.660156,31885.109375,93.33396039173321,-6.666039608266784,201.9797490669407,150.29978264246628,0.030699187633935532,3746500.0
3442,BSESN,2017-07-13,32037.380859,32091.519531,31892.630859,31896.230469,10500.0,232.56054599999698,0.0,232.56054599999698,86.98588668714733,30680.660156,32091.519531,96.16271664211745,-3.8372833578825634,236.89579964434597,167.61898604284224,0.03608387488725273,3757000.0
3443,BSESN,2017-07-14,32020.75,32109.75,31897.869141000006,32099.929688,7200.0,-16.630858999997145,16.630858999997145,0.0,85.15481035357378,30680.660156,32109.75,93.77225998955457,-6.227740010445425,260.2253342831209,186.140255690898,0.025595432939945706,3749800.0
3444,BSESN,2017-07-17,32074.779297000005,32131.919922000005,32037.210938,32053.980469,10300.0,54.0292970000046,0.0,54.0292970000046,86.24053974527008,30680.660156,32131.919922000005,96.06268799434216,-3.937312005657841,279.84795822765227,204.88179619824885,0.027715350214445156,3760100.0
3445,BSESN,2017-07-18,31710.990234,31911.609375,31626.439452999995,31775.539063,21600.0,-363.7890630000074,363.7890630000074,0.0,54.99319930870829,30680.660156,32131.919922000005,70.99556551752411,-29.004434482475894,263.01244822148146,216.50792660289542,0.014895866127922153,3738500.0
3446,BSESN,2017-07-19,31955.349609,31978.890625,31793.720702999995,31882.800781,11300.0,244.359375,0.0,244.359375,64.8609626792045,30680.660156,32131.919922000005,87.83330750726515,-12.166692492734857,266.3179965275158,226.4699405878195,0.018680972182208322,3749800.0
3447,BSESN,2017-07-20,31904.400391000006,32057.119141000006,31859.5,32033.820313,11200.0,-50.94921799999429,50.94921799999429,0.0,61.61116425581324,31017.109375,32131.919922000005,79.5911931751757,-20.408806824824303,261.80852557038816,233.5376575843333,0.017339240860454685,3738600.0
3448,BSESN,2017-07-21,32028.890625,32062.230469,31808.929688,32035.880859,18000.0,124.49023399999714,0.0,124.49023399999714,66.3627558780541,31166.369141000006,32131.919922000005,89.32947919183498,-10.670520808165012,265.22273621571003,239.87467331060864,0.009876830290259875,3756600.0
3449,BSESN,2017-07-24,32245.869141000006,32320.859375,32058.330077999995,32100.220702999995,11500.0,216.97851600000286,0.0,216.97851600000286,73.06698067010548,31177.779297000005,32320.859375,93.43963424406792,-6.560365755932089,282.1840337387912,248.33654539624519,0.015711024205712354,3768100.0
3450,BSESN,2017-07-25,32228.269531,32374.300781,32196.859375,32350.710938,14100.0,-17.59961000000112,17.59961000000112,0.0,71.72897787950245,31264.859375,32374.300781,86.8374076170004,-13.16259238299961,290.8530696473208,256.83985024646034,0.013313994980406196,3754000.0
3451,BSESN,2017-07-26,32382.460938,32413.630859,32226.080077999995,32255.990234,12400.0,154.19140699999843,0.0,154.19140699999843,76.1449062433197,31286.619141000006,32413.630859,97.2342859881426,-2.765714011857397,306.6306536708398,266.79801093133625,0.010771170106530725,3766400.0
3452,BSESN,2017-07-27,32383.300781,32672.660156,32325.330077999995,32519.439452999995,10900.0,0.8398430000015651,0.0,0.8398430000015651,76.16830115195613,31471.410156,32672.660156,75.91181061394381,-24.088189386056193,315.5646382742161,276.55133639991226,0.011322370056916276,3777300.0
3453,BSESN,2017-07-28,32309.880859,32381.359375,32104.660156,32381.359375,11300.0,-73.41992200000459,73.41992200000459,0.0,69.3116768981083,31626.439452999995,32672.660156,65.3247831972984,-34.6752168027016,313.11116077231054,283.8633012743919,0.007329795158465435,3766000.0
3454,BSESN,2017-07-31,32514.939452999995,32546.5,32324.449219,32412.199219,13100.0,205.0585939999983,0.0,205.0585939999983,76.21245013217995,31626.439452999995,32672.660156,84.92471975102892,-15.07528024897108,323.9786527264041,291.8863715647944,0.02535238455398381,3779100.0
3455,BSESN,2017-08-01,32575.169922000005,32632.019531,32462.25,32579.800781,9000.0,60.23046900000919,0.0,60.23046900000919,77.89692116654622,31626.439452999995,32672.660156,90.68167608226,-9.318323917739999,333.60571485879336,300.2302402235942,0.019396449126171778,3788100.0
3456,BSESN,2017-08-02,32476.740234,32686.480469,32394.890625,32641.580077999995,10500.0,-98.42968800000745,98.42968800000745,0.0,68.72078745587802,31626.439452999995,32686.480469,80.21395098545914,-19.78604901454086,329.4945694541566,306.0831060697067,0.017939213274211774,3777600.0
3457,BSESN,2017-08-03,32237.880859,32502.550781,32194.580077999995,32502.550781,12600.0,-238.859375,238.859375,0.0,51.67597550782819,31626.439452999995,32686.480469,57.68091958434217,-42.31908041565783,303.46435360204123,305.55935557617363,0.006525053784937285,3765000.0
3458,BSESN,2017-08-04,32325.410156,32352.189452999995,32107.990234,32191.119141000006,11300.0,87.52929700000459,0.0,87.52929700000459,56.26281908098399,31626.439452999995,32686.480469,65.9380809279935,-34.06191907200651,286.59442067401324,301.76636859574154,0.0024667040188059985,3776300.0
3459,BSESN,2017-08-07,32273.669922000005,32396.140625,32235.820313,32377.800781,10400.0,-51.74023399999714,51.74023399999714,0.0,52.841831109014436,31793.720702999995,32686.480469,53.760175724586546,-46.239824275413454,265.98377739792704,294.60985035617864,0.0014087132713200834,3765900.0
3460,BSESN,2017-08-08,32014.189452999995,32354.769531,31915.199219,32341.050781,9400.0,-259.4804690000092,259.4804690000092,0.0,39.08860876598549,31808.929688,32686.480469,23.39007262532374,-76.60992737467626,226.10538667851506,280.90895762064594,-0.011372560155483713,3756500.0
3461,BSESN,2017-08-09,31797.839844,31967.279297000005,31731.910156,31926.140625,9300.0,-216.34960899999714,216.34960899999714,0.0,31.261004206880187,31731.910156,32686.480469,6.9067398286035715,-93.09326017139642,175.02627543477502,259.73242118347173,-0.018079100118895464,3747200.0
3462,BSESN,2017-08-10,31531.330077999995,31756.269531,31422.800781,31750.730469,13000.0,-266.50976600000286,266.50976600000286,0.0,24.33460044847041,31422.800781,32686.480469,8.588354947111721,-91.41164505288828,111.75238899099713,230.1364147449768,-0.024096368055258166,3734200.0
3463,BSESN,2017-08-11,31213.589844,31379.199219,31128.019531,31355.919922000005,15200.0,-317.7402339999972,317.7402339999972,0.0,18.650092689249604,31128.019531,32686.480469,5.490693472870137,-94.50930652712987,35.55850044397448,191.22083188477635,-0.04002312877995928,3719000.0
3464,BSESN,2017-08-14,31449.029297000005,31526.400391000006,31298.900391000006,31299.519531,9700.0,235.4394530000063,0.0,235.4394530000063,32.192641403192766,31128.019531,32686.480469,20.5978705126842,-79.4021294873158,-5.761296331544145,151.82440624151226,-0.0345705218943293,3728700.0
3465,BSESN,2017-08-16,31770.890625,31805.990234,31399.349609,31566.240234,12500.0,321.8613279999954,0.0,321.8613279999954,46.295097130379645,31128.019531,32686.480469,41.25038224089256,-58.74961775910743,-12.393153151886509,118.9808943628325,-0.0217340042108366,3741200.0
3466,BSESN,2017-08-17,31795.460938,31937.509766000006,31714.099609,31919.169922000005,8500.0,24.570313000000173,0.0,24.570313000000173,47.26123186513005,31128.019531,32686.480469,42.82695772000157,-57.173042279998434,-15.487794886892516,92.0871565128875,-0.013723604319248794,3749700.0
3467,BSESN,2017-08-18,31524.679688,31729.880859,31349.130859,31729.880859,16400.0,-270.78125,270.78125,0.0,38.46254957148227,31128.019531,32686.480469,25.45204357249019,-74.5479564275098,-39.33665613355333,65.80239398359933,-0.024770929870208458,3733300.0
3468,BSESN,2017-08-21,31258.849609,31641.810547000005,31220.529297000005,31609.929688,23600.0,-265.830079000003,265.830079000003,0.0,31.763994280342345,31128.019531,32686.480469,8.394825613524574,-91.60517438647543,-78.77919867002129,36.8860754528752,-0.031444218009685665,3709700.0
3469,BSESN,2017-08-22,31291.849609,31484.279297000005,31241.5,31393.929688,10800.0,33.0,0.0,33.0,33.42477929909448,31128.019531,32686.480469,10.512299282280722,-89.48770071771928,-106.1512283077609,8.27861470074797,-0.022563115179300763,3720500.0
3470,BSESN,2017-08-23,31568.009766000006,31593.390625,31379.25,31407.470702999995,10000.0,276.1601570000057,0.0,276.1601570000057,46.093575183010316,31128.019531,32502.550781,32.01020238717779,-67.98979761282222,-104.35697999194235,-14.248504237790103,-0.007227851927286144,3730500.0
3471,BSESN,2017-08-24,31596.060547000005,31678.189452999995,31546.050781,31673.439452999995,8900.0,28.05078100000173,0.0,28.05078100000173,47.26959773999848,31128.019531,32396.140625,36.9082273147649,-63.09177268523511,-99.52430741411808,-31.30366487305571,0.002052893704131309,3739400.0
3472,BSESN,2017-08-28,31750.820313,31809.699219,31701.669922000005,31756.869141000006,10100.0,154.7597659999956,0.0,154.7597659999956,53.699726797922715,31128.019531,32396.140625,49.11209071016362,-50.88790928983637,-82.25833693959066,-41.4945992863627,0.017211428473462576,3749500.0
3473,BSESN,2017-08-29,31388.390625,31739.800781,31360.810547000005,31724.839844,6800.0,-362.42968800000017,362.42968800000017,0.0,40.39053189227423,31128.019531,32354.769531,21.22446252292629,-78.77553747707371,-96.70522023231388,-52.53672347555294,-0.0019281571913505324,3742700.0
3474,BSESN,2017-08-30,31646.460938,31727.980469,31533.019531,31534.570313,5400.0,258.07031300000017,0.0,258.07031300000017,50.47525825327629,31128.019531,31967.279297000005,61.77365197320762,-38.22634802679238,-86.33514405160167,-59.29640759076269,-0.00391646833161452,3748100.0
3475,BSESN,2017-08-31,31730.490234,31757.179688,31551.849609,31685.439452999995,17900.0,84.02929599999699,0.0,84.02929599999699,53.434969526190955,31128.019531,31937.509766000006,74.42593831907008,-25.574061680929912,-70.52337250202254,-61.54180057301466,-0.0020433955691565586,3766000.0
3476,BSESN,2017-09-01,31892.230469,31944.099609,31707.269531,31769.339844,6600.0,161.74023500000112,0.0,161.74023500000112,58.89124959296677,31128.019531,31944.099609,93.64411147897148,-6.355888521028518,-44.42919231358246,-58.11927892112823,0.011659144030570667,3772600.0
3477,BSESN,2017-09-04,31702.25,31932.199219,31560.320313,31932.199219,7600.0,-189.9804689999983,189.9804689999983,0.0,50.820490123900825,31220.529297000005,31944.099609,66.57552072147453,-33.42447927852547,-38.63385559256858,-54.2221942554163,0.014184795555378882,3765000.0
3478,BSESN,2017-09-05,31809.550781,31863.470702999995,31674.230469,31755.160156,8000.0,107.30078100000172,0.0,107.30078100000172,54.85264990768373,31220.529297000005,31944.099609,81.40487168025217,-18.595128319747833,-25.0934712944254,-48.39644966321812,0.016544281609071287,3773000.0
3479,BSESN,2017-09-06,31661.970702999995,31727.849609,31586.529297000005,31713.5,7400.0,-147.58007800000632,147.58007800000632,0.0,48.53724218999829,31220.529297000005,31944.099609,61.00877809370282,-38.99122190629718,-25.971712368020235,-43.91150220417855,0.0029764605908475517,3765600.0
3480,BSESN,2017-09-07,31662.740234,31814.960938,31620.439452999995,31738.740234,10200.0,0.7695310000017344,0.0,0.7695310000017344,48.572866166210055,31220.529297000005,31944.099609,61.11513002484802,-38.88486997515198,-26.302431962802075,-40.38968815590326,0.0021103797703136973,3775800.0
3481,BSESN,2017-09-08,31687.519531,31763.699219,31619.0,31694.150391000006,7800.0,24.779297000004593,0.0,24.779297000004593,49.862373670278586,31220.529297000005,31944.099609,64.53971732328338,-35.46028267671662,-24.285103885064018,-37.16877130173541,-0.0019936739075078203,3783600.0
3482,BSESN,2017-09-11,31882.160156,31952.869141000006,31797.890625,31798.310547000005,8700.0,194.640625,0.0,194.640625,59.146712466106614,31241.5,31952.869141000006,90.06015570191789,-9.9398442980821,-6.900935403809854,-31.1152041221503,0.015730960433719243,3792300.0
3483,BSESN,2017-09-12,32158.660156,32172.460938,31950.240234,32029.150391000006,7000.0,276.5,0.0,276.5,68.65941407463947,31360.810547000005,32172.460938,98.29966422082356,-1.7003357791764446,28.8547628125998,-19.12121073520028,0.01618503942679328,3799300.0
3484,BSESN,2017-09-13,32186.410156,32348.300781,32126.769531,32188.949219,8900.0,27.75,0.0,27.75,69.482308832575,31360.810547000005,32348.300781,83.60585052631512,-16.39414947368487,58.75333249425603,-3.546302089309013,0.014368511757548275,3808200.0
3485,BSESN,2017-09-14,32241.929688,32328.609375,32186.839844,32289.259766000006,9100.0,55.519531999998435,0.0,55.519531999998435,71.22637318985011,31360.810547000005,32348.300781,89.22813721720291,-10.771862782797086,85.93749268935426,14.350456866423647,0.010965028593403536,3817300.0
3486,BSESN,2017-09-15,32272.609375,32356.109375,32138.380859,32207.630859,8900.0,30.679686999999827,0.0,30.679686999999827,72.2379871603875,31360.810547000005,32356.109375,91.61055979862961,-8.389440201370395,108.70366168905093,33.22109783094911,0.017991132332878523,3826200.0
3487,BSESN,2017-09-18,32423.759766000006,32508.060547000005,32361.25,32361.369141000006,9500.0,151.15039100000288,0.0,151.15039100000288,76.86229510029011,31533.019531,32508.060547000005,91.35412976309112,-8.64587023690887,137.35919666387053,54.04871759753341,0.01930894872513811,3835700.0
3488,BSESN,2017-09-19,32402.369141000006,32524.109375,32358.630859,32522.439452999995,57400.0,-21.390625,21.390625,0.0,74.82705087654546,31551.849609,32524.109375,87.47863089091423,-12.521369109085773,156.5383927647781,74.54665263098236,0.0233844710724167,3778300.0
3489,BSESN,2017-09-20,32400.509766000006,32499.880859,32383.820313,32467.099609,10500.0,-1.859375,1.859375,0.0,74.62885192029673,31560.320313,32524.109375,87.17565763368317,-12.824342366316824,169.63258893768216,93.56383989232233,0.023300874357292,3767800.0
3490,BSESN,2017-09-21,32370.039063,32462.609375,32164.419922000005,32406.419922000005,8700.0,-30.47070300000269,30.47070300000269,0.0,71.06935593628174,31560.320313,32524.109375,84.01410453027118,-15.985895469728817,175.52772827614535,109.95661756908696,0.021539064657058127,3759100.0
3491,BSESN,2017-09-22,31922.439452999995,32342.810547000005,31886.089844,32339.5,9600.0,-447.5996100000048,447.5996100000048,0.0,39.29914975657663,31586.529297000005,32524.109375,35.827356391417744,-64.17264360858226,142.4401594014198,116.45332593555354,0.001263380423500271,3749500.0
3492,BSESN,2017-09-25,31626.630859,32016.519531,31474.560547000005,31986.400391000006,12200.0,-295.80859399999827,295.80859399999827,0.0,29.308388382616684,31474.560547000005,32524.109375,14.489112649459015,-85.51088735054098,91.29633401635874,111.42192755171459,-0.01654388878203117,3737300.0
3493,BSESN,2017-09-26,31599.759766000006,31693.589844,31455.650391000006,31685.810547000005,10000.0,-26.87109299999429,26.87109299999429,0.0,28.547696206040712,31455.650391000006,32524.109375,13.48759074124654,-86.51240925875345,48.0424083156322,98.74602370449811,-0.01822664867428947,3727300.0
3494,BSESN,2017-09-27,31159.810547000005,31797.460938,31100.800781,31785.240234,9800.0,-439.9492189999983,439.9492189999983,0.0,19.155377038658173,31100.800781,32524.109375,4.145957261043765,-95.85404273895624,-21.48915103753825,74.69898875609084,-0.033562480641558645,3717500.0
3495,BSESN,2017-09-28,31282.480469,31340.910156,31081.830077999995,31216.359375,8300.0,122.66992199999369,0.0,122.66992199999369,26.893590009987292,31081.830077999995,32524.109375,13.912034334637074,-86.08796566536293,-65.93491856452601,46.572207291967466,-0.03068016268827045,3725800.0
3496,BSESN,2017-09-29,31283.720702999995,31523.869141000006,31243.710938,31367.25,7700.0,1.2402339999971446,0.0,1.2402339999971446,26.975130586541113,31081.830077999995,32524.109375,13.998025584915496,-86.0019744150845,-99.90676997097034,17.2764118393799,-0.03516060664240028,3733500.0
3497,BSESN,2017-10-03,31497.380859,31615.279297000005,31440.480469,31537.810547000005,7100.0,213.6601560000017,0.0,213.6601560000017,40.2273506973861,31081.830077999995,32524.109375,28.812088051486747,-71.18791194851325,-108.34023917009108,-7.846918362514304,-0.02792969483379193,3740600.0
3498,BSESN,2017-10-04,31671.710938,31752.160156,31457.779297000005,31522.169922000005,5900.0,174.33007900000302,0.0,174.33007900000302,48.94934610026069,31081.830077999995,32524.109375,40.8992114930152,-59.10078850698479,-99.80633848939397,-26.238802387890242,-0.02249343708674556,3746500.0
3499,BSESN,2017-10-05,31592.029297000005,31772.410156,31562.25,31725.849609,5900.0,-79.68164099999558,79.68164099999558,0.0,45.45153948299692,31081.830077999995,32524.109375,35.37450894991302,-64.62549105008698,-98.33921001888666,-40.65888391408953,-0.024034872632862747,3740600.0
3500,BSESN,2017-10-06,31814.220702999995,31844.279297000005,31632.810547000005,31633.339844,8300.0,222.19140599999082,0.0,222.19140599999082,55.648564327593014,31081.830077999995,32524.109375,50.780083061817514,-49.21991693818249,-78.34440506883766,-48.19598814503916,-0.0033900526355240546,3748900.0
3501,BSESN,2017-10-09,31846.890625,31935.630859,31781.75,31862.199219,5800.0,32.66992200000459,0.0,32.66992200000459,57.011915756436565,31081.830077999995,32524.109375,53.045242248943005,-46.954757751056995,-59.17999823824357,-50.39279016368005,0.006964376540200545,3754700.0
3502,BSESN,2017-10-10,31924.410156,31994.769531,31896.900391000006,31910.820313,7200.0,77.51953100000173,0.0,77.51953100000173,60.34898621471004,31081.830077999995,32499.880859,59.418187930182675,-40.581812069817325,-37.30683943663462,-47.775600018270964,0.010273824624113193,3761900.0
3503,BSESN,2017-10-11,31833.990234,32098.460938,31769.400391000006,31975.589844,8600.0,-90.41992200000459,90.41992200000459,0.0,54.64035847809992,31081.830077999995,32462.609375,54.473597455741896,-45.5264025442581,-26.95758527085127,-43.611997068787026,0.021636193390299763,3753300.0
3504,BSESN,2017-10-12,32182.220702999995,32209.029297000005,31813.669922000005,31887.470702999995,7800.0,348.23046899999827,0.0,348.23046899999827,68.06448887844645,31081.830077999995,32342.810547000005,87.26468427164767,-12.735315728352333,9.23708244617228,-33.042181165795164,0.02876179319896366,3761100.0
3505,BSESN,2017-10-13,32432.689452999995,32508.589844,32247.740234,32247.740234,15500.0,250.46875,0.0,250.46875,74.36160928583037,31081.830077999995,32508.589844,94.68022628555094,-5.319773714449045,57.46987530200204,-14.939769872235717,0.03672736887367156,3776600.0
3506,BSESN,2017-10-16,32633.640625,32687.320313,32445.429688,32488.230469,9200.0,200.9511720000046,0.0,200.9511720000046,78.31918037170378,31081.830077999995,32687.320313,96.65649240152494,-3.3435075984750546,110.63446604314959,10.175077310841353,0.03607473812145012,3785800.0
3507,BSESN,2017-10-17,32609.160156,32699.859375,32556.740234,32654.410156,5500.0,-24.480468999998266,24.480468999998266,0.0,76.65591805132678,31081.830077999995,32699.859375,94.39446373633876,-5.6055362636612385,149.07398586549607,37.9548590217723,0.02959894461764745,3780300.0
3508,BSESN,2017-10-18,32584.349609,32670.320313,32462.849609,32518.560547000005,14100.0,-24.810547000004593,24.810547000004593,0.0,74.79833158493514,31081.830077999995,32699.859375,92.86108315750732,-7.138916842492679,175.51238099849434,65.46636341711671,0.03141046441401674,3766200.0
3509,BSESN,2017-10-19,32389.960938,32663.060547000005,32319.369141000006,32656.75,2500.0,-194.38867099999698,194.38867099999698,0.0,61.35680478366601,31243.710938,32699.859375,78.7179363637912,-21.282063636208804,178.7192936753636,88.1169494687661,0.01809694602846945,3763700.0
3510,BSESN,2017-10-23,32506.720702999995,32614.890625,32312.740234,32411.859375,8400.0,116.75976499999523,0.0,116.75976499999523,65.6365999858146,31440.480469,32699.859375,84.66397435435493,-15.336025645645071,188.5093142777514,108.19542243056316,0.02071882262446123,3772100.0
3511,BSESN,2017-10-24,32607.339844,32670.369141000006,32502.080077999995,32619.259766000006,8400.0,100.61914100000286,0.0,100.61914100000286,69.04546315293675,31457.779297000005,32699.859375,92.55124265828518,-7.448757341714813,202.05790218814218,126.96791838207896,0.021392084760934793,3780500.0
3512,BSESN,2017-10-25,33042.5,33117.328125,32804.601563,32995.28125,29900.0,435.1601560000017,0.0,435.1601560000017,79.295013578127,31562.25,33117.328125,95.18814368249183,-4.811856317508164,245.0838692383004,150.59110855332327,0.0379628741831195,3810400.0
3513,BSESN,2017-10-26,33147.128906,33196.171875,32835.058594,33025.171875,15500.0,104.6289059999981,0.0,104.6289059999981,81.03697521410231,31632.810547000005,33196.171875,96.86297926642828,-3.137020733571711,284.34715935180066,177.34231871301876,0.02998264824248298,3825900.0
3514,BSESN,2017-10-27,33157.21875,33286.511719,33109.410156,33228.320313,18300.0,10.089844000001904,0.0,10.089844000001904,81.21285065445909,31769.400391000006,33286.511719,91.47768745682964,-8.52231254317035,312.6734607073704,204.4085471118891,0.02233947628826649,3844200.0
3515,BSESN,2017-10-30,33266.160156,33340.171875,33206.929688,33260.101563,14000.0,108.9414059999981,0.0,108.9414059999981,83.15878199994553,31769.400391000006,33340.171875,95.28819311058983,-4.71180688941016,339.99368406336,231.5255745021833,0.019382438455715523,3858200.0
3516,BSESN,2017-10-31,33213.128906,33294.300781,33164.28125,33254.929688,11500.0,-53.03125,53.03125,0.0,78.5868147843628,31769.400391000006,33340.171875,91.91206548539543,-8.087934514604573,353.2934324583548,255.8791460934176,0.018521444499356887,3846700.0
3517,BSESN,2017-11-01,33600.269531,33651.519531,33340.621094,33344.230469,14200.0,387.140625,0.0,387.140625,85.36456343333053,31813.669922000005,33651.519531,97.2114149194239,-2.7885850805760994,390.5703400902348,282.81738489278104,0.03117815559281234,3860900.0
3518,BSESN,2017-11-02,33573.21875,33657.570313,33527.0,33615.839844,12400.0,-27.050780999998093,27.050780999998093,0.0,83.24035524359836,32247.740234,33657.570313,94.01689861377992,-5.983101386220089,413.1670533962424,308.8873185934733,0.03653162207465943,3848500.0
3519,BSESN,2017-11-03,33685.558594,33733.710938,33531.941406,33667.339844,199700.0,112.3398440000019,0.0,112.3398440000019,85.02586825699716,32312.740234,33733.710938,96.61130635104249,-3.388693648957507,435.124157605831,334.13468639594487,0.036264435953738516,4048200.0
3520,BSESN,2017-11-06,33731.191406,33848.421875,33582.378906,33710.148438,13100.0,45.632811999996186,0.0,45.632811999996186,85.73801502494578,32312.740234,33848.421875,92.36622579380031,-7.633774206199679,451.0085614896234,357.50946141468063,0.03446621427496788,4061300.0
3521,BSESN,2017-11-07,33370.761719,33865.949219,33341.820313,33781.011719,16300.0,-360.4296869999962,360.4296869999962,0.0,59.8131808914983,32312.740234,33865.949219,68.11842419260795,-31.881575807392053,429.5616828175116,371.9199056952469,0.00993453034727998,4045000.0
3522,BSESN,2017-11-08,33218.808594,33484.699219,33157.679688,33417.351563,283000.0,-151.953125,151.953125,0.0,52.14346253117244,32312.740234,33865.949219,58.33525100294218,-41.66474899705783,395.7416661049647,376.6842577771905,0.002162470487361956,3762000.0
3523,BSESN,2017-11-09,33250.929688,33463.800781,33111.539063,33376.621094,14100.0,32.12109399999463,0.0,32.12109399999463,53.594830324271825,32312.740234,33865.949219,60.4032981434237,-39.5967018565763,367.29699195006833,374.8068046117661,0.0028262605107671757,3776100.0
3524,BSESN,2017-11-10,33314.558594,33380.421875,33108.089844,33235.75,21200.0,63.62890600000537,0.0,63.62890600000537,56.6030364182356,32502.080077999995,33865.949219,59.57158876725423,-40.42841123274578,345.901368040104,369.02571729743374,0.00145488501747848,3797300.0
3525,BSESN,2017-11-13,33033.558594,33417.300781,32999.980469,33397.410156,18200.0,-281.0,281.0,0.0,42.548287847922545,32804.601563,33865.949219,21.57229346158788,-78.42770653841212,302.7805644862601,355.77668673519906,-0.005406606300424666,3779100.0
3526,BSESN,2017-11-14,32941.871094,33126.550781,32907.109375,32990.03125,12000.0,-91.6875,91.6875,0.0,38.91077182422504,32835.058594,33865.949219,10.3611864740743,-89.6388135259257,258.23186581032496,336.2677225502243,-0.019595034390797128,3767100.0
3527,BSESN,2017-11-15,32760.439452999995,32944.941406,32683.589844,32944.941406,11300.0,-181.4316410000065,181.4316410000065,0.0,32.55594234675438,32683.589844,33865.949219,6.499682805830241,-93.50031719416975,205.91304658775334,310.1967873577301,-0.02420915620430364,3755800.0
3528,BSESN,2017-11-16,33106.820313,33165.148438,32829.820313,32829.820313,9600.0,346.3808600000011,0.0,346.3808600000011,50.400328727302686,32683.589844,33865.949219,35.79541702369442,-64.20458297630557,190.20745287676255,286.1989204615366,-0.01718060513632358,3765400.0
3529,BSESN,2017-11-17,33342.800781,33520.820313,33278.910156,33388.46875,11300.0,235.9804680000016,0.0,235.9804680000016,58.94009437755759,32683.589844,33865.949219,55.75385546378383,-44.24614453621618,194.5595469564505,267.8710457605194,-0.011514287186752403,3776700.0
3530,BSESN,2017-11-20,33359.898438,33449.53125,33288.210938,33365.839844,7900.0,17.097656999998435,0.0,17.097656999998435,59.52271648848814,32683.589844,33865.949219,57.199918087510085,-42.800081912489915,197.1160201190869,253.7200406322329,-0.00032553290486680986,3784600.0
3531,BSESN,2017-11-21,33478.351563,33625.050781,33437.609375,33438.28125,14800.0,118.453125,0.0,118.453125,63.64630570706048,32683.589844,33865.949219,67.2182870795942,-32.781712920405795,206.32187065826292,244.2404066374389,0.007813132980539095,3799400.0
3532,BSESN,2017-11-22,33561.550781,33654.53125,33465.230469,33569.070313,13100.0,83.19921800000157,0.0,83.19921800000157,66.41886024252699,32683.589844,33865.949219,74.2549985701257,-25.745001429874304,217.82015988800413,238.95635728755195,0.009341726559666697,3812500.0
3533,BSESN,2017-11-23,33588.078125,33670.191406,33468.300781,33575.910156,7100.0,26.527344000001907,0.0,26.527344000001907,67.33535897367558,32683.589844,33865.949219,76.49859257046944,-23.501407429530556,226.46265142824996,236.4576161156916,0.008210210266728746,3819600.0
3534,BSESN,2017-11-24,33679.238281,33738.53125,33639.980469,33670.0,7800.0,91.1601559999981,0.0,91.1601559999981,70.52505061986272,32683.589844,33865.949219,84.20861356133761,-15.791386438662377,237.92509853895172,236.75111260034365,0.019546174087259116,3827400.0
3535,BSESN,2017-11-27,33724.441406,33745.171875,33540.460938,33640.511719,8900.0,45.203125,0.0,45.203125,72.0846912943819,32683.589844,33745.171875,98.04720988160717,-1.9527901183928262,247.80019842866022,238.96092976600698,0.023756097817483557,3836300.0
3536,BSESN,2017-11-28,33618.589844,33770.148438,33576.648438,33726.648438,8100.0,-105.8515619999962,105.8515619999962,0.0,63.067817241797435,32683.589844,33770.148438,86.05150289759754,-13.948497102402458,244.26916691855877,240.02257719651735,0.026194715496144605,3828200.0
3537,BSESN,2017-11-29,33602.761719,33728.808594,33553.121094,33664.269531,6600.0,-15.828125,15.828125,0.0,61.735438770255826,32683.589844,33770.148438,84.59478210155366,-15.405217898446338,237.45635257966205,239.5093322731463,0.014980037385386336,3821600.0
3538,BSESN,2017-11-30,33149.351563,33576.199219,33108.71875,33542.5,7400.0,-453.4101560000053,453.4101560000053,0.0,36.35174744813978,32683.589844,33770.148438,42.86577102900343,-57.13422897099657,193.24315109386225,230.25609603728952,-0.005801828684716792,3814200.0
3539,BSESN,2017-12-01,32832.941406,33300.808594,32797.78125,33247.660156,9200.0,-316.41015699999843,316.41015699999843,0.0,27.31005246165219,32683.589844,33770.148438,13.745375797009258,-86.25462420299075,131.16028098284005,210.43693302639966,-0.01579612219082016,3805000.0
3540,BSESN,2017-12-04,32869.71875,33008.46875,32785.761719,32968.019531,9600.0,36.77734400000191,0.0,36.77734400000191,29.656581235984348,32683.589844,33770.148438,17.130130581802938,-82.86986941819706,83.95895684477,185.14133779007375,-0.018179891917756597,3814600.0
3541,BSESN,2017-12-05,32802.441406,32893.050781,32682.519531,32814.03125,8600.0,-67.2773440000019,67.2773440000019,0.0,27.764752908292152,32682.519531,33770.148438,11.02599188272558,-88.97400811727442,40.65421155317745,156.2439125426945,-0.022618423682309374,3806000.0
3542,BSESN,2017-12-06,32597.179688,32804.75,32565.160156,32798.5,9600.0,-205.26171799999798,205.26171799999798,0.0,22.673102100439337,32565.160156,33770.148438,2.6572484129765646,-97.34275158702343,-10.111457692975819,122.97283849556042,-0.02950149256269774,3796400.0
3543,BSESN,2017-12-07,32949.210938,32992.449219,32598.119141000006,32615.050781,9500.0,352.03124999999636,0.0,352.03124999999636,43.262935265716806,32565.160156,33770.148438,31.87174412705172,-68.12825587294827,-21.687634934918606,94.04074380946462,-0.021675886399480815,3805900.0
3544,BSESN,2017-12-08,33250.300781,33285.679688,33034.199219,33034.199219,14200.0,301.0898430000016,0.0,301.0898430000016,55.06955883170601,32565.160156,33770.148438,56.85869607485522,-43.14130392514478,-6.49157395997463,73.93428025557677,-0.014059258070191372,3820100.0
3545,BSESN,2017-12-11,33455.789063,33535.96875,33313.171875,33317.71875,12000.0,205.48828199999843,0.0,205.48828199999843,61.39563139485785,32565.160156,33770.148438,73.91183136833182,-26.088168631668186,21.880377492881962,63.52349970303781,-0.004842582087929537,3832100.0
3546,BSESN,2017-12-12,33227.988281,33458.410156,33179.75,33426.589844,8200.0,-227.80078199999843,227.80078199999843,0.0,52.02586337658734,32565.160156,33770.148438,55.007018317212086,-44.992981682787914,25.687623201032693,55.95632440263679,-0.01115305465467431,3823900.0
3547,BSESN,2017-12-13,33053.039063,33404.261719,32988.820313,33229.730469,24500.0,-174.94921800000157,174.94921800000157,0.0,45.8281888630788,32565.160156,33770.148438,40.488269827008736,-59.511730172991264,14.421708594010852,47.6494012409116,-0.0029054112813325927,3799400.0
3548,BSESN,2017-12-14,33246.699219,33321.519531,32886.929688,33114.691406,11200.0,193.66015600000537,0.0,193.66015600000537,52.982176255337734,32565.160156,33770.148438,56.559808355049476,-43.440191644950524,20.87946077833476,42.295413148396236,0.012601911229445761,3810600.0
3549,BSESN,2017-12-15,33462.96875,33621.960938,33405.820313,33456.019531,24200.0,216.2695309999981,0.0,216.2695309999981,59.819593846401936,32565.160156,33770.148438,74.50766180977702,-25.492338190222984,42.95328093666467,42.426986706049924,0.018048526807063148,3834800.0
3550,BSESN,2017-12-18,33601.679688,33801.898438,32595.630859,33364.519531,21100.0,138.7109379999965,0.0,138.7109379999965,63.72365313240067,32565.160156,33801.898438,83.8107421016987,-16.189257898301303,70.82334841186821,48.106259047213584,0.02436520721453994,3855900.0
3551,BSESN,2017-12-19,33836.738281,33862.070313,33666.621094,33732.078125,20600.0,235.0585930000016,0.0,235.0585930000016,69.51524692295965,32565.160156,33862.070313,98.04673964011536,-1.9532603598846312,110.60288050882082,60.60558333953504,0.038026559501904256,3876500.0
3552,BSESN,2017-12-20,33777.378906,33956.308594,33754.941406,33928.589844,7100.0,-59.359375,59.359375,0.0,66.42517662299221,32565.160156,33956.308594,87.13798735545114,-12.862012644548848,135.77352810035518,75.63917229169907,0.02513468287778875,3869400.0
3553,BSESN,2017-12-21,33756.28125,33860.988281,33707.800781,33826.25,9900.0,-21.097655999998093,21.097655999998093,0.0,65.23594071607783,32565.160156,33956.308594,85.6214233840083,-14.378576615991706,152.26384037177195,90.96410590771366,0.015217320057722139,3859500.0
3554,BSESN,2017-12-22,33940.300781,33964.28125,33767.730469,33768.46875,7800.0,184.0195309999981,0.0,184.0195309999981,70.5434917600513,32565.160156,33964.28125,98.286033346017,-1.713966653982985,178.12802094486688,108.39688891514433,0.014482148876764578,3867300.0
3555,BSESN,2017-12-26,34010.609375,34061.878906,33889.75,33980.761719,12900.0,70.3085940000019,0.0,70.3085940000019,72.401074921595,32565.160156,34061.878906,96.57453806869205,-3.4254619313079506,201.97069389592798,127.11164991130109,0.023553068797953935,3880200.0
3556,BSESN,2017-12-27,33911.808594,34137.96875,33839.511719,34087.320313,10900.0,-98.8007809999981,98.8007809999981,0.0,65.68475385274246,32595.630859,34137.96875,85.33653635045148,-14.663463649548516,210.46764665363298,143.7828492597675,0.025981560405479387,3869300.0
3557,BSESN,2017-12-28,33848.03125,34023.648438,33752.03125,33928.859375,9500.0,-63.7773440000019,63.7773440000019,0.0,61.439642622275855,32595.630859,34137.96875,81.20142793016552,-18.798572069834478,209.63866029966448,156.9540114677469,0.01808696938721499,3859800.0
3558,BSESN,2017-12-29,34056.828125,34086.050781,33889.390625,33889.390625,12100.0,208.796875,0.0,208.796875,69.00629054825875,32595.630859,34137.96875,94.73911485456723,-5.260885145432768,223.25628597333707,170.21446636886495,0.01774676297959976,3871900.0
3559,BSESN,2018-01-01,33812.75,34101.128906,33766.148438,34059.988281,7500.0,-244.078125,244.078125,0.0,54.564384696508455,32595.630859,34137.96875,78.91391037607595,-21.08608962392406,211.91051507979864,178.55367611105171,0.00628154050511287,3864400.0
3560,BSESN,2018-01-02,33812.261719,33964.140625,33703.371094,33913.550781,10600.0,-0.4882809999980964,0.4882809999980964,0.0,54.53803811871713,32595.630859,34137.96875,78.88225187874878,-21.117748121251225,200.56749250417488,182.95643938967638,-0.000723372382903098,3853800.0
3561,BSESN,2018-01-03,33793.378906,33998.371094,33765.429688,33929.609375,9000.0,-18.882813000003807,18.882813000003807,0.0,53.387763722273256,32595.630859,34137.96875,77.6579538108487,-22.3420461891513,187.8885183095481,183.94285517365074,0.00047368980418904805,3844800.0
3562,BSESN,2018-01-04,33969.640625,33995.398438,33802.128906,33912.488281,10500.0,176.2617190000019,0.0,176.2617190000019,62.01632097458785,32595.630859,34137.96875,89.08617067749908,-10.913829322500908,189.87443328174413,185.12917079526943,0.006320582928547536,3855300.0
3563,BSESN,2018-01-05,34153.851563,34188.851563,34020.839844,34021.269531,14700.0,184.21093799999653,0.0,184.21093799999653,68.94793082578978,32595.630859,34188.851563,97.80319199266442,-2.196808007335567,203.9614280060341,188.8956222374224,0.006291953137891548,3870000.0
3564,BSESN,2018-01-08,34352.789063,34385.671875,34216.328125,34216.328125,13500.0,198.9375,0.0,198.9375,74.70089197419654,33666.621094,34385.671875,95.42691380513172,-4.5730861948682815,228.54355859622592,196.82520950918314,0.010060969041369772,3883500.0
3565,BSESN,2018-01-09,34443.191406,34488.03125,34343.410156,34431.609375,11200.0,90.40234300000157,0.0,90.40234300000157,76.94092168024808,33703.371094,34488.03125,94.28544400309757,-5.714555996902437,252.41016053900967,207.94219971514846,0.015669550933181897,3894700.0
3566,BSESN,2018-01-10,34433.070313,34565.628906,34311.628906,34538.78125,8500.0,-10.121093000001563,10.121093000001563,0.0,76.07083526313284,33703.371094,34565.628906,84.62657094488554,-15.373429055114451,267.42521549089724,219.83880287029822,0.017284286305425667,3886200.0
3567,BSESN,2018-01-11,34503.488281,34558.878906,34400.609375,34471.480469,8100.0,70.41796800000157,0.0,70.41796800000157,78.06241542952546,33703.371094,34565.628906,92.79326622093855,-7.206733779061462,281.7589543906215,232.2228331743629,0.0131151425599767,3894300.0
3568,BSESN,2018-01-12,34592.390625,34638.421875,34342.160156,34578.988281,7800.0,88.9023440000019,0.0,88.9023440000019,80.43454221043598,33703.371094,34638.421875,95.07713902438844,-4.922860975611558,296.8700883275451,245.15228420499935,0.02305759291983045,3902100.0
3569,BSESN,2018-01-15,34843.511719,34963.691406,34687.210938,34687.210938,14600.0,251.1210940000019,0.0,251.1210940000019,85.5330575662348,33703.371094,34963.691406,90.46435371581978,-9.53564628418022,325.3586128612951,261.19354993625853,0.03049929071797397,3916700.0
3570,BSESN,2018-01-16,34771.050781,34936.03125,34735.550781,34877.710938,53600.0,-72.46093800000382,72.46093800000382,0.0,78.70460169916704,33703.371094,34963.691406,84.71494721097532,-15.285052789024684,338.19053175398585,276.592946299804,0.028930870680895948,3863100.0
3571,BSESN,2018-01-17,35081.820313,35118.609375,34700.820313,34753.800781,35000.0,310.76953199999843,0.0,310.76953199999843,84.73521608667244,33703.371094,35118.609375,97.40050403568729,-2.5994959643127062,369.1807382054758,295.1105046809384,0.03274040194530303,3898100.0
3572,BSESN,2018-01-18,35260.289063,35507.359375,35166.441406,35366.449219,15700.0,178.46875,0.0,178.46875,87.14706340823575,33703.371094,35507.359375,86.30421746071177,-13.69578253928822,403.49044994718133,316.786493734187,0.03239568743686405,3913800.0
3573,BSESN,2018-01-19,35511.578125,35542.171875,35221.160156,35339.109375,35200.0,251.28906200000347,0.0,251.28906200000347,89.77243465338739,33703.371094,35542.171875,98.3362118226118,-1.663788177388208,445.8189475687759,342.5929845011048,0.03373202274420528,3949000.0
3574,BSESN,2018-01-22,35798.011719,35827.699219,35544.679688,35613.96875,13700.0,286.43359400000185,0.0,286.43359400000185,91.93822850818749,33765.429688,35827.699219,98.56044520108851,-1.4395547989114874,496.75114610912715,373.4246168227093,0.039334923904989605,3962700.0
3575,BSESN,2018-01-23,36139.980469,36170.828125,35863.980469,35868.191406,27000.0,341.96875,0.0,341.96875,93.75885060007091,33802.128906,36170.828125,98.69769636631952,-1.3023036336804767,558.2738669471946,410.3944668476064,0.049571825587553686,3989700.0
3576,BSESN,2018-01-24,36161.640625,36268.191406,36036.511719,36161.621094,25200.0,21.660155999998093,0.0,21.660155999998093,93.8601874735011,34020.839844,36268.191406,95.25882897889039,-4.741171021109615,601.8412091998398,448.6838153180531,0.04805752770548399,4014900.0
3577,BSESN,2018-01-25,36050.441406,36247.019531,35823.351563,36208.390625,15100.0,-111.1992190000019,111.1992190000019,0.0,85.62468724161101,34216.328125,36268.191406,89.38769449132707,-10.612305508672934,620.2459845578996,482.99624916602244,0.042149465667350006,3999800.0
3578,BSESN,2018-01-29,36283.25,36443.980469,36093.359375,36106.359375,16900.0,232.8085940000019,0.0,232.8085940000019,88.13878863722974,34311.628906,36443.980469,92.46229037514479,-7.537709624855216,646.1689757750937,515.6307944878367,0.04132012561222176,4016700.0
3579,BSESN,2018-01-30,36033.730469,36291.820313,35993.410156,36277.121094,18100.0,-249.5195309999981,249.5195309999981,0.0,72.4657939657568,34311.628906,36443.980469,80.76067722046642,-19.239322779533577,639.210570685711,540.3467497274116,0.03631410784657607,3998600.0
3580,BSESN,2018-01-31,35965.019531,36050.691406,35818.410156,35951.640625,11000.0,-68.71093800000382,68.71093800000382,0.0,68.5903862829551,34342.160156,36443.980469,77.21208920488709,-22.787910795112907,620.9931634312306,556.4760324681755,0.02517541023014469,3987600.0
3581,BSESN,2018-02-01,35906.660156,36256.828125,35501.738281,36048.988281,25200.0,-58.359375,58.359375,0.0,65.17456497261617,34342.160156,36443.980469,74.43547815783228,-25.564521842167714,594.9879721243706,564.1784203994146,0.0183314178691254,3962400.0
3582,BSESN,2018-02-02,35066.75,35738.128906,35006.410156,35707.601563,18000.0,-839.9101559999982,839.9101559999982,0.0,35.673127107812846,34687.210938,36443.980469,21.604374125498328,-78.39562587450168,500.83166481416265,551.5090692823642,-0.012526284341242588,3944400.0
3583,BSESN,2018-02-05,34757.160156,34874.171875,34520.800781,34718.851563,23500.0,-309.58984400000185,309.58984400000185,0.0,29.914170719265087,34520.800781,36443.980469,12.290030748286457,-87.70996925171355,396.65836908321216,520.5389292425338,-0.029075680827479244,3920900.0
3584,BSESN,2018-02-06,34195.941406,34521.011719,33482.808594,33753.78125,22900.0,-561.21875,561.21875,0.0,22.362847182854452,33482.808594,36443.980469,24.0827902635674,-75.9172097364326,265.75120440416504,469.58138427486,-0.0537919234535158,3898000.0
3585,BSESN,2018-02-07,34082.710938,34666.328125,34008.421875,34563.300781,13100.0,-113.23046800000157,113.23046800000157,0.0,21.121617046821314,33482.808594,36443.980469,20.25895048729634,-79.74104951270367,151.12747731483978,405.89060288285594,-0.057489916139555786,3884900.0
3586,BSESN,2018-02-08,34413.160156,34634.351563,34108.761719,34208.109375,35700.0,330.4492180000016,0.0,330.4492180000016,33.54264648000235,33482.808594,36443.980469,31.418357369073558,-68.58164263092644,85.96093385380664,341.9046690770461,-0.045416399526456375,3920600.0
3587,BSESN,2018-02-09,34005.761719,34070.730469,33849.648438,34002.449219,15200.0,-407.3984369999962,407.3984369999962,0.0,27.403959993911755,33482.808594,36443.980469,17.660343508429413,-82.3396564915706,1.4258927620685427,273.8089138140506,-0.06276968796896631,3905400.0
3588,BSESN,2018-02-12,34300.46875,34351.339844,34115.121094,34203.339844,15500.0,294.70703099999815,0.0,294.70703099999815,37.02391100316347,33482.808594,36443.980469,27.61272193968809,-72.38727806031191,-41.31212149228668,210.7847067527831,-0.048101090185240114,3920900.0
3589,BSESN,2018-02-14,34155.949219,34473.429688,34028.679688,34436.980469,21100.0,-144.5195309999981,144.5195309999981,0.0,34.44149681246574,33482.808594,36443.980469,22.73223755375564,-77.26776244624436,-85.85415084264241,151.456935233698,-0.050300829405658165,3899800.0
3590,BSESN,2018-02-15,34297.46875,34535.078125,34186.011719,34207.570313,13000.0,141.5195309999981,0.0,141.5195309999981,39.23072372486775,33482.808594,36443.980469,27.51141069783388,-72.48858930216612,-108.48404998788465,99.46873818938147,-0.044815958905916276,3912800.0
3591,BSESN,2018-02-16,34010.761719,34508.238281,33957.328125,34411.238281,18000.0,-286.70703099999815,286.70703099999815,0.0,33.50854042422979,33482.808594,36443.980469,17.829195578186425,-82.17080442181359,-147.84895862888516,50.00519882572814,-0.03011366268616278,3894800.0
3592,BSESN,2018-02-19,33774.660156,34122.960938,33554.371094,34053.949219,18000.0,-236.1015630000038,236.1015630000038,0.0,29.429757812470726,33482.808594,36291.820313,10.389830701877422,-89.61016929812257,-195.83983556836756,0.8361919469089858,-0.028267556831175544,3876800.0
3593,BSESN,2018-02-20,33703.589844,33960.949219,33657.890625,33913.941406,19200.0,-71.07031199999618,71.07031199999618,0.0,28.236001948591607,33482.808594,36256.828125,7.958893134411754,-92.04110686558823,-236.87715907857637,-46.706478258188106,-0.014397953141702668,3857600.0
3594,BSESN,2018-02-21,33844.859375,33911.359375,33702.5,33813.828125,17700.0,141.2695309999981,0.0,141.2695309999981,34.34416146439685,33482.808594,36256.828125,13.051486370374743,-86.94851362962525,-255.06008916687279,-88.37720043992506,-0.006978657402947563,3875300.0
3595,BSESN,2018-02-22,33819.5,33868.738281,33691.421875,33817.089844,11800.0,-25.359375,25.359375,0.0,33.74917800381627,33482.808594,35738.128906,14.928762189944692,-85.07123781005531,-268.42227696634654,-124.3862157452094,-0.017250963099838756,3863500.0
3596,BSESN,2018-02-23,34142.148438,34167.601563,33832.0,33832.0,21600.0,322.6484379999965,0.0,322.6484379999965,47.18213800149944,33482.808594,34874.171875,47.388044014365185,-52.611955985634815,-250.09394725976017,-149.52776204811957,0.004010694426638706,3885100.0
3597,BSESN,2018-02-26,34445.75,34483.390625,34225.71875,34225.71875,8400.0,303.6015620000035,0.0,303.6015620000035,56.711706881311784,33482.808594,34666.328125,81.36252767931717,-18.63747232068284,-208.66514328726043,-161.35523829594774,0.004235547072516388,3893500.0
3598,BSESN,2018-02-27,34346.390625,34610.789063,34314.871094,34558.558594,12700.0,-99.359375,99.359375,0.0,53.09433328929402,33554.371094,34666.328125,71.22753028394668,-28.772469716053312,-181.7548322741859,-165.43515709159539,0.00557564378547748,3880800.0
3599,BSESN,2018-02-28,34184.039063,34302.738281,34076.449219,34155.628906,12000.0,-162.35156200000347,162.35156200000347,0.0,47.394711287614236,33554.371094,34634.351563,58.303644100437694,-41.69635589956231,-171.55109688475204,-166.65834505022673,-0.003307232024229334,3868800.0
3600,BSESN,2018-03-01,34046.941406,34278.628906,34015.789063,34141.21875,11300.0,-137.09765699999843,137.09765699999843,0.0,42.90678865200603,33554.371094,34610.789063,46.62646097039255,-53.37353902960744,-172.53828428180714,-167.83433289654283,0.0010637717349266662,3857500.0
3601,BSESN,2018-03-05,33746.78125,34034.28125,33653.410156,34034.28125,16900.0,-300.16015599999815,300.16015599999815,0.0,34.624199217290794,33554.371094,34610.789063,18.213449756267735,-81.78655024373226,-195.28987335606507,-173.3254409884473,-0.0008254385350209281,3840600.0
3602,BSESN,2018-03-06,33317.199219,34060.128906,33209.761719,34047.429688,11800.0,-429.5820309999981,429.5820309999981,0.0,26.254865399512198,33209.761719,34610.789063,7.668479880860941,-92.33152011913906,-245.15831885463558,-187.69201656168497,-0.011464375954859496,3828800.0
3603,BSESN,2018-03-07,33033.089844,33331.210938,32991.140625,33279.390625,10700.0,-284.109375,284.109375,0.0,22.16613487491483,32991.140625,34610.789063,2.5900200324832463,-97.40997996751676,-304.09920699334907,-210.97345464801782,-0.023985017104240725,3818100.0
3604,BSESN,2018-03-08,33351.570313,33439.96875,33037.480469,33244.519531,15500.0,318.4804689999946,0.0,318.4804689999946,35.21563922414498,32991.140625,34610.789063,22.25357550093209,-77.74642449906791,-321.40659809924546,-233.06008333826338,-0.013836091219562752,3833600.0
3605,BSESN,2018-03-09,33307.140625,33519.488281,33256.421875,33465.050781,8200.0,-44.42968799999653,44.42968799999653,0.0,34.29022925477557,32991.140625,34610.789063,19.510406862751577,-80.48959313724843,-334.84801526655065,-253.41766972392088,-0.02445680342923695,3825400.0
3606,BSESN,2018-03-12,33917.941406,33962.480469,33468.160156,33468.160156,12200.0,610.8007809999981,0.0,610.8007809999981,53.6224148621093,32991.140625,34610.789063,57.22234277856292,-42.77765722143708,-292.8382596880401,-261.30178771674474,-0.015322894522546426,3837600.0
3607,BSESN,2018-03-13,33856.78125,34077.320313,33722.960938,33818.21875,14300.0,-61.1601559999981,61.1601559999981,0.0,51.859637799079074,32991.140625,34610.789063,53.44620503378658,-46.55379496621342,-261.46631822125346,-261.3346938176465,-0.014255045904113861,3823300.0
3608,BSESN,2018-03-14,33835.738281,33875.148438,33580.691406,33733.550781,9300.0,-21.042969000001907,21.042969000001907,0.0,51.19154681237659,32991.140625,34610.789063,52.14697437938689,-47.85302562061312,-235.58613006099768,-256.1849810663167,-0.01018898853228234,3814000.0
3609,BSESN,2018-03-15,33685.539063,33866.28125,33637.28125,33843.46875,17300.0,-150.19921800000157,150.19921800000157,0.0,46.281127010350076,32991.140625,34610.789063,42.87340522227565,-57.12659477772435,-224.60659114271402,-249.86930308159617,-0.010614825534264072,3796700.0
3610,BSESN,2018-03-16,33176.0,33691.320313,33119.921875,33685.859375,12700.0,-509.5390629999965,509.5390629999965,0.0,33.64743993078916,32991.140625,34610.789063,11.413549426088503,-88.5864505739115,-254.09175979485735,-250.71379442424842,-0.016913650098111188,3784000.0
3611,BSESN,2018-03-19,32923.121094,33275.789063,32856.539063,33268.96875,9800.0,-252.8789059999981,252.8789059999981,0.0,29.098775214928835,32856.539063,34610.789063,3.79546991591879,-96.20453008408121,-294.4697190773586,-259.4649793548705,-0.01182806881243692,3774200.0
3612,BSESN,2018-03-20,32996.761719,33102.738281,32810.859375,32876.480469,14600.0,73.640625,0.0,73.640625,32.179450824405976,32810.859375,34302.738281,12.460953985765528,-87.53904601423447,-316.8746262750283,-270.94690873890204,-0.0010997495290800963,3788800.0
3613,BSESN,2018-03-21,33136.179688,33354.929688,33070.53125,33090.820313,10100.0,139.41796899999463,0.0,139.41796899999463,38.058698447247295,32810.859375,34278.628906,22.16426394805691,-77.83573605194309,-319.69556029856176,-280.696639050834,-0.006458185416116535,3798900.0
3614,BSESN,2018-03-22,33006.269531,33281.769531,32963.308594,33206.988281,12900.0,-129.91015699999843,129.91015699999843,0.0,34.81391596028902,32810.859375,34077.320313,15.429623617810991,-84.57037638218901,-328.62564295177435,-290.2824398310221,-0.009033230963518157,3786000.0
3615,BSESN,2018-03-23,32596.539063,32720.029297000005,32483.839844,32650.890625,11400.0,-409.73046799999787,409.73046799999787,0.0,26.57010554289404,32483.839844,34077.320313,7.07251963186767,-92.92748036813234,-364.56217646124423,-305.1383871570665,-0.038958801396073106,3774600.0
3616,BSESN,2018-03-26,33066.410156,33115.410156,32515.169922000005,32536.439452999995,16400.0,469.87109299999787,0.0,469.87109299999787,44.08881747575427,32483.839844,34077.320313,36.559614211374466,-63.440385788625534,-351.0804311770844,-314.3267959610701,-0.023344543244198768,3791000.0
3617,BSESN,2018-03-27,33174.390625,33371.039063,33077.128906,33172.980469,15100.0,107.9804690000019,0.0,107.9804690000019,47.415428305058406,32483.839844,34077.320313,43.336005331358876,-56.66399466864112,-327.903067046449,-317.0420501781459,-0.019545831998924346,3806100.0
3618,BSESN,2018-03-28,32968.679688,33104.109375,32917.660156,33098.089844,12300.0,-205.71093700000347,205.71093700000347,0.0,41.93136567177915,32483.839844,34077.320313,30.42646919320345,-69.57353080679655,-322.4173657127976,-318.1171132850763,-0.021280923355844195,3793800.0
3619,BSESN,2018-04-02,33255.359375,33289.339844,32997.878906,33030.871094,7600.0,286.6796870000035,0.0,286.6796870000035,51.03749480910594,32483.839844,34077.320313,48.41725681671989,-51.58274318328011,-291.5761447281693,-312.80891957369494,0.0023920718290331155,3801400.0
3620,BSESN,2018-04-03,33370.628906,33402.941406,33153.828125,33197.421875,11100.0,115.2695309999981,0.0,115.2695309999981,54.358129767752544,32483.839844,34077.320313,55.65107820596707,-44.34892179403293,-254.89469966354227,-301.2260755916644,0.013592508763743849,3812500.0
3621,BSESN,2018-04-04,33019.070313,33505.53125,32972.558594,33437.519531,9700.0,-351.5585930000016,351.5585930000016,0.0,43.88445054671036,32483.839844,33875.148438,38.46957255264385,-61.53042744735616,-251.29545297571167,-291.2399510684739,0.0006760843439721498,3802800.0
3622,BSESN,2018-04-05,33596.800781,33637.460938,33267.859375,33289.960938,11000.0,577.7304680000016,0.0,577.7304680000016,58.90027390735045,32483.839844,33866.28125,80.5069156761063,-19.49308432389369,-199.525003531111,-272.8969615610013,0.013900850892802685,3813800.0
3623,BSESN,2018-04-06,33626.96875,33697.511719,33501.371094,33608.589844,10800.0,30.167969000001907,0.0,30.167969000001907,59.55239382202512,32483.839844,33697.511719,94.18764079047298,-5.812359209527014,-154.28375924794818,-249.1743210983907,0.018805494465741868,3824600.0
3624,BSESN,2018-04-09,33788.539063,33846.5,33578.910156,33653.609375,37400.0,161.57031299999653,0.0,161.57031299999653,63.164181862294434,32483.839844,33846.5,95.74648625742871,-4.2535137425712914,-104.19132056173112,-220.17772099105878,0.036568299404307725,3862000.0
3625,BSESN,2018-04-10,33880.25,33949.980469,33813.300781,33880.109375,13600.0,91.7109370000035,0.0,91.7109370000035,65.19945609613887,32483.839844,33949.980469,95.24394401116865,-4.756055988831339,-56.44177025701356,-187.43053084424974,0.02461228298325957,3875600.0
3626,BSESN,2018-04-11,33940.441406,33981.539063,33750.738281,33970.351563,9300.0,60.1914059999981,0.0,60.1914059999981,66.5971046871723,32483.839844,33981.539063,97.25594722367292,-2.7440527763270794,-13.586349223318393,-152.6616945200635,0.023091630820272213,3884900.0
3627,BSESN,2018-04-12,34101.128906,34177.441406,33924.878906,33987.550781,6600.0,160.6875,0.0,160.6875,70.27447228753948,32483.839844,34177.441406,95.49407005093444,-4.505929949065552,32.96304160618456,-115.53674729481388,0.0343492438495252,3891500.0
3628,BSESN,2018-04-13,34192.648438,34313.140625,34103.53125,34167.53125,8300.0,91.51953199999843,0.0,91.51953199999843,72.27998748929113,32483.839844,34313.140625,93.41321076055435,-6.586789239445656,76.35841826627438,-77.15771418259622,0.028184601839083223,3899800.0
3629,BSESN,2018-04-16,34305.429688,34341.460938,33899.339844,33944.730469,7100.0,112.78125,0.0,112.78125,74.70646838758954,32515.169922000005,34341.460938,98.02708058659145,-1.972919413408545,118.48425846131431,-38.029319653814106,0.028012680990615824,3906900.0
3630,BSESN,2018-04-17,34395.058594,34434.140625,34229.828125,34381.800781,10400.0,89.62890600000537,0.0,89.62890600000537,76.58587394018994,32917.660156,34434.140625,97.42284640000872,-2.5771535999912736,157.28847039234097,1.0342383554169206,0.041672532507926574,3917300.0
3631,BSESN,2018-04-18,34331.679688,34591.808594,34270.039063,34443.421875,8200.0,-63.37890600000537,63.37890600000537,0.0,72.20821243799523,32917.660156,34591.808594,84.46201662316368,-15.537983376836312,180.8423023908108,36.995851162495704,0.0218734787216881,3909100.0
3632,BSESN,2018-04-19,34427.289063,34478.820313,34358.910156,34403.671875,7600.0,95.609375,0.0,95.609375,74.72311258472374,32972.558594,34591.808594,89.83976958468394,-10.160230415316065,204.86223712020728,70.56912835403803,0.023799954106776156,3916700.0
3633,BSESN,2018-04-20,34415.578125,34487.328125,34311.289063,34434.140625,10200.0,-11.710937999996533,11.710937999996533,0.0,73.77953141226016,32972.558594,34591.808594,89.11653734753733,-10.883462652462677,220.41245603217976,100.53779388966639,0.018557744116455055,3906500.0
3634,BSESN,2018-04-23,34450.769531,34663.949219,34259.269531,34493.691406,9500.0,35.19140599999809,0.0,35.19140599999809,74.87941544496785,32972.558594,34663.949219,87.39618838788327,-12.603811612116733,232.8911447634091,127.00846406441497,0.016839295194102766,3916000.0
3635,BSESN,2018-04-24,34616.640625,34706.710938,34465.488281,34491.378906,8400.0,165.8710940000019,0.0,165.8710940000019,79.5457161698192,33267.859375,34706.710938,93.74012474141526,-6.259875258584735,253.24574719656812,152.2559206908456,0.019923112104265783,3924400.0
3636,BSESN,2018-04-25,34501.269531,34631.269531,34400.558594,34593.171875,7800.0,-115.3710940000019,115.3710940000019,0.0,69.22561377593156,33501.371094,34706.710938,82.95572754666199,-17.04427245333801,257.1037017502167,173.22547690271986,0.011733940718003488,3916600.0
3637,BSESN,2018-04-26,34713.601563,34747.96875,34505.621094,34532.949219,10000.0,212.33203199999843,0.0,212.33203199999843,75.87283240236,33578.910156,34747.96875,97.06026822125192,-2.939731778748073,274.1345267965153,193.40728688147897,0.015235822575856428,3926600.0
3638,BSESN,2018-04-27,34969.699219,35065.371094,34744.730469,34747.039063,16200.0,256.09765600000543,0.0,256.09765600000543,81.44919807979403,33750.738281,35065.371094,92.7225401607255,-7.277459839274507,304.78316824536887,215.68246315425696,0.01936339340569071,3942800.0
3639,BSESN,2018-04-30,35160.359375,35213.300781,35004.0,35021.199219,6900.0,190.6601559999981,0.0,190.6601559999981,84.52216192484943,33750.738281,35213.300781,96.38022949446618,-3.619770505533822,340.531681332126,240.6523067898308,0.022250311884437268,3949700.0
3640,BSESN,2018-05-02,35176.421875,35357.148438,35072.421875,35328.910156,8700.0,16.0625,0.0,16.0625,84.76744557715153,33899.339844,35357.148438,87.60286064001642,-12.397139359983578,365.94041174104495,265.70992778007366,0.02460532647038738,3958400.0
3641,BSESN,2018-05-03,35103.140625,35257.308594,35020.078125,35257.308594,7700.0,-73.28125,73.28125,0.0,78.24039504819025,33899.339844,35357.148438,82.57605188737162,-17.42394811262839,375.83147788203496,287.7342378004659,0.01963127450329405,3950700.0
3642,BSESN,2018-05-04,34915.378906,35206.550781,34847.609375,35144.960938,7800.0,-187.7617190000019,187.7617190000019,0.0,63.73232261323771,33899.339844,35357.148438,69.69632818614045,-30.30367181385954,364.31976604511874,303.0513434493965,0.014522515913714562,3942900.0
3643,BSESN,2018-05-07,35208.140625,35259.808594,34977.738281,34983.589844,12600.0,292.76171900000185,0.0,292.76171900000185,72.8048029121226,34229.828125,35357.148438,86.78212294396961,-13.217877056030392,374.50303759118833,317.3416822777549,0.021984156067065275,3955500.0
3644,BSESN,2018-05-08,35216.320313,35388.871094,35136.011719,35349.851563,14200.0,8.179687999996531,0.0,8.179687999996531,73.02236365985856,34259.269531,35388.871094,84.72463329975007,-15.275366700249934,378.8660540835044,329.6465566389048,0.017323451298937087,3969700.0
3645,BSESN,2018-05-09,35319.351563,35404.828125,35134.199219,35198.078125,9400.0,103.03125,0.0,103.03125,75.8323423678296,34259.269531,35404.828125,92.53843823897817,-7.461561761021832,386.1858270722587,340.95441072557566,0.023711650125365358,3979100.0
3646,BSESN,2018-05-10,35246.269531,35500.761719,35203.851563,35353.960938,8400.0,-73.08203199999843,73.08203199999843,0.0,69.87553152228026,34259.269531,35500.761719,79.50110435974786,-20.498895640252147,381.689808176583,349.1014902157772,0.01534464717045525,3970700.0
3647,BSESN,2018-05-11,35535.789063,35596.148438,35262.058594,35287.988281,8900.0,289.51953199999843,0.0,289.51953199999843,77.83443590905797,34259.269531,35596.148438,95.48505293307016,-4.51494706692983,396.9131200483316,358.6638161822881,0.01618801009567794,3979600.0
3648,BSESN,2018-05-14,35556.710938,35642.71875,35456.558594,35555.828125,9000.0,20.921875,0.0,20.921875,78.31220702996279,34400.558594,35642.71875,93.07594825155512,-6.924051748444876,405.98597128633264,368.12824720309703,0.011272682362905906,3988600.0
3649,BSESN,2018-05-15,35543.941406,35993.53125,35497.921875,35537.851563,12000.0,-12.769531999998437,12.769531999998437,0.0,77.14122581743212,34400.558594,35993.53125,71.77667536811741,-28.223324631882598,407.44905763762654,375.99240929000297,0.010447894112311396,3976600.0
3650,BSESN,2018-05-16,35387.878906,35543.890625,35241.628906,35452.351563,10900.0,-156.0625,156.0625,0.0,63.70785681563212,34505.621094,35993.53125,59.29509980439956,-40.70490019560043,391.5026260594386,379.0944526438901,0.008111475951448455,3965700.0
3651,BSESN,2018-05-17,35149.121094,35510.011719,35087.820313,35483.621094,11000.0,-238.7578119999962,238.7578119999962,0.0,48.728626025163166,34744.730469,35993.53125,32.3823167916485,-67.6176832083515,355.50120747186156,374.3758036094845,0.006694533908089273,3954700.0
3652,BSESN,2018-05-18,34848.300781,35163.109375,34821.621094,35143.589844,9500.0,-300.8203130000038,300.8203130000038,0.0,36.31539657229195,34821.621094,35993.53125,2.276598326535557,-97.72340167346444,299.2466100203819,359.349964891664,-0.01022035920137443,3945200.0
3653,BSESN,2018-05-21,34616.128906,34973.949219,34593.820313,34873.160156,6500.0,-232.171875,232.171875,0.0,29.600365235942704,34593.820313,35993.53125,1.5938000061509492,-98.40619999384906,233.24144409661676,334.12826073265455,-0.017042990342703068,3938700.0
3654,BSESN,2018-05-22,34651.238281,34754.601563,34550.21875,34601.488281,12000.0,35.109375,0.0,35.109375,31.80074812782175,34550.21875,35993.53125,6.999144745160739,-93.00085525483927,181.670720719354,303.63675272999444,-0.018916351870397974,3950700.0
3655,BSESN,2018-05-23,34344.910156,34668.46875,34302.890625,34656.628906,11300.0,-306.328125,306.328125,0.0,24.189359412594442,34302.890625,35993.53125,2.485420637517101,-97.5145793624829,114.75955458936369,265.8613131018683,-0.025573185105652985,3939400.0
3656,BSESN,2018-05-24,34663.109375,34741.460938,34367.828125,34404.140625,15800.0,318.19921900000185,0.0,318.19921900000185,41.08917039009926,34302.890625,35993.53125,21.30664226763154,-78.69335773236847,86.41188857197267,229.97142819588916,-0.024557768689274284,3955200.0
3657,BSESN,2018-05-25,34924.871094,35017.929688,34700.519531,34753.46875,10300.0,261.7617190000019,0.0,261.7617190000019,51.37748098979672,34302.890625,35993.53125,36.789632273269305,-63.210367726730695,84.09870459171361,200.79688347505405,-0.01776991817667639,3965500.0
3658,BSESN,2018-05-28,35165.480469,35240.960938,35006.5,35074.320313,11200.0,240.609375,0.0,240.609375,58.97618150211747,34302.890625,35993.53125,51.02147855934799,-48.97852144065201,100.5219014209506,180.74188706423337,-0.010647691899922762,3976700.0
3659,BSESN,2018-05-29,34949.238281,35234.140625,34922.179688,35213.140625,8400.0,-216.2421880000038,216.2421880000038,0.0,50.751378495205174,34302.890625,35993.53125,38.230931307473945,-61.76906869252606,94.99344061854936,163.59219777509657,-0.01239522227837253,3968300.0
3660,BSESN,2018-05-30,34906.109375,35017.449219,34735.109375,34876.128906,10900.0,-43.12890599999809,43.12890599999809,0.0,49.1732101163979,34302.890625,35993.53125,35.67989205275367,-64.32010794724633,86.13899659822346,148.10155753972194,-0.006913735292274015,3957400.0
3661,BSESN,2018-05-31,35322.378906,35416.03125,34926.078125,35083.808594,22900.0,416.2695309999981,0.0,416.2695309999981,62.24721354062793,34302.890625,35993.53125,60.301891834640976,-39.69810816535903,111.42679937889625,140.7666059075568,0.013604052834004454,3980300.0
3662,BSESN,2018-06-01,35227.261719,35438.21875,35177.351563,35373.980469,11900.0,-95.1171869999962,95.1171869999962,0.0,58.29381436312041,34302.890625,35993.53125,54.67578859345119,-45.32421140654881,122.38166357026785,137.089617440099,0.017654568327369446,3968400.0
3663,BSESN,2018-06-04,35011.890625,35555.589844,34982.25,35503.238281,29400.0,-215.3710940000019,215.3710940000019,0.0,49.99766114871552,34302.890625,35555.589844,56.597784148534615,-43.402215851465385,112.3892714515896,132.14954824239712,0.010408065105071751,3939000.0
3664,BSESN,2018-06-05,34903.210938,35073.121094,34784.679688,35029.449219,8300.0,-108.6796870000035,108.6796870000035,0.0,46.17171243402912,34302.890625,35555.589844,47.922143152545196,-52.077856847454804,94.61008012839011,124.64165461959571,0.01625570657963893,3930700.0
3665,BSESN,2018-06-06,35178.878906,35230.539063,34896.371094,34932.488281,10100.0,275.6679680000016,0.0,275.6679680000016,56.021293146033905,34302.890625,35555.589844,69.92806155808712,-30.071938441912867,101.59294385946123,120.03191246756883,0.014879494087509215,3940800.0
3666,BSESN,2018-06-07,35463.078125,35628.488281,35278.378906,35278.378906,8800.0,284.19921900000185,0.0,284.19921900000185,63.88279907935934,34302.890625,35628.488281,87.52184305310824,-12.47815694689176,128.5772569153196,121.740981357119,0.015410422834530202,3949600.0
3667,BSESN,2018-06-08,35443.671875,35484.941406,35260.0,35406.46875,9900.0,-19.40625,19.40625,0.0,62.995561574974296,34302.890625,35628.488281,86.05788074809342,-13.942119251906579,146.7054679201683,126.73387866972887,0.0079109229360661,3939700.0
3668,BSESN,2018-06-11,35483.46875,35704.839844,35444.488281,35472.589844,11100.0,39.796875,0.0,39.796875,64.17295655797537,34302.890625,35704.839844,84.20976373467336,-15.79023626532664,162.4113045431077,133.86936384440463,0.015285897355034272,3950800.0
3669,BSESN,2018-06-12,35692.519531,35743.078125,35479.070313,35525.300781,11100.0,209.0507809999981,0.0,209.0507809999981,69.96516680510325,34367.828125,35743.078125,96.3236797673149,-3.676320232685105,189.54202169733617,145.00389541499095,0.022529298454649016,3961900.0
3670,BSESN,2018-06-13,35739.160156,35877.410156,35715.960938,35835.441406,11900.0,46.640625,0.0,46.640625,71.16524643791092,34700.519531,35877.410156,88.2529440660639,-11.747055933936087,212.35887819484196,158.47489197096115,0.01179935391976672,3973800.0
3671,BSESN,2018-06-14,35599.820313,35749.878906,35488.550781,35743.101563,9800.0,-139.33984300000157,139.33984300000157,0.0,62.54994225078083,34735.109375,35877.410156,75.6990586352403,-24.300941364759694,216.69985944850487,170.11988546646992,0.010575860166816664,3964000.0
3672,BSESN,2018-06-15,35622.140625,35675.199219,35419.679688,35656.261719,9000.0,22.320312000003465,0.0,22.320312000003465,63.36957161101998,34735.109375,35877.410156,77.65303716447353,-22.346962835526462,219.41193677888805,179.97829572895355,0.017429792824848356,3973000.0
3673,BSESN,2018-06-18,35548.261719,35721.550781,35518.730469,35698.429688,8100.0,-73.8789059999981,73.8789059999981,0.0,58.481353952119505,34735.109375,35877.410156,71.1854843772538,-28.81451562274619,213.1428887752918,186.61121433822123,0.018481130064103235,3964900.0
3674,BSESN,2018-06-19,35286.738281,35552.46875,35249.058594,35552.46875,9000.0,-261.5234380000038,261.5234380000038,0.0,44.47012616181821,34784.679688,35877.410156,45.945327571849205,-54.054672428150795,184.93999413116399,186.2769702968098,0.003066026500964103,3955900.0
3675,BSESN,2018-06-20,35547.328125,35571.371094,35329.511719,35329.609375,10200.0,260.5898440000019,0.0,260.5898440000019,56.46275720166554,34784.679688,35877.410156,69.79291411136917,-30.20708588863083,181.5239246962301,185.32636117669387,0.0023757103008101854,3966100.0
3676,BSESN,2018-06-21,35432.390625,35678.691406,35396.96875,35644.050781,62300.0,-114.9375,114.9375,0.0,50.871441699442755,34784.679688,35877.410156,59.27453804646752,-40.72546195353248,167.61006488600106,181.78310191855533,-0.0003182867181421578,3903800.0
3677,BSESN,2018-06-22,35689.601563,35741.261719,35344.488281,35428.421875,14700.0,257.21093799999653,0.0,257.21093799999653,60.87550177698786,34784.679688,35877.410156,82.81290780298795,-17.187092197012056,175.317057924869,180.48989311981808,0.005809263306592483,3918500.0
3678,BSESN,2018-06-25,35470.351563,35806.96875,35430.109375,35783.75,11800.0,-219.25,219.25,0.0,50.717696807039964,34896.371094,35877.410156,58.50740212421805,-41.492597875781954,161.86735665418382,176.76538582669124,-0.006224496642974198,3906700.0
3679,BSESN,2018-06-26,35490.039063,35616.640625,35338.089844,35355.71875,11500.0,19.6875,0.0,19.6875,51.55523201401004,35249.058594,35877.410156,38.3512166712806,-61.64878332871939,151.05571199305996,171.623451059965,-0.006970535734824201,3918200.0
3680,BSESN,2018-06-27,35217.109375,35618.851563,35154.210938,35543.890625,11300.0,-272.92968799999653,272.92968799999653,0.0,40.53580540455975,35154.210938,35877.410156,8.6972490338068,-91.3027509661932,119.0914487629052,161.11705060055306,-0.010750361508432671,3906900.0
3681,BSESN,2018-06-28,35037.640625,35282.398438,34937.148438,35207.191406,13000.0,-179.46875,179.46875,0.0,34.879392221305,34937.148438,35877.410156,10.687682490547095,-89.31231750945291,78.37445963657228,144.56853240775692,-0.016408334528604684,3893900.0
3682,BSESN,2018-06-29,35423.480469,35459.050781,35099.648438,35128.160156,37800.0,385.8398440000019,0.0,385.8398440000019,51.624671315058976,34937.148438,35877.410156,51.723049198947024,-48.27695080105297,76.35977525969065,130.92678097814365,-0.003510192734214823,3931700.0
3683,BSESN,2018-07-02,35264.410156,35578.238281,35106.570313,35545.21875,14800.0,-159.0703130000038,159.0703130000038,0.0,45.99810023747786,34937.148438,35877.410156,34.80538574899218,-65.19461425100782,61.221752271994774,116.98577523691388,-0.0006327625076082422,3916900.0
3684,BSESN,2018-07-03,35378.601563,35445.210938,35195.628906,35344.210938,7700.0,114.19140699999843,0.0,114.19140699999843,50.46957477054077,34937.148438,35806.96875,50.75222076441901,-49.247779235580985,57.77308009334229,105.14323620819957,-0.004746532887273225,3924600.0
3685,BSESN,2018-07-04,35645.398438,35667.308594,35309.671875,35385.519531,11900.0,266.796875,0.0,266.796875,59.50822803615668,34937.148438,35806.96875,81.42486329981188,-18.57513670018812,75.69568787253957,99.25372654106758,0.006011669245080675,3936500.0
3686,BSESN,2018-07-05,35574.550781,35748.261719,35517.789063,35703.171875,19300.0,-70.84765699999843,70.84765699999843,0.0,56.35705246022993,34937.148438,35806.96875,73.2797721789692,-26.720227821030807,83.22332317678229,96.04764586821054,-0.003223649941759832,3917200.0
3687,BSESN,2018-07-06,35657.859375,35799.710938,35532.210938,35543.660156,14600.0,83.3085940000019,0.0,83.3085940000019,59.282478588540656,34937.148438,35806.96875,82.85745079266448,-17.142549207335527,94.8183290114248,95.8017824968534,0.005286325162776162,3931800.0
3688,BSESN,2018-07-09,35934.71875,35977.371094,35779.71875,35835.101563,8400.0,276.859375,0.0,276.859375,67.6082854851575,34937.148438,35977.371094,95.89969092155577,-4.100309078444229,124.90783268230734,101.62299253394421,0.012529704073039438,3940200.0
3689,BSESN,2018-07-10,36239.621094,36274.328125,36019.628906,36068.269531,8800.0,304.90234400000185,0.0,304.90234400000185,74.2888838936649,34937.148438,36274.328125,97.40446019802587,-2.5955398019741236,171.38147316881077,115.57468866091753,0.029034515811961148,3949000.0
3690,BSESN,2018-07-11,36265.929688,36362.300781,36169.699219,36299.261719,9400.0,26.30859399999463,0.0,26.30859399999463,74.80620453975797,34937.148438,36362.300781,93.23783920551702,-6.76216079448297,207.9380710979167,134.0473651483174,0.03505627208595752,3958400.0
3691,BSESN,2018-07-12,36548.410156,36699.53125,36422.078125,36424.230469,12300.0,282.4804680000016,0.0,282.4804680000016,79.83325625983751,34937.148438,36699.53125,91.42518339539947,-8.574816604600523,256.74367010108836,158.5866261388716,0.031756610928856954,3970700.0
3692,BSESN,2018-07-13,36541.628906,36740.070313,36501.609375,36635.140625,11900.0,-6.78125,6.78125,0.0,79.39444364681403,34937.148438,36740.070313,88.99334409595544,-11.006655904044562,291.5148668118127,185.17227427345983,0.036218350012092504,3958800.0
3693,BSESN,2018-07-16,36323.769531,36658.710938,36298.941406,36658.710938,9600.0,-217.859375,217.859375,0.0,65.95561446300954,34937.148438,36740.070313,76.90966049208325,-23.09033950791675,298.0560552112511,207.74903046101812,0.026715809168344373,3949200.0
3694,BSESN,2018-07-17,36519.960938,36549.550781,36261.78125,36390.988281,9200.0,196.19140699999843,0.0,196.19140699999843,71.04780309424737,34937.148438,36740.070313,87.79151897527451,-12.208481024725488,315.43486428532196,229.2861972258789,0.024535074324423034,3958400.0
3695,BSESN,2018-07-18,36373.441406,36747.871094,36320.921875,36722.410156,18400.0,-146.51953199999843,146.51953199999843,0.0,62.93593104125955,35099.648438,36747.871094,77.28282118699364,-22.717178813006353,313.7678732375425,246.18253242821166,0.02245680149042606,3940000.0
3696,BSESN,2018-07-19,36351.230469,36515.578125,36279.328125,36509.078125,9400.0,-22.210936999996196,22.210936999996196,0.0,61.70367561851796,35106.570313,36747.871094,75.83376370793314,-24.166236292066852,307.114311223042,258.36888818717773,0.019445112694738143,3930600.0
3697,BSESN,2018-07-20,36496.371094,36567.339844,36335.609375,36377.03125,16300.0,145.140625,0.0,145.140625,66.63005232182128,35195.628906,36747.871094,83.79763145569142,-16.202368544308587,309.9796978359227,268.6910501169267,0.015629796573821908,3946900.0
3698,BSESN,2018-07-23,36718.601563,36749.691406,36491.828125,36501.050781,8100.0,222.23046899999463,0.0,222.23046899999463,72.80950672193374,35309.671875,36749.691406,97.8410124077684,-2.158987592231595,326.4199133891889,280.23682277137914,0.013217038548984705,3955000.0
3699,BSESN,2018-07-24,36825.101563,36902.058594,36709.71875,36859.390625,11600.0,106.5,0.0,106.5,75.33512354783645,35517.789063,36902.058594,94.44060356190813,-5.559396438091873,344.0762655931612,293.0047113357356,0.015418655465629039,3966600.0
3700,BSESN,2018-07-25,36858.230469,36947.179688,36803.148438,36928.058594,11000.0,33.12890600000537,0.0,33.12890600000537,76.13090129362921,35532.210938,36947.179688,93.71369728130075,-6.286302718699238,356.631254657892,305.73002000016686,0.008476984680799937,3977600.0
3701,BSESN,2018-07-26,36984.640625,37061.621094,36852.53125,36928.378906,17800.0,126.4101559999981,0.0,126.4101559999981,79.09974425027727,35779.71875,37061.621094,93.99482578682282,-6.0051742131771775,372.48761175808613,319.08153835175074,0.012123480322664637,3995400.0
3702,BSESN,2018-07-27,37336.851563,37368.621094,37134.878906,37253.859375,14700.0,352.2109379999965,0.0,352.2109379999965,85.06987091986892,36019.628906,37368.621094,97.64494329302926,-2.3550567069707364,408.7624095344945,337.0177125882995,0.027890333109161336,4010100.0
3703,BSESN,2018-07-30,37494.398438,37533.5,37292.449219,37491.390625,14100.0,157.546875,0.0,157.546875,86.9882041390235,36169.699219,37533.5,97.132897814347,-2.867102185652988,445.0924159458227,358.63265325980416,0.026682325910871052,4024200.0
3704,BSESN,2018-07-31,37606.578125,37644.589844,37298.75,37534.949219,14000.0,112.1796870000035,0.0,112.1796870000035,88.23061850056303,36261.78125,37644.589844,97.25112216072893,-2.7488778392710693,477.4326248783909,382.3926475835216,0.033902118450540364,4038200.0
3705,BSESN,2018-08-01,37521.621094,37711.871094,37432.910156,37643.871094,16100.0,-84.9570309999981,84.9570309999981,0.0,81.43580378593172,36261.78125,37711.871094,86.88012327048614,-13.119876729513855,490.5523687215318,404.0245918111237,0.03219672649040306,4022100.0
3706,BSESN,2018-08-02,37165.160156,37529.691406,37128.988281,37529.691406,11700.0,-356.4609380000038,356.4609380000038,0.0,59.319360686607006,36261.78125,37711.871094,62.29813343896483,-37.701866561035175,466.8053995419832,416.5807533572957,0.01832480989075491,4010400.0
3707,BSESN,2018-08-03,37556.160156,37582.269531,37319.609375,37327.160156,17800.0,391.0,0.0,391.0,69.72549923576321,36261.78125,37711.871094,89.26197996322195,-10.738020036778053,474.07138779683737,428.0788802452041,0.022810198573683715,4028200.0
3708,BSESN,2018-08-06,37691.890625,37805.25,37643.289063,37714.699219,12400.0,135.7304690000019,0.0,135.7304690000019,72.53911543702591,36279.328125,37805.25,92.57108919812818,-7.428910801871819,485.189092500259,439.50092269621507,0.023537995150321844,4040600.0
3709,BSESN,2018-08-07,37665.800781,37876.871094,37586.878906,37849.210938,15900.0,-26.089844000001907,26.089844000001907,0.0,71.07410306318796,36279.328125,37876.871094,86.78781622179932,-13.212183778200682,486.28908335905726,448.85855482878355,0.021910175874536586,4024700.0
3710,BSESN,2018-08-08,37887.558594,37931.421875,37641.398438,37756.238281,9400.0,221.7578130000038,0.0,221.7578130000038,75.85630699414824,36335.609375,37931.421875,97.25135120824044,-2.7486487917595643,499.2992255719728,458.9466889774214,0.024413322767010248,4034100.0
3711,BSESN,2018-08-09,38024.371094,38076.230469,37939.28125,37994.511719,15300.0,136.8125,0.0,136.8125,78.3985597226972,36491.828125,38076.230469,96.72688094685121,-3.273119053148784,514.7161549345474,470.10058216884664,0.018413966422421213,4049400.0
3712,BSESN,2018-08-10,37869.230469,38051.449219,37815.75,38050.070313,15600.0,-155.140625,155.140625,0.0,68.90530093107233,36709.71875,38076.230469,84.85194110508762,-15.148058894912392,508.55334426494665,477.79113458806665,0.009997014130519233,4033800.0
3713,BSESN,2018-08-13,37644.898438,37799.539063,37559.261719,37693.191406,11400.0,-224.33203100000537,224.33203100000537,0.0,57.32399922393266,36803.148438,38076.230469,66.11907006014418,-33.88092993985582,480.0340189680719,478.23971146406774,0.001018978990128483,4022400.0
3714,BSESN,2018-08-14,37852.0,37932.398438,37689.710938,37749.589844,11300.0,207.10156200000347,0.0,207.10156200000347,63.804382909937814,36852.53125,38076.230469,81.67601437359407,-18.323985626405925,468.74026741106354,476.3398226534669,0.008805027511266772,4033700.0
3715,BSESN,2018-08-16,37663.558594,37891.921875,37634.128906,37796.011719,13000.0,-188.4414059999981,188.4414059999981,0.0,55.0310314620917,37128.988281,38076.230469,56.43438602842315,-43.56561397157686,439.5177542605743,468.9754089748884,0.01341036701868048,4020700.0
3716,BSESN,2018-08-17,37947.878906,38022.320313,37840.160156,37898.601563,10000.0,284.3203119999962,0.0,284.3203119999962,63.71666772545376,37128.988281,38076.230469,86.44997397434295,-13.55002602565705,434.29469614824484,462.0392664095598,0.010430213002950328,4030700.0
3717,BSESN,2018-08-20,38278.75,38340.691406,38050.691406,38075.070313,11800.0,330.87109400000185,0.0,330.87109400000185,71.18885949639662,37128.988281,38340.691406,94.88807078879175,-5.11192921120824,451.647604599857,459.9609340476192,0.015569910802265552,4042500.0
3718,BSESN,2018-08-21,38285.75,38402.960938,38213.871094,38360.320313,8900.0,7.0,0.0,7.0,71.33297496177045,37128.988281,38402.960938,90.7995719251927,-9.200428074807313,460.6546114539742,460.0996695288902,0.016459207189157388,4051400.0
3719,BSESN,2018-08-23,38336.761719,38487.628906,38227.359375,38416.648438,11100.0,51.0117190000019,0.0,51.0117190000019,72.4900455001677,37128.988281,38487.628906,88.89572531367548,-11.104274686324516,466.53106892140204,461.38594940739256,0.011856217229872845,4062500.0
3720,BSESN,2018-08-24,38251.800781,38429.5,38172.769531,38366.789063,10700.0,-84.96093800000382,84.96093800000382,0.0,67.27198958354873,37319.609375,38487.628906,79.80957349248294,-20.190426507517053,459.0410269380809,460.9169649135303,0.005981155781321634,4051800.0
3721,BSESN,2018-08-27,38694.109375,38736.878906,38416.730469,38472.03125,10800.0,442.3085940000019,0.0,442.3085940000019,77.15160502108637,37559.261719,38736.878906,96.36812951847669,-3.6318704815233165,483.2254000971516,465.3786519502546,0.02178229913267571,4062600.0
3722,BSESN,2018-08-28,38896.628906,38938.910156,38760.578125,38814.761719,9900.0,202.5195309999981,0.0,202.5195309999981,80.29429695726972,37559.261719,38938.910156,96.93536056968692,-3.0646394303130804,512.8218328218209,474.86728812456784,0.033250998672810006,4072500.0
3723,BSESN,2018-08-29,38722.929688,38989.648438,38679.570313,38989.648438,11400.0,-173.69921800000157,173.69921800000157,0.0,70.67407477969199,37559.261719,38989.648438,81.35338181925604,-18.64661818074396,516.3094498132632,483.155720462307,0.023008815597590493,4061100.0
3724,BSESN,2018-08-30,38690.101563,38819.058594,38581.828125,38796.980469,10800.0,-32.828125,32.828125,0.0,68.87456022743199,37559.261719,38989.648438,79.05832939993893,-20.94167060006107,510.5392770878898,488.63243178742357,0.027255602160851877,4050300.0
3725,BSESN,2018-08-31,38645.070313,38838.449219,38562.210938,38704.839844,18000.0,-45.03125,45.03125,0.0,66.2064051401187,37559.261719,38989.648438,75.910142311661,-24.089857688338988,496.60813860404596,490.2275731507481,0.018372341935816827,4032300.0
3726,BSESN,2018-09-03,38312.519531,38934.351563,38270.011719,38915.910156,12300.0,-332.55078199999843,332.55078199999843,0.0,49.775549743011425,37559.261719,38989.648438,52.66113016811358,-47.33886983188642,453.50580944885587,482.8832204103697,0.0008822004637036862,4020000.0
3727,BSESN,2018-09-04,38157.921875,38518.558594,38098.601563,38460.960938,12500.0,-154.5976559999981,154.5976559999981,0.0,43.92775627793816,37634.128906,38989.648438,38.64149181437265,-61.35850818562735,402.2354444247103,466.75366521323787,-0.0033387911951574534,4007500.0
3728,BSESN,2018-09-05,38018.308594,38250.609375,37774.421875,38192.949219,14800.0,-139.6132809999981,139.6132809999981,0.0,39.13669384197467,37634.128906,38989.648438,28.341877703021122,-71.65812229697887,346.3452335206166,442.67197887471366,-0.008306729904163257,3992700.0
3729,BSESN,2018-09-06,38242.808594,38320.960938,37912.5,38161.851563,9300.0,224.5,0.0,224.5,49.38024159021707,37774.421875,38989.648438,38.54316003788696,-61.456839962113044,316.5184844245741,417.4412799846857,-0.0002350787888778516,4002000.0
3730,BSESN,2018-09-07,38389.820313,38421.558594,38067.21875,38314.550781,18700.0,147.01171899999463,0.0,147.01171899999463,55.09120964191662,37774.421875,38989.648438,50.6406341613188,-49.3593658386812,301.270331127962,394.207090213341,-0.00786396345373963,4020700.0
3731,BSESN,2018-09-10,37922.171875,38354.519531,37882.828125,38348.390625,20500.0,-467.6484379999965,467.6484379999965,0.0,38.95849970343136,37774.421875,38989.648438,12.158226663121454,-87.84177333687855,248.5852036491051,365.08271290049385,-0.025052480341032468,4000200.0
3732,BSESN,2018-09-11,37413.128906,38043.269531,37361.199219,38017.488281,11900.0,-509.0429690000019,509.0429690000019,0.0,28.482667402344262,37361.199219,38989.648438,3.1889042896827577,-96.81109571031725,163.8673859759365,324.8396475155824,-0.0338249402241354,3988300.0
3733,BSESN,2018-09-12,37717.960938,37752.578125,37342.0,37546.421875,13600.0,304.83203199999843,0.0,304.83203199999843,39.68842118515637,37342.0,38989.648438,22.81803140337134,-77.18196859662866,119.94267797586508,283.8602536076389,-0.025126339444135115,4001900.0
3734,BSESN,2018-09-14,38090.640625,38125.621094,37859.519531,37939.289063,12200.0,372.6796870000034,0.0,372.6796870000034,50.60601352612509,37342.0,38989.648438,45.436915286900636,-54.563084713099364,113.89129855728243,249.86646259756762,-0.014346711844731463,4014100.0
3735,BSESN,2018-09-17,37585.511719,38027.808594,37548.929688,38027.808594,8800.0,-505.1289059999981,505.1289059999981,0.0,39.44041398382129,37342.0,38989.648438,14.779349367489427,-85.22065063251057,67.5570994053196,213.40458995911803,-0.018975724408094585,4005300.0
3736,BSESN,2018-09-18,37290.671875,37745.441406,37242.851563,37660.191406,10900.0,-294.83984400000185,294.83984400000185,0.0,34.33788663951873,37242.851563,38989.648438,2.737600042935929,-97.26239995706408,6.96550739275699,172.1167734458458,-0.022727914870232957,3994400.0
3737,BSESN,2018-09-19,37121.21875,37530.628906,37062.691406,37432.929688,13000.0,-169.453125,169.453125,0.0,31.62468885581754,37062.691406,38934.351563,3.127028364690564,-96.87297163530944,-54.10354483809351,126.87270978905795,-0.023596258675789183,3981400.0
3738,BSESN,2018-09-21,36841.601563,37489.238281,35993.640625,37278.890625,41100.0,-279.61718700000347,279.61718700000347,0.0,27.489155932590165,35993.640625,38934.351563,28.8352359642904,-71.16476403570961,-123.63874831425346,76.77041816839566,-0.03663975221788085,3940300.0
3739,BSESN,2018-09-24,36305.019531,36945.5,36216.949219,36924.71875,23300.0,-536.5820319999984,536.5820319999984,0.0,21.316839234284217,35993.640625,38934.351563,10.588558772518105,-89.41144122748189,-219.51317241307697,17.51370005210112,-0.054306083357572255,3917000.0
3740,BSESN,2018-09-25,36652.058594,36705.789063,36064.101563,36350.25,20500.0,347.0390630000038,0.0,347.0390630000038,32.60903981543538,35993.640625,38518.558594,26.076806339208296,-73.9231936607917,-264.4428595171339,-38.877611861745905,-0.033492630252997535,3937500.0
3741,BSESN,2018-09-26,36542.269531,36938.738281,36357.929688,36936.640625,21800.0,-109.7890630000038,109.7890630000038,0.0,30.985780692714044,35993.640625,38421.558594,22.596682136916037,-77.40331786308397,-305.388689373387,-92.17982736407416,-0.023276838918980136,3915700.0
3742,BSESN,2018-09-27,36324.171875,36711.621094,36238.230469,36691.929688,17800.0,-218.0976559999981,218.0976559999981,0.0,27.81236091586605,35993.640625,38421.558594,13.613773373741184,-86.3862266262588,-351.38664612831053,-144.02119111692147,-0.036952927155608384,3897900.0
3743,BSESN,2018-09-28,36227.140625,36551.859375,35985.628906,36452.738281,22800.0,-97.03125,97.03125,0.0,26.423180331553667,35985.628906,38421.558594,9.914560349986651,-90.08543965001336,-391.1609097268665,-193.4491348389105,-0.04892277917680732,3875100.0
3744,BSESN,2018-10-01,36526.140625,36616.640625,35960.648438,36274.25,21300.0,299.0,0.0,299.0,37.5193666491404,35960.648438,38354.519531,23.622499501062443,-76.37750049893755,-394.0135560251292,-233.56201907615431,-0.028185623809519056,3896400.0
3745,BSESN,2018-10-03,35975.628906,36602.851563,35911.820313,36602.851563,25100.0,-550.5117190000019,550.5117190000019,0.0,28.415413789200457,35911.820313,38125.621094,2.882309625492964,-97.11769037450703,-435.673817107534,-273.9843786824303,-0.0352646627930997,3871300.0
3746,BSESN,2018-10-04,35169.160156,35820.53125,35022.121094,35820.53125,21300.0,-806.46875,806.46875,0.0,20.150623043138765,35022.121094,38125.621094,4.737846367004871,-95.26215363299512,-527.6823684728661,-324.7239766405175,-0.052586058856162965,3850000.0
3747,BSESN,2018-10-05,34376.988281,35118.539063,34202.21875,35097.988281,22100.0,-792.171875,792.171875,0.0,15.154792883530746,34202.21875,38125.621094,4.4545401077019395,-95.54545989229806,-656.948564061393,-391.16889412469266,-0.06689756083989595,3827900.0
3748,BSESN,2018-10-08,34474.378906,34636.429688,33974.660156,34412.359375,20400.0,97.390625,0.0,97.390625,18.037368576267667,33974.660156,38027.808594,12.329149984119075,-87.67085001588093,-742.9698518978621,-461.5290856793266,-0.05042389864125696,3848300.0
3749,BSESN,2018-10-09,34299.46875,34711.679688,34233.5,34651.820313,30300.0,-174.9101559999981,174.9101559999981,0.0,16.85098665107165,33974.660156,37745.441406,8.613827545684384,-91.38617245431561,-815.8515017993923,-532.3935689033399,-0.06418711347321493,3818000.0
3750,BSESN,2018-10-10,34760.890625,34858.351563,34346.5,34493.210938,24400.0,461.421875,0.0,461.421875,30.721189785618733,33974.660156,37530.628906,22.110162497912896,-77.88983750208712,-826.8464739239571,-591.2841499074633,-0.04874844745175988,3842400.0
3751,BSESN,2018-10-11,34001.148438,34325.179688,33723.53125,34063.820313,30700.0,-759.7421870000035,759.7421870000035,0.0,23.32816361371063,33723.53125,37489.238281,7.372246054050419,-92.62775394594959,-886.6442308315382,-650.3561660922783,-0.06395255052184179,3811700.0
3752,BSESN,2018-10-12,34733.578125,34808.421875,34279.78125,34291.921875,31300.0,732.4296870000035,0.0,732.4296870000035,39.51845579501192,33723.53125,36945.5,31.348748339039602,-68.6512516609604,-864.9626780972321,-693.2774684932691,-0.04122772248189266,3843000.0
3753,BSESN,2018-10-15,34865.101563,35008.648438,34559.980469,34971.828125,10600.0,131.5234379999965,0.0,131.5234379999965,42.05375511054019,33723.53125,36938.738281,35.50534388589415,-64.49465611410585,-827.6266838570009,-720.1473115660156,-0.04547535090151622,3853600.0
3754,BSESN,2018-10-16,35162.480469,35215.789063,34913.058594,35004.328125,12900.0,297.3789060000054,0.0,297.3789060000054,47.7660918705394,33723.53125,36938.738281,44.75448097513205,-55.24551902486796,-765.220659584942,-729.1619811698009,-0.02260275808171852,3866500.0
3755,BSESN,2018-10-17,34779.578125,35605.429688,34727.160156,35543.378906,17700.0,-382.9023440000019,382.9023440000019,0.0,41.6640429194493,33723.53125,36711.621094,35.34187156790187,-64.65812843209812,-738.1515037981735,-730.9598856954755,-0.011077376578568443,3848800.0
3756,BSESN,2018-10-19,34315.628906,34563.289063,34140.320313,34563.289063,16000.0,-463.9492190000019,463.9492190000019,0.0,35.350392304502876,33723.53125,36616.640625,20.465788853903877,-79.53421114609613,-745.5416869190958,-733.8762459401996,-0.0017848967599617405,3832800.0
3757,BSESN,2018-10-22,34134.378906,34748.691406,34082.761719,34689.390625,17100.0,-181.25,181.25,0.0,33.09006062382505,33723.53125,36616.640625,14.200902999043999,-85.79909700095601,-757.294204328151,-738.55983761779,-0.009862396678039231,3815700.0
3758,BSESN,2018-10-23,33847.230469,34073.921875,33742.75,33935.878906,12700.0,-287.1484369999962,287.1484369999962,0.0,29.627129467143803,33723.53125,36602.851563,4.296125666932773,-95.70387433306723,-780.778311753158,-747.0035324448637,-0.01318499374716986,3803000.0
3759,BSESN,2018-10-24,34033.960938,34300.96875,33726.070313,34203.699219,18900.0,186.73046899999463,0.0,186.73046899999463,34.75076640525245,33723.53125,35820.53125,14.803513972341275,-85.19648602765872,-775.3839048097507,-752.6796069178412,-0.020912286018275883,3821900.0
3760,BSESN,2018-10-25,33690.089844,33838.761719,33553.179688,33778.601563,17400.0,-343.8710939999947,343.8710939999947,0.0,30.09495695857676,33553.179688,35605.429688,6.671222122061414,-93.32877787793859,-789.7525461297628,-760.0941947602256,-0.00914847316311096,3804500.0
3761,BSESN,2018-10-26,33349.308594,33776.800781,33291.578125,33776.800781,21300.0,-340.78125,340.78125,0.0,26.09691051775063,33291.578125,35605.429688,2.4949944898432532,-97.50500551015675,-819.1948286895495,-771.9143215460905,-0.03985392826556067,3783200.0
3762,BSESN,2018-10-29,34067.398438,34154.601563,33341.800781,33549.878906,28000.0,718.0898439999946,0.0,718.0898439999946,44.139847260394596,33291.578125,35605.429688,33.5293899317429,-66.4706100682571,-775.6430701630088,-772.6600712694742,-0.022879701742975822,3811200.0
3763,BSESN,2018-10-30,33891.128906,34176.359375,33799.789063,34068.921875,15800.0,-176.26953199999843,176.26953199999843,0.0,41.28499743459319,33291.578125,35605.429688,25.911376104984786,-74.08862389501522,-746.7434719309531,-767.4767514017701,-0.0361564811709133,3795400.0
3764,BSESN,2018-10-31,34442.050781,34463.378906,33587.238281,33963.089844,25900.0,550.921875,0.0,550.921875,52.38984723969545,33291.578125,35605.429688,49.72110892491161,-50.27889107508838,-671.643255687246,-748.3100522588654,-0.00970475670483717,3821300.0
3765,BSESN,2018-11-01,34431.96875,34679.929688,34303.378906,34650.628906,22400.0,-10.082030999998096,10.082030999998096,0.0,52.18145300918514,33291.578125,35605.429688,49.28538386971722,-50.714616130282785,-605.9542653118478,-719.838894869462,0.0033902873911677567,3798900.0
3766,BSESN,2018-11-02,35011.648438,35190.199219,34649.800781,34743.949219,38700.0,579.6796879999965,0.0,579.6796879999965,62.16564374677882,33291.578125,35605.429688,74.33797139388925,-25.66202860611076,-501.3408160853942,-676.1392791126485,0.02570046856325825,3837600.0
3767,BSESN,2018-11-05,34950.921875,35123.410156,34811.601563,35118.621094,22200.0,-60.72656299999653,60.72656299999653,0.0,60.63532902038415,33291.578125,35605.429688,71.71349176126915,-28.28650823873085,-418.5097105651221,-624.6133654031432,0.03260802702929699,3815400.0
3768,BSESN,2018-11-06,34991.910156,35196.03125,34889.71875,35076.238281,16200.0,40.98828099999809,0.0,40.98828099999809,61.3758178789459,33291.578125,35605.429688,73.4849226367595,-26.51507736324049,-345.57448341887357,-568.8055890062893,0.02814686247495879,3831600.0
3769,BSESN,2018-11-07,35237.679688,35302.25,35183.171875,35301.878906,2500.0,245.76953199999843,0.0,245.76953199999843,65.82369928687636,33291.578125,35302.25,96.7886201223159,-3.211379877684094,-264.8877817240136,-508.0220275498342,0.04593605571151693,3834100.0
3770,BSESN,2018-11-09,35158.550781,35287.289063,35011.230469,35258.128906,17100.0,-79.12890699999843,79.12890699999843,0.0,63.123236526639026,33291.578125,35302.25,92.85317406650442,-7.146825933495584,-204.96531819985103,-447.4106856798376,0.05425126526687585,3817000.0
3771,BSESN,2018-11-12,34812.988281,35333.21875,34756.800781,35287.488281,15700.0,-345.5625,345.5625,0.0,52.30949919991135,33291.578125,35333.21875,74.51899895457841,-25.481001045421593,-183.24797135670087,-394.5781428152103,0.021885728796019466,3801300.0
3772,BSESN,2018-11-13,35144.488281,35187.75,34672.199219,34846.191406,12000.0,331.5,0.0,331.5,59.91125406315377,33291.578125,35333.21875,90.75594075230542,-9.24405924769458,-137.70021560943132,-343.20255737405455,0.0369819305363448,3813300.0
3773,BSESN,2018-11-14,35141.988281,35351.878906,34986.859375,35330.140625,23300.0,-2.5,2.5,0.0,59.828270360669116,33291.578125,35351.878906,89.81262216975297,-10.18737783024702,-100.64484896288195,-294.69101569182004,0.020322178387418344,3790000.0
3774,BSESN,2018-11-15,35260.539063,35402.0,35118.421875,35145.75,20000.0,118.55078199999843,0.0,118.55078199999843,62.658298910981465,33291.578125,35402.0,93.29703038640066,-6.7029696135993415,-61.00887426301779,-247.95458740605957,0.02406398306806068,3810000.0
3775,BSESN,2018-11-16,35457.160156,35545.851563,35324.371094,35398.699219,21100.0,196.6210930000016,0.0,196.6210930000016,67.0945103112657,33341.800781,35545.851563,95.97598169133299,-4.0240183086670145,-13.574916589190252,-201.0786532426857,0.012724671298723012,3831100.0
3776,BSESN,2018-11-19,35774.878906,35818.828125,35511.101563,35647.621094,15600.0,317.71875,0.0,317.71875,73.06146517055636,33587.238281,35818.828125,98.03058706696633,-1.9694129330336683,49.088225936902745,-151.045277406768,0.02357468664050799,3846700.0
3777,BSESN,2018-11-20,35474.511719,35731.671875,35416.179688,35730.769531,15700.0,-300.3671869999962,300.3671869999962,0.0,60.99601789589402,33587.238281,35818.828125,84.57080242923001,-15.42919757076999,73.66295543812157,-106.10363083779008,0.013791803901201272,3831000.0
3778,BSESN,2018-11-21,35199.800781,35494.25,35112.488281,35492.621094,13900.0,-274.7109380000038,274.7109380000038,0.0,51.943708790276645,34303.378906,35818.828125,59.152221253017046,-40.84777874698295,70.16293414776737,-70.85031784067858,-0.00107495463195606,3817100.0
3779,BSESN,2018-11-22,34981.019531,35364.5,34937.980469,35282.328125,13800.0,-218.78125,218.78125,0.0,45.709941171722285,34649.800781,35818.828125,28.332848816579904,-71.6671511834201,49.1685393003645,-46.84654641246996,-0.005049447319539158,3803300.0
3780,BSESN,2018-11-26,35354.078125,35397.238281,34896.070313,35118.089844,19200.0,373.0585940000019,0.0,373.0585940000019,56.0802631273582,34672.199219,35818.828125,59.468141997110905,-40.5318580028891,61.919274034728005,-25.093382323030365,0.015542757767086357,3822500.0
3781,BSESN,2018-11-27,35513.140625,35555.160156,35262.96875,35394.769531,19100.0,159.0625,0.0,159.0625,59.85305693941475,34672.199219,35818.828125,73.3403284706656,-26.6596715293344,83.89227960684366,-3.296249937055556,0.010489620479103845,3841600.0
3782,BSESN,2018-11-28,35716.949219,35822.160156,35605.339844,35635.519531,27500.0,203.8085940000019,0.0,203.8085940000019,64.37717837343516,34672.199219,35822.160156,90.8509120949387,-9.149087905061295,116.40979540714034,20.64495913178363,0.016361081604220562,3869100.0
3783,BSESN,2018-11-29,36170.410156,36253.851563,35946.238281,35997.289063,40500.0,453.4609369999962,0.0,453.4609369999962,72.37039727585005,34672.199219,36253.851563,94.72441543070235,-5.275584569297658,176.73339626027882,51.862646557482684,0.025804230938566652,3909600.0
3784,BSESN,2018-11-30,36194.300781,36389.21875,36082.96875,36304.429688,23300.0,23.890625,0.0,23.890625,72.74220604791205,34672.199219,36389.21875,88.64788865351572,-11.352111346484277,223.88722574624262,86.26756239523469,0.0207896126411935,3932900.0
3785,BSESN,2018-12-03,36241.0,36446.160156,36099.679688,36396.691406,30100.0,46.6992190000019,0.0,46.6992190000019,73.54514116514804,34672.199219,36446.160156,88.43491129252534,-11.565088707474652,262.0049816939718,121.41504625498214,0.013029285024968251,3963000.0
3786,BSESN,2018-12-04,36134.308594,36295.839844,36036.390625,36290.480469,18500.0,-106.6914059999981,106.6914059999981,0.0,68.24566949737024,34896.070313,36446.160156,79.8817105080537,-20.1182894919463,280.37251329183346,153.2065396623524,0.0185991813002635,3944500.0
3787,BSESN,2018-12-05,35884.410156,36048.648438,35777.808594,36035.648438,20800.0,-249.8984380000038,249.8984380000038,0.0,57.12165855102346,34896.070313,36446.160156,63.760165093862916,-36.239834906137084,271.6329830133327,176.8918283325485,0.019449240047106686,3923700.0
3788,BSESN,2018-12-06,35312.128906,35707.230469,35266.761719,35694.25,22600.0,-572.28125,572.28125,0.0,39.92552451605945,34896.070313,36446.160156,26.840934083844658,-73.15906591615534,216.03817458415142,184.7210975828691,0.009465400935686707,3901100.0
3789,BSESN,2018-12-07,35673.25,35730.050781,35378.269531,35494.859375,19000.0,361.1210940000019,0.0,361.1210940000019,50.72592255929865,34896.070313,36446.160156,50.13771882382451,-49.8622811761755,198.82639571132313,187.54215720855993,0.009027865862363038,3920100.0
3790,BSESN,2018-12-10,34959.71875,35246.96875,34915.769531,35204.660156,18500.0,-713.53125,713.53125,0.0,35.97886728722031,34896.070313,36446.160156,4.106112770652056,-95.89388722934794,126.15568410770356,175.26486258838867,-0.01558358019764694,3901600.0
3791,BSESN,2018-12-11,35150.011719,35207.328125,34426.289063,34584.128906,22300.0,190.2929690000019,0.0,190.2929690000019,41.235949041128926,34426.289063,36446.160156,35.83014077027562,-64.16985922972438,82.96233568768366,156.80435720824767,-0.015873066216372522,3923900.0
3792,BSESN,2018-12-12,35779.070313,35826.578125,35167.46875,35277.839844,21600.0,629.0585939999946,0.0,629.0585939999946,55.25164619455656,34426.289063,36446.160156,66.97364275810244,-33.02635724189757,98.35726581231575,145.11493892906128,-0.010819336615542463,3945500.0
3793,BSESN,2018-12-13,35929.640625,36095.558594,35794.511719,36024.878906,22600.0,150.57031200000347,0.0,150.57031200000347,58.017130835523524,34426.289063,36446.160156,74.42809430809565,-25.571905691904355,121.30924717135349,140.35380057751973,-0.007312205244725423,3968100.0
3794,BSESN,2018-12-14,35962.929688,36019.019531,35813.851563,35960.191406,19000.0,33.28906299999653,0.0,33.28906299999653,58.66873376149283,34426.289063,36446.160156,76.0761728966433,-23.9238271033567,140.56466497491783,140.39597345699937,-0.007672810132170804,3987100.0
3795,BSESN,2018-12-17,36270.070313,36312.308594,36123.621094,36129.128906,17130800.0,307.140625,0.0,307.140625,64.5295859402234,34426.289063,36446.160156,91.28212470537092,-8.717875294629083,178.5501884395344,148.02681645350637,0.0037571417382131767,21117900.0
3796,BSESN,2018-12-18,36347.078125,36375.378906,36046.519531,36226.378906,20793100.0,77.00781200000347,0.0,77.00781200000347,65.92734853771809,34426.289063,36446.160156,95.09463592288768,-4.9053640771123215,212.4192395364371,160.90530107009252,0.012893286164901374,41911000.0
3797,BSESN,2018-12-19,36484.328125,36554.988281,36381.871094,36441.460938,16700.0,137.25,0.0,137.25,68.4815627048795,34426.289063,36554.988281,96.68059463720824,-3.3194053627917497,247.48280675438582,178.2208022069512,0.033195370976368155,41927700.0
3798,BSESN,2018-12-20,36431.671875,36475.519531,36202.898438,36321.179688,19766300.0,-52.65625,52.65625,0.0,66.28201903809601,34426.289063,36554.988281,94.20695958558866,-5.793040414411333,267.93344709034136,196.16333118362925,0.021260240516353335,22161400.0
3799,BSESN,2018-12-21,35742.070313,36483.488281,35694.738281,36449.269531,18528300.0,-689.6015620000035,689.6015620000035,0.0,44.62383520446816,34426.289063,36554.988281,61.81151563705789,-38.18848436294211,225.89170511890552,202.10900597068454,0.02237865723676613,3633100.0
3800,BSESN,2018-12-24,35470.148438,35910.671875,35423.238281,35859.660156,13245200.0,-271.921875,271.921875,0.0,38.84830108386641,34426.289063,36554.988281,49.03742934526691,-50.962570654733085,168.68698043907352,195.42460086436236,0.009107727233756524,-9612100.0
3801,BSESN,2018-12-26,35649.941406,35711.261719,35010.820313,35443.160156,16200.0,179.79296800000157,0.0,179.79296800000157,44.34389383384891,34426.289063,36554.988281,57.48357178191065,-42.51642821808935,136.28856418633222,183.59739352875636,-0.003609062669051033,-9595900.0
3802,BSESN,2018-12-27,35807.28125,36041.238281,35781.949219,36002.109375,13054200.0,157.3398440000019,0.0,157.3398440000019,48.974200479153055,34426.289063,36554.988281,64.87493279099812,-35.125067209001884,121.90337018562423,171.25858886012995,-0.003405527382727591,3458300.0
3803,BSESN,2018-12-28,36076.71875,36194.78125,35911.988281,35911.988281,10426300.0,269.4375,0.0,269.4375,56.17792510877178,34426.289063,36554.988281,77.53231048539814,-22.467689514601858,130.73729659321543,163.15433040674705,0.0031640654136688706,13884600.0
3804,BSESN,2018-12-31,36068.328125,36285.460938,36033.949219,36239.191406,8645400.0,-8.390625,8.390625,0.0,55.89438165896187,34426.289063,36554.988281,77.13814371307775,-22.86185628692225,135.49924267786992,157.62331286097162,-0.005562222136847872,5239200.0
3805,BSESN,2019-01-02,35891.519531,36236.699219,35734.011719,36198.128906,14705400.0,-176.8085940000019,176.8085940000019,0.0,49.784847829910795,35010.820313,36554.988281,57.03390021363276,-42.96609978636724,123.58157193874649,150.8149646765266,-0.012533568515007087,-9466200.0
3806,BSESN,2019-01-03,35513.710938,35999.660156,35475.570313,35934.5,17400.0,-377.8085930000016,377.8085930000016,0.0,39.216154613849355,35010.820313,36554.988281,32.56709343941005,-67.43290656058994,82.69745129768125,137.19146200075755,-0.026603674423564705,-9483600.0
3807,BSESN,2019-01-04,35695.101563,35744.199219,35382.078125,35590.789063,15855600.0,181.390625,0.0,181.390625,45.612265560599525,35010.820313,36554.988281,44.31391300560894,-55.68608699439106,64.19321915671026,122.5918134319481,-0.020217856444448512,6372000.0
3808,BSESN,2019-01-07,35850.160156,36076.949219,35809.230469,35971.179688,14831200.0,155.05859300000157,0.0,155.05859300000157,50.72638803442766,35010.820313,36554.988281,54.35547559551506,-45.64452440448494,61.33340117552871,110.34013098066423,0.0030241628997267345,21203200.0
3809,BSESN,2019-01-08,35980.929688,36037.351563,35753.949219,35964.621094,16218000.0,130.76953199999843,0.0,130.76953199999843,54.85704192712076,35010.820313,36554.988281,62.82408359088556,-37.17591640911444,68.82560444183036,102.03722567289746,0.01440031329140945,37421200.0
3810,BSESN,2019-01-09,36212.910156,36250.539063,35863.289063,36181.371094,20300.0,231.9804680000016,0.0,231.9804680000016,61.46870573909272,35010.820313,36554.988281,77.8470909843404,-22.1529090156596,92.41679129216209,100.1131387967504,0.015791575744504627,37441500.0
3811,BSESN,2019-01-10,36106.5,36269.308594,36070.761719,36258.0,17331500.0,-106.4101559999981,106.4101559999981,0.0,57.046590949283335,35010.820313,36483.488281,74.40099946548185,-25.599000534518158,101.35817263311037,100.36214556402241,0.008356366067306498,20110000.0
3812,BSESN,2019-01-11,36009.839844,36214.261719,35840.601563,36191.871094,18100.0,-96.6601559999981,96.6601559999981,0.0,53.046712997788,35010.820313,36483.488281,67.83739123196602,-32.16260876803397,99.49766781894868,100.18925001500769,-0.0018537968062851684,20091900.0
3813,BSESN,2019-01-14,35853.558594,36124.941406,35691.75,36113.269531,24100.0,-156.28125,156.28125,0.0,46.91057533891848,35010.820313,36285.460938,66.11575564681263,-33.88424435318736,84.43925045379001,97.03925010276416,-0.005954518608560999,20067800.0
3814,BSESN,2019-01-15,36318.328125,36349.308594,35950.078125,35950.078125,24000.0,464.7695309999981,0.0,464.7695309999981,61.995678359016026,35010.820313,36349.308594,97.68541350419177,-2.3145864958082347,108.75470655284153,99.38234139277964,0.011891627871351673,20091800.0
3815,BSESN,2019-01-16,36321.289063,36462.03125,36278.609375,36370.738281,16400.0,2.9609379999965317,0.0,2.9609379999965317,62.07489321648041,35382.078125,36462.03125,86.96775038268412,-13.03224961731589,126.80210787770193,104.8662946897641,0.022739896892495226,20108200.0
3816,BSESN,2019-01-17,36374.078125,36468.421875,36170.800781,36413.601563,20500.0,52.78906200000347,0.0,52.78906200000347,63.634192343407996,35382.078125,36468.421875,91.31547910134337,-8.684520898656618,143.70786476894864,112.63460870560101,0.019021561286263422,20128700.0
3817,BSESN,2019-01-18,36386.609375,36469.980469,36218.328125,36417.578125,20800.0,12.53125,0.0,12.53125,64.0391696526529,35382.078125,36469.980469,92.33652777201831,-7.663472227981684,156.3150633046098,121.37069962540276,0.014963649162672343,20149500.0
3818,BSESN,2019-01-21,36578.960938,36701.03125,36351.769531,36467.121094,18700.0,192.35156299999653,0.0,192.35156299999653,69.9634628912008,35382.078125,36701.03125,90.74490899742904,-9.255091002570957,179.75541403990064,133.04764250830235,0.016620783709194953,20168200.0
3819,BSESN,2019-01-22,36444.640625,36650.46875,36282.929688,36649.921875,17300.0,-134.3203129999965,134.3203129999965,0.0,61.7648212016802,35382.078125,36701.03125,80.5610510229467,-19.438948977053297,185.3568557266408,143.50948515197004,0.006399112029431997,20150900.0
3820,BSESN,2019-01-23,36108.46875,36521.46875,36037.898438,36494.121094,14300.0,-336.171875,336.171875,0.0,46.14804181935522,35382.078125,36701.03125,55.07327070474927,-44.92672929525073,160.81599117092992,146.97078635576202,5.452619334467279e-05,20136600.0
3821,BSESN,2019-01-24,36195.101563,36258.28125,35996.679688,36146.550781,23100.0,86.63281299999653,0.0,86.63281299999653,49.913678131649746,35691.75,36701.03125,49.87227920859488,-50.12772079140512,146.6670368874402,146.91003646209765,0.005144752651013551,20159700.0
3822,BSESN,2019-01-25,36025.539063,36474.480469,35953.148438,36245.769531,23000.0,-169.5625,169.5625,0.0,43.1063941234396,35691.75,36701.03125,33.071957197262556,-66.92804280273744,120.383901344685,141.60480943861512,0.004796747540389834,20136700.0
3823,BSESN,2019-01-28,35656.699219,36124.261719,35565.148438,36099.621094,15000.0,-368.8398439999947,368.8398439999947,0.0,32.11376743744401,35565.148438,36701.03125,8.05987906787739,-91.94012093212261,68.9966833628132,127.08318422345474,-0.01821749348490964,20121700.0
3824,BSESN,2019-01-29,35592.5,35734.140625,35375.511719,35716.71875,16670300.0,-64.1992190000019,64.1992190000019,0.0,30.549182315014633,35375.511719,36701.03125,16.370055357562165,-83.62994464243783,22.828450284563587,106.2322374356765,-0.02006506602053404,3451400.0
3825,BSESN,2019-01-30,35591.25,35850.410156,35490.96875,35819.671875,18974200.0,-1.25,1.25,0.0,30.51578122760725,35375.511719,36701.03125,16.27575271088166,-83.72424728911834,-13.703110677422956,82.24516781305661,-0.02152159354554084,-15522800.0
3826,BSESN,2019-01-31,36256.691406,36278.128906,35740.070313,35805.511719,18611400.0,665.4414059999981,0.0,665.4414059999981,58.43243323794262,35375.511719,36701.03125,66.47806134815809,-33.52193865184191,10.915101704806148,67.97915459140651,-0.003570488463518817,3088600.0
3827,BSESN,2019-02-01,36469.429688,36778.140625,36221.320313,36311.738281,31815100.0,212.73828199999843,0.0,212.73828199999843,63.797761659423294,35375.511719,36778.140625,77.99054791474518,-22.00945208525482,47.049061517609516,63.793135976647115,-0.0029943783855875816,34903700.0
3828,BSESN,2019-02-04,36582.738281,36622.769531,36225.480469,36456.21875,15600.0,113.30859300000157,0.0,113.30859300000157,66.45842692895829,35375.511719,36778.140625,86.06884948940285,-13.931150510597146,83.86183447045914,67.80687567540953,0.0037892445537044406,34919300.0
3829,BSESN,2019-02-05,36616.808594,36727.828125,36495.828125,36573.039063,14104800.0,34.07031300000381,0.0,34.07031300000381,67.2924236902312,35375.511719,36778.140625,88.49788206204283,-11.502117937957163,114.46591990679008,77.13868452168565,0.0140781335126543,49024100.0
3830,BSESN,2019-02-06,36975.230469,37005.25,36680.878906,36714.539063,13931600.0,358.421875,0.0,358.421875,74.87548966385604,35375.511719,37005.25,98.1580152255135,-1.8419847744865072,165.73108319842868,94.85716425703427,0.02155343878900684,62955700.0
3831,BSESN,2019-02-07,36971.089844,37172.179688,36898.800781,37026.558594,14600.0,-4.140625,4.140625,0.0,74.64480678183736,35375.511719,37172.179688,88.80762347469694,-11.192376525303057,203.6771175927497,116.62115492417738,0.026246679594341904,62941100.0
3832,BSESN,2019-02-08,36546.480469,36885.578125,36480.621094,36873.589844,21600.0,-424.609375,424.609375,0.0,54.70320462897852,35375.511719,37172.179688,65.17446574459433,-34.825534255405685,197.21383693197276,132.7396913257365,0.024954111555168135,62919500.0
3833,BSESN,2019-02-11,36395.03125,36588.410156,36300.480469,36585.5,19200.0,-151.4492190000019,151.4492190000019,0.0,49.28449222262143,35375.511719,37172.179688,56.74501625180368,-43.25498374819632,177.8211427398346,141.7559816085561,0.022547762871391486,62900300.0
3834,BSESN,2019-02-12,36153.621094,36465.398438,36113.910156,36405.71875,12200.0,-241.4101559999981,241.4101559999981,0.0,41.68921757756929,35375.511719,37172.179688,43.30846814356506,-56.69153185643494,141.34319447259622,141.67342418136414,0.01580082447230713,62888100.0
3835,BSESN,2019-02-14,35876.21875,36109.101563,35799.421875,36065.078125,32500.0,-277.4023440000019,277.4023440000019,0.0,34.61606007913595,35375.511719,37172.179688,27.868645717477,-72.13135428252299,89.02389480484999,131.1435183060613,-0.010493860339860883,62855600.0
3836,BSESN,2019-02-15,35808.949219,36022.570313,35510.96875,35985.679688,23000.0,-67.2695309999981,67.2695309999981,0.0,33.04721303271907,35375.511719,37172.179688,24.12451869118847,-75.87548130881153,41.65224279388349,113.24526320362574,-0.018110523653659505,62832600.0
3837,BSESN,2019-02-18,35498.441406,35912.441406,35470.761719,35831.179688,15900.0,-310.5078130000038,310.5078130000038,0.0,26.621306867788135,35375.511719,37172.179688,6.842092647113729,-93.15790735288627,-20.706822841995745,86.45484599450144,-0.029639576640525855,62816700.0
3838,BSESN,2019-02-19,35352.609375,35776.039063,35287.160156,35543.238281,10100.0,-145.8320309999981,145.8320309999981,0.0,24.083558827788522,35287.160156,37172.179688,3.472071131833872,-96.52792886816613,-80.96098986905417,52.97167882179031,-0.034525106571061226,62806600.0
3839,BSESN,2019-02-20,35756.261719,35797.109375,35469.488281,35564.929688,12500.0,403.6523440000019,0.0,403.6523440000019,41.80212947874286,35287.160156,37172.179688,24.885766700904625,-75.11423329909537,-95.04585123932338,23.36817280956757,-0.03296717111802672,62819100.0
3840,BSESN,2019-02-21,35898.351563,35983.070313,35707.289063,35837.0,11400.0,142.08984399999463,0.0,142.08984399999463,46.841423007370956,35287.160156,37172.179688,32.42361135385832,-67.57638864614168,-93.6630530623006,-0.03807236480606947,-0.029015598012567034,62830500.0
3841,BSESN,2019-02-22,35871.480469,35941.691406,35795.789063,35906.011719,18400.0,-26.87109399999463,26.87109399999463,0.0,45.97279527609446,35287.160156,37172.179688,30.998103896570356,-69.00189610342964,-93.65584201121965,-18.761626294088792,-0.018469630764378464,62812100.0
3842,BSESN,2019-02-25,36213.378906,36242.179688,35901.058594,35983.800781,11800.0,341.8984369999962,0.0,341.8984369999962,57.53403238750498,35287.160156,37172.179688,49.13576407440646,-50.86423592559354,-65.30893989415199,-28.071089014101435,-0.004991130320845749,62823900.0
3843,BSESN,2019-02-26,35973.710938,36172.519531,35714.160156,35975.75,17900.0,-239.6679680000016,239.6679680000016,0.0,49.0451808995433,35287.160156,37172.179688,36.42141475699038,-63.57858524300962,-61.474379387684166,-34.751747088817986,-0.004976269335020045,62806000.0
3844,BSESN,2019-02-27,35905.429688,36371.109375,35735.328125,36138.828125,19300.0,-68.28125,68.28125,0.0,46.77641128248584,35287.160156,37172.179688,32.799104810548926,-67.20089518945107,-63.2164686844626,-40.44469140794691,0.0008142145136182943,62786700.0
3845,BSESN,2019-02-28,35867.441406,36085.851563,35829.148438,36025.71875,11900.0,-37.988281999998435,37.988281999998435,0.0,45.4274227664654,35287.160156,36885.578125,36.30347388818671,-63.69652611181329,-66.89134212570934,-45.7340215514994,0.0016334516447904512,62774800.0
3846,BSESN,2019-03-01,36063.808594,36140.671875,35952.410156,36018.488281,16700.0,196.3671880000038,0.0,196.3671880000038,53.43668352133804,35287.160156,36588.410156,59.68479830931825,-40.31520169068175,-53.34360299135733,-47.255937839470995,0.015926535521203045,62791500.0
3847,BSESN,2019-03-05,36442.539063,36457.441406,35926.941406,36141.070313,21200.0,378.7304689999947,0.0,378.7304689999947,64.9004782172282,35287.160156,36465.398438,98.05986824997763,-1.9401317500223634,-11.909255965954799,-40.18660146476776,0.03083024725102046,62812700.0
3848,BSESN,2019-03-06,36636.101563,36666.46875,36456.820313,36544.859375,15900.0,193.5625,0.0,193.5625,69.35036252648109,35287.160156,36666.46875,97.79837614786851,-2.2016238521314855,36.13015274015925,-24.92325062378236,0.02460659480888827,62828600.0
3849,BSESN,2019-03-07,36725.421875,36830.25,36590.878906,36744.019531,16800.0,89.32031200000347,0.0,89.32031200000347,71.28848219023871,35287.160156,36830.25,93.2066091026648,-6.793390897335196,80.48139353566512,-3.8423217918928585,0.023039228153653113,62845400.0
3850,BSESN,2019-03-08,36671.429688,36753.589844,36592.929688,36753.589844,14600.0,-53.99218700000347,53.99218700000347,0.0,68.27714629123817,35287.160156,36830.25,89.70764323169227,-10.292356768307735,110.00528073971509,18.927198714428737,0.0223004238615494,62830800.0
3851,BSESN,2019-03-11,37054.101563,37106.191406,36726.390625,36741.570313,14400.0,382.671875,0.0,382.671875,76.42209813397588,35287.160156,37106.191406,97.13639647477186,-2.8636035252281435,162.40944130426215,47.62364723239543,0.023215802623176574,62845200.0
3852,BSESN,2019-03-12,37535.660156,37586.628906,37230.851563,37249.648438,19500.0,481.5585930000016,0.0,481.5585930000016,82.82507165196179,35469.488281,37586.628906,97.59256662509132,-2.4074333749086696,240.03094271176815,86.10510632827,0.04341918521255672,62864700.0
3853,BSESN,2019-03-13,37752.171875,37797.289063,37478.871094,37608.289063,21000.0,216.5117190000019,0.0,216.5117190000019,84.94592570239267,35707.289063,37797.289063,97.84128287081356,-2.158717129186437,315.3817041026996,131.96042588315595,0.05143350749586495,62885700.0
3854,BSESN,2019-03-14,37754.890625,37907.78125,37693.691406,37840.640625,15600.0,2.71875,0.0,2.71875,84.97281189742591,35714.160156,37907.78125,93.03021723221997,-6.969782767780035,371.0399877667878,179.77633825988235,0.052622912173608816,62901300.0
3855,BSESN,2019-03-15,38024.320313,38254.769531,37760.230469,37760.230469,16300.0,269.42968799999653,0.0,269.42968799999653,87.5212322852976,35714.160156,38254.769531,90.9293722888824,-9.070627711117595,431.91149580256024,230.20336976841799,0.054362303800774114,62917600.0
3856,BSESN,2019-03-18,38095.070313,38369.589844,37952.101563,38132.960938,15900.0,70.75,0.0,70.75,88.13109609788029,35714.160156,38369.589844,89.66195443846355,-10.338045561536441,480.32465456788486,280.2276267283114,0.045346216056548316,62933500.0
3857,BSESN,2019-03-19,38363.46875,38396.058594,38078.230469,38218.589844,15100.0,268.39843700000347,0.0,268.39843700000347,90.22270835679757,35735.328125,38396.058594,98.77515425257447,-1.2248457474255308,534.1921083519046,331.02052305303005,0.047149317566706594,62948600.0
3858,BSESN,2019-03-20,38386.75,38489.808594,38316.210938,38433.859375,15600.0,23.28125,0.0,23.28125,90.39216949409463,35829.148438,38489.808594,96.12657806869485,-3.8734219313051454,572.165488286948,379.24951609981366,0.045236461289799745,62964200.0
3859,BSESN,2019-03-22,38164.609375,38564.710938,38089.359375,38452.46875,18200.0,-222.140625,222.140625,0.0,75.90757710849404,35926.941406,38564.710938,84.83182256273037,-15.16817743726963,577.675687799725,418.93475043979595,0.040717793107712286,62946000.0
3860,BSESN,2019-03-25,37808.910156,38016.761719,37667.398438,38016.761719,17000.0,-355.6992190000019,355.6992190000019,0.0,58.56799416002279,35926.941406,38564.710938,71.34697429661573,-28.653025703384266,547.0347304858151,444.5547464489998,0.02037044648665054,62929000.0
3861,BSESN,2019-03-26,38233.410156,38297.699219,37800.078125,37886.289063,14600.0,424.5,0.0,424.5,68.48209878759917,36456.820313,38564.710938,84.2828286216227,-15.717171378377303,550.6575162884692,465.7753004168937,0.01858898969939826,62943600.0
3862,BSESN,2019-03-27,38132.878906,38475.929688,38001.339844,38372.03125,18800.0,-100.53125,100.53125,0.0,64.27910584939806,36590.878906,38564.710938,78.12214894686647,-21.877851053133522,539.2009950080537,480.4604393351257,0.010084374278135355,62924800.0
3863,BSESN,2019-03-28,38545.71875,38593.648438,38148.441406,38208.300781,16000.0,412.8398440000019,0.0,412.8398440000019,72.32677052704453,36592.929688,38593.648438,97.60437652718572,-2.3956234728142842,557.0134403067859,495.7710395294578,0.020946375738573497,62940800.0
3864,BSESN,2019-04-01,38871.871094,39115.570313,38808.738281,38858.878906,19800.0,326.15234400000185,0.0,326.15234400000185,77.04168993203466,36726.390625,39115.570313,89.7998790034919,-10.200120996508112,590.6391791327769,514.7446674501217,0.02228970232796601,62960600.0
3865,BSESN,2019-04-02,39056.648438,39121.691406,38846.960938,38988.570313,19700.0,184.77734399999463,0.0,184.77734399999463,79.34244062605565,37230.851563,39121.691406,96.56010167964281,-3.439898320357189,624.9932734137328,536.794388642844,0.02524153695214104,62980300.0
3866,BSESN,2019-04-03,38877.121094,39270.140625,38826.558594,39167.050781,17000.0,-179.52734399999463,179.52734399999463,0.0,71.32889136474559,37478.871094,39270.140625,78.05916283404932,-21.940837165950683,630.4651742730202,555.5285457688792,0.013389100640176066,62963300.0
3867,BSESN,2019-04-04,38684.71875,38939.351563,38581.039063,38935.75,13000.0,-192.4023440000019,192.4023440000019,0.0,63.409345382195355,37667.398438,39270.140625,63.47373396991648,-36.52626603008352,612.219152641148,566.866667143333,0.00776228125590217,62950300.0
3868,BSESN,2019-04-05,38862.230469,38958.601563,38701.039063,38839.519531,15900.0,177.5117190000019,0.0,177.5117190000019,67.27703835831078,37667.398438,39270.140625,74.54923447397861,-25.450765526021385,605.107459115985,574.5148255378634,0.01827926724325346,62966200.0
3869,BSESN,2019-04-08,38700.53125,39041.25,38520.960938,38993.601563,10500.0,-161.6992190000019,161.6992190000019,0.0,60.549988076274104,37667.398438,39270.140625,64.46032433536993,-35.539675664630074,579.7407249624812,575.560005422787,0.02358230084710633,62955700.0
3870,BSESN,2019-04-09,38939.21875,38978.988281,38598.71875,38730.929688,15100.0,238.6875,0.0,238.6875,66.2908293210758,37667.398438,39270.140625,79.35276941705663,-20.64723058294336,572.300369429533,574.9080782241361,0.018460518983793417,62970800.0
3871,BSESN,2019-04-10,38585.351563,38950.449219,38542.28125,38898.601563,16200.0,-353.8671870000035,353.8671870000035,0.0,53.07786240788609,37667.398438,39270.140625,57.27391045457008,-42.72608954542993,531.7203680469684,566.2705361887026,0.011865683105526159,62954600.0
3872,BSESN,2019-04-11,38607.011719,38649.980469,38460.25,38621.578125,14500.0,21.66015600000537,0.0,21.66015600000537,53.729225072108676,37667.398438,39270.140625,58.625354010226935,-41.374645989773065,495.5953039888773,552.1354897487375,0.0015901368812847316,62969100.0
3873,BSESN,2019-04-12,38767.109375,38818.871094,38554.789063,38692.058594,17000.0,160.0976559999981,0.0,160.0976559999981,58.627348530001036,37667.398438,39270.140625,68.6143377219284,-31.385662278071607,474.4157043765299,536.591532674296,-0.0026950521302837593,62986100.0
3874,BSESN,2019-04-15,38905.839844,38976.578125,38780.078125,38805.539063,20900.0,138.7304690000019,0.0,138.7304690000019,62.58719223484647,37800.078125,39270.140625,75.21868757280741,-24.781312427192592,463.4823722429064,521.9697005880181,-0.003861278425858594,63007000.0
3875,BSESN,2019-04-16,39275.640625,39364.339844,39038.808594,39040.300781,14400.0,369.8007809999981,0.0,369.8007809999981,71.09596674362744,38001.339844,39364.339844,93.49235370506223,-6.507646294937778,479.13429828929657,513.4026201282738,0.01025074696339856,63021400.0
3876,BSESN,2019-04-18,39140.28125,39487.449219,39083.160156,39420.039063,14600.0,-135.359375,135.359375,0.0,64.86539105840086,38148.441406,39487.449219,74.07274508561804,-25.927254914381958,475.13908452748,505.7499130081151,0.01177629086420584,63006800.0
3877,BSESN,2019-04-22,38645.179688,39158.21875,38585.648438,39158.21875,14900.0,-495.1015620000034,495.1015620000034,0.0,47.351848200930036,38460.25,39487.449219,18.003293283266817,-81.99670671673319,427.0989595741703,490.0197223213261,-0.005585134419218263,62991900.0
3878,BSESN,2019-04-23,38564.878906,38832.609375,38518.261719,38771.269531,11600.0,-80.30078199999843,80.30078199999843,0.0,45.07432112805922,38460.25,39487.449219,10.18584360897941,-89.81415639102059,378.1877000401,467.65331786508096,-0.0035051804101526862,62980300.0
3879,BSESN,2019-04-24,39054.679688,39095.351563,38571.0,38672.628906,15200.0,489.8007819999984,0.0,489.8007819999984,58.96512392645559,38460.25,39487.449219,57.868977799524146,-42.131022200475854,374.6295083705045,449.0485559661657,0.0029651580516107945,62995500.0
3880,BSESN,2019-04-25,38730.859375,39262.21875,38663.980469,39101.78125,14400.0,-323.8203129999965,323.8203129999965,0.0,49.429103605367956,38460.25,39487.449219,26.344390649307876,-73.65560935069213,341.7406493772796,427.5869746483885,0.0037710635281480442,62981100.0
3881,BSESN,2019-04-26,39067.328125,39103.160156,38765.328125,38865.828125,17300.0,336.46875,0.0,336.46875,57.64199377905535,38460.25,39487.449219,59.10032968979495,-40.89967031020505,338.9193564409725,409.85345100690535,0.011923129646769892,62998400.0
3882,BSESN,2019-04-30,39031.550781,39105.878906,38753.460938,39056.921875,30900.0,-35.77734400000191,35.77734400000191,0.0,56.51589308248372,38460.25,39487.449219,55.61733015686775,-44.38266984313224,329.99257975935325,393.88127675739497,0.006821282532107675,62967500.0
3883,BSESN,2019-05-02,38981.429688,39189.949219,38882.988281,39036.511719,26200.0,-50.12109300000157,50.12109300000157,0.0,54.78581114439439,38460.25,39487.449219,50.7379365521106,-49.2620634478894,315.2398033762074,378.1529820811575,0.0019428919746518059,62941300.0
3884,BSESN,2019-05-03,38963.261719,39172.761719,38920.171875,39009.550781,14800.0,-18.167968999994628,18.167968999994628,0.0,54.09322672159378,38460.25,39487.449219,48.96924663646974,-51.03075336353026,298.6395872768626,362.25030312029855,-0.007953502502545118,62926500.0
3885,BSESN,2019-05-06,38600.339844,38719.328125,38509.789063,38719.328125,13400.0,-362.921875,362.921875,0.0,41.88793319879391,38460.25,39487.449219,13.638040353689332,-86.36195964631067,253.27938705911947,340.45611990806276,-0.013795031327221152,62913100.0
3886,BSESN,2019-05-07,38276.628906,38835.539063,38236.179688,38815.460938,15600.0,-323.7109380000038,323.7109380000038,0.0,33.99390709858922,38236.179688,39487.449219,3.23265427614743,-96.76734572385257,189.03129910437565,310.1711557473254,-0.009536785311272333,62897500.0
3887,BSESN,2019-05-08,37789.128906,38248.570313,37743.070313,38244.179688,13100.0,-487.5,487.5,0.0,25.6079942898359,37743.070313,39487.449219,2.64040070890432,-97.35959929109568,97.65138632952585,267.66720186376546,-0.020115452764440267,62884400.0
3888,BSESN,2019-05-09,37558.910156,37780.460938,37405.398438,37747.910156,15300.0,-230.21875,230.21875,0.0,22.57364896184332,37405.398438,39487.449219,7.3731015305145515,-92.62689846948545,6.579572772825486,215.44967604557743,-0.03829936755209362,62869100.0
3889,BSESN,2019-05-10,37462.988281,37721.980469,37370.390625,37632.359375,19700.0,-95.921875,95.921875,0.0,21.357028431424112,37370.390625,39487.449219,4.3738825303386015,-95.6261174696614,-72.49985605675465,157.859769625111,-0.032735423754072124,62849400.0
3890,BSESN,2019-05-13,37090.820313,37583.570313,36999.839844,37491.300781,17800.0,-372.1679680000016,372.1679680000016,0.0,17.205639435018725,36999.839844,39262.21875,4.021451435862827,-95.97854856413718,-163.319077161912,93.62400026770639,-0.05059234677313895,62831600.0
3891,BSESN,2019-05-14,37318.53125,37572.699219,36956.101563,37146.578125,17700.0,227.71093700000347,0.0,227.71093700000347,27.19639421129102,36956.101563,39262.21875,15.716013437785584,-84.28398656221442,-214.44757647606457,32.00968491895219,-0.0438880725137335,62849300.0
3892,BSESN,2019-05-15,37114.878906,37559.671875,37047.871094,37539.050781,19400.0,-203.6523440000019,203.6523440000019,0.0,24.184818382387945,36956.101563,39262.21875,6.885050937352966,-93.11494906264703,-268.3074415401352,-28.053740372865306,-0.0478830765556707,62829900.0
3893,BSESN,2019-05-16,37393.480469,37518.941406,37052.300781,37179.128906,15700.0,278.6015630000038,0.0,278.6015630000038,35.46508268085688,36956.101563,39262.21875,18.96603123490813,-81.03396876509187,-285.22308074941975,-79.48760844817622,-0.0402887535782076,62845600.0
3894,BSESN,2019-05-17,37930.769531,38001.128906,37415.359375,37494.421875,18800.0,537.2890619999962,0.0,537.2890619999962,51.5169451361282,36956.101563,39189.949219,43.631801183133106,-56.36819881686689,-252.365003038758,-114.06308736629259,-0.017346228445293876,62864400.0
3895,BSESN,2019-05-20,39352.671875,39412.558594,38570.039063,38701.179688,26400.0,1421.9023440000021,0.0,1421.9023440000021,72.4453258979397,36956.101563,39412.558594,97.56206934441582,-2.437930655584171,-110.31743319662928,-113.31395653235995,0.02811227111046155,62890800.0
3896,BSESN,2019-05-21,38969.800781,39571.730469,38884.851563,39449.449219,22700.0,-382.8710940000019,382.8710940000019,0.0,63.87830630702656,36956.101563,39571.730469,76.98719085802905,-23.012809141970944,-28.311846850832808,-96.31353459605452,0.03124369121968673,62868100.0
3897,BSESN,2019-05-22,39110.210938,39249.078125,38903.871094,39086.210938,15600.0,140.41015699999843,0.0,140.41015699999843,65.59968212527635,36956.101563,39571.730469,82.35531309730814,-17.644686902691863,47.46099653519923,-67.55862836980377,0.0413031362080718,62883700.0
3898,BSESN,2019-05-23,38811.390625,40124.960938,38651.609375,39591.769531,28100.0,-298.8203129999965,298.8203129999965,0.0,58.727302475758265,36956.101563,40124.960938,58.54753532570386,-41.45246467429614,82.44880046971957,-37.557142601899095,0.035992920102528636,62855600.0
3899,BSESN,2019-05-24,39434.71875,39476.96875,38824.261719,39076.28125,17100.0,623.328125,0.0,623.328125,67.03855020548534,36956.101563,40124.960938,78.21796090273028,-21.78203909726971,158.64549101135344,1.6833841207514246,0.06319349146825126,62872700.0
3900,BSESN,2019-05-27,39683.289063,39821.941406,39353.160156,39536.230469,16000.0,248.57031299999653,0.0,248.57031299999653,69.83370456058898,36956.101563,40124.960938,86.06211817146351,-13.937881828536492,236.36479784583935,48.61966686576903,0.06336685110028273,62888700.0
3901,BSESN,2019-05-28,39749.730469,39828.648438,39498.648438,39765.640625,15300.0,66.44140600000537,0.0,66.44140600000537,70.60256305915496,36956.101563,40124.960938,88.15881600930952,-11.841183990690487,299.862545868913,98.86824266639783,0.07099178660054983,62904000.0
3902,BSESN,2019-05-29,39502.050781,39767.929688,39420.5,39714.269531,12800.0,-247.6796880000038,247.6796880000038,0.0,63.627201179604654,36956.101563,40124.960938,80.34276427933952,-19.65723572066048,326.4363329312182,144.38186071936192,0.056388714972601894,62891200.0
3903,BSESN,2019-05-30,39831.96875,39911.921875,39500.558594,39580.28125,17500.0,329.91796900000185,0.0,329.91796900000185,68.42222996601402,36956.101563,40124.960938,90.75401735048604,-9.24598264951396,369.85442194093775,189.4763729636771,0.0501228749774294,62908700.0
3904,BSESN,2019-05-31,39714.199219,40122.339844,39374.238281,39998.910156,17100.0,-117.7695309999981,117.7695309999981,0.0,64.89833515304232,36956.101563,40124.960938,87.03755293653589,-12.962447063464108,390.26185761589295,229.63346989412028,0.009186856362596085,62891600.0
3905,BSESN,2019-06-03,40267.621094,40308.898438,39711.019531,39806.859375,34600.0,553.421875,0.0,553.421875,72.56079923898541,37047.871094,40308.898438,98.73422269592614,-1.265777304073863,445.9507746533491,272.8969308459661,0.033303231912665154,62926200.0
3906,BSESN,2019-06-04,40083.539063,40312.070313,40031.050781,40196.0,11900.0,-184.08203100000537,184.08203100000537,0.0,66.95155455777399,37052.300781,40312.070313,92.98934333373602,-7.010656666263978,469.8150259886461,312.2805498745021,0.024886803258181933,62914300.0
3907,BSESN,2019-06-06,39529.71875,40159.261719,39481.148438,40136.429688,18700.0,-553.8203129999965,553.8203129999965,0.0,52.786182852012146,37415.359375,40312.070313,72.991728213649,-27.008271786351003,438.9786734224108,337.6201745840839,0.01850817797127058,62895600.0
3908,BSESN,2019-06-07,39615.898438,39703.101563,39279.46875,39581.769531,14800.0,86.17968799999653,0.0,86.17968799999653,54.51411966663801,38570.039063,40312.070313,60.03677459861871,-39.963225401381294,416.6912649169899,353.43439265066513,0.004594420696863555,62910400.0
3909,BSESN,2019-06-10,39784.519531,39979.480469,39619.96875,39787.328125,16200.0,168.62109300000157,0.0,168.62109300000157,57.985578513366335,38651.609375,40312.070313,68.22865447016017,-31.771345529839834,407.9322569549986,364.33396551153186,0.0025509596202897278,62926600.0
3910,BSESN,2019-06-11,39950.460938,40066.308594,39760.019531,39900.449219,14200.0,165.94140699999843,0.0,165.94140699999843,61.336238040601636,38651.609375,40312.070313,78.22234978706854,-21.777650212931462,409.65847683713946,373.39886777665345,0.0050498573608326325,62940800.0
3911,BSESN,2019-06-12,39756.808594,39982.101563,39623.53125,39974.179688,11700.0,-193.65234399999463,193.65234399999463,0.0,55.3883073140349,38651.609375,40312.070313,66.55978431694997,-33.44021568305004,390.89440540762007,376.8979753028468,0.00644923005168474,62929100.0
3912,BSESN,2019-06-13,39741.359375,39800.808594,39461.269531,39679.351563,21800.0,-15.449219000001905,15.449219000001905,0.0,54.89825886950572,38824.261719,40312.070313,61.64083603888643,-38.35916396111357,370.5061564140342,375.61961152508434,-0.0022747902713194934,62907300.0
3913,BSESN,2019-06-14,39452.070313,39799.898438,39363.449219,39797.0,20600.0,-289.2890620000035,289.2890620000035,0.0,46.0881106099608,39279.46875,40312.070313,16.715214191477756,-83.28478580852224,327.23297454824933,365.9422841297174,-0.0066003825119203,62886700.0
3914,BSESN,2019-06-17,38960.789063,39540.421875,38911.488281,39514.359375,12700.0,-491.28125,491.28125,0.0,35.06228837397022,38911.488281,40312.070313,3.5200210250875537,-96.47997897491246,250.40980670983117,342.8357886457402,-0.03245366861750687,62874000.0
3915,BSESN,2019-06-18,39046.339844,39167.828125,38870.960938,39056.980469,17800.0,85.55078100000537,0.0,85.55078100000537,38.04060552547357,38870.960938,40312.070313,12.169715154341104,-87.8302848456589,194.19160581409233,313.10695207941063,-0.0258759391821618,62891800.0
3916,BSESN,2019-06-19,39112.738281,39435.800781,38881.050781,39176.558594,18500.0,66.39843699999618,0.0,66.39843699999618,40.48505888338396,38870.960938,40312.070313,16.777168145200747,-83.22283185479925,153.2297384819467,281.13150935991786,-0.010548531135198158,62910300.0
3917,BSESN,2019-06-20,39601.628906,39638.640625,38933.78125,39042.960938,20100.0,488.890625,0.0,488.890625,55.42548479927004,38870.960938,40312.070313,50.70177050232579,-49.29822949767421,158.39072147262777,256.58335178245983,-0.0003601971067835885,62930400.0
3918,BSESN,2019-06-21,39194.488281,39617.949219,39121.300781,39608.25,15600.0,-407.140625,407.140625,0.0,44.65395200888271,38870.960938,40312.070313,22.449881224317313,-77.55011877568269,128.15074978188204,230.89683138234426,-0.01483067426616147,62914800.0
3919,BSESN,2019-06-24,39122.960938,39300.019531,39021.699219,39160.230469,11600.0,-71.52734300000157,71.52734300000157,0.0,42.96147509873054,38870.960938,40312.070313,17.48652839067125,-82.51347160932875,97.29217195259116,204.17589949639364,-0.02071315275396235,62903200.0
3920,BSESN,2019-06-25,39434.941406,39490.640625,38946.039063,39131.941406,11300.0,311.9804680000016,0.0,311.9804680000016,52.098683315007925,38870.960938,40159.261719,43.77708034627042,-56.22291965372958,96.89381159114419,182.71948191534378,-0.008095901038912334,62914500.0
3921,BSESN,2019-06-26,39592.078125,39674.21875,39319.640625,39379.128906,15000.0,157.1367190000019,0.0,157.1367190000019,56.17841412990057,38870.960938,40066.308594,60.32698381766855,-39.67301618233146,108.01262579695322,167.7781106916657,-0.0037563196716896563,62929500.0
3922,BSESN,2019-06-27,39586.410156,39817.21875,39510.441406,39633.96875,13200.0,-5.667969000001904,5.667969000001904,0.0,55.97998085709606,38870.960938,40066.308594,59.85281473626769,-40.14718526373232,115.04088867845712,157.230666289024,0.003405140514406213,62916300.0
3923,BSESN,2019-06-28,39394.640625,39675.25,39361.921875,39630.519531,11200.0,-191.7695309999981,191.7695309999981,0.0,49.196133902128466,38870.960938,40066.308594,43.809822554251205,-56.19017744574879,103.93850084285077,146.57223319978934,0.011135594848925123,62905100.0
3924,BSESN,2019-07-01,39686.5,39764.820313,39541.089844,39543.730469,10800.0,291.859375,0.0,291.859375,58.11049924583571,38870.960938,39982.101563,73.39656598371637,-26.60343401628363,117.33779383953515,140.7253453277385,0.01639488255640864,62915900.0
3925,BSESN,2019-07-02,39816.480469,39838.488281,39499.191406,39811.679688,14800.0,129.9804690000019,0.0,129.9804690000019,61.57514079700075,38870.960938,39838.488281,97.72535503423016,-2.2746449657698364,136.86744492423168,139.95376524703713,0.017992659653335075,62930700.0
3926,BSESN,2019-07-03,39839.25,39934.988281,39732.378906,39907.570313,13800.0,22.769530999998093,0.0,22.769530999998093,62.20695430968694,38870.960938,39934.988281,91.00227248577409,-8.997727514225916,152.42508349003037,142.4480288956358,0.00600028586106971,62944500.0
3927,BSESN,2019-07-04,39908.058594,39979.101563,39858.328125,39917.648438,14500.0,68.8085940000019,0.0,68.8085940000019,64.25628845912888,38870.960938,39979.101563,93.58899336444824,-6.411006635551749,168.36608321548556,147.63163975960575,0.018205884150958918,62959000.0
3928,BSESN,2019-07-05,39513.390625,40032.410156,39441.378906,39990.398438,26000.0,-394.6679690000019,394.6679690000019,0.0,47.286536525208284,38870.960938,40032.410156,55.312765900024274,-44.687234099975726,147.45328395519755,147.5959685987241,0.00997955363395775,62933000.0
3929,BSESN,2019-07-08,38720.570313,39476.378906,38605.480469,39476.378906,22000.0,-792.8203120000035,792.8203120000035,0.0,29.331535087039597,38605.480469,40032.410156,8.0655581735048,-91.9344418264952,66.1433076919493,131.30543641736915,-0.018115180789676777,62911000.0
3930,BSESN,2019-07-09,38730.820313,38814.230469,38435.871094,38754.46875,18800.0,10.25,0.0,10.25,29.729566706931067,38435.871094,40032.410156,18.47428766512669,-81.52571233487332,2.502804264142469,105.54490998672381,-0.021753286333716648,62929800.0
3931,BSESN,2019-07-10,38557.039063,38854.851563,38474.660156,38701.988281,14900.0,-173.78125,173.78125,0.0,26.778952313796438,38435.871094,40032.410156,7.589414620911726,-92.41058537908827,-61.249402743560495,72.18604744066695,-0.026003143223735425,62914900.0
3932,BSESN,2019-07-11,38823.109375,38892.5,38631.308594,38751.621094,14600.0,266.07031200000347,0.0,266.07031200000347,37.70190500023506,38435.871094,40032.410156,24.254857912145404,-75.7451420878546,-89.27473203172849,39.89389154618786,-0.014507842714963193,62929500.0
3933,BSESN,2019-07-12,38736.230469,39021.839844,38684.851563,38941.101563,12900.0,-86.8789059999981,86.8789059999981,0.0,35.695653902791165,38435.871094,40032.410156,18.813155415297988,-81.18684458470202,-117.14503400926333,8.486106435097614,-0.023944402529827435,62916600.0
3934,BSESN,2019-07-15,38896.710938,39023.96875,38696.601563,39009.949219,18000.0,160.48046899999463,0.0,160.48046899999463,42.245939881355916,38435.871094,40032.410156,28.864927577950844,-71.13507242204915,-124.84389376933541,-18.179893605789,-0.02310022182186877,62934600.0
3935,BSESN,2019-07-16,39131.039063,39173.890625,38845.269531,38961.859375,25100.0,234.328125,0.0,234.328125,50.70584513889607,38435.871094,40032.410156,43.542183561055666,-56.45781643894434,-110.76019963526778,-36.695954811684764,-0.017776713592750903,62959700.0
3936,BSESN,2019-07-17,39215.640625,39284.730469,39081.140625,39171.101563,23400.0,84.60156200000347,0.0,84.60156200000347,53.540864159805025,38435.871094,40032.410156,48.84124350976888,-51.15875649023111,-91.71489928937808,-47.69974370722343,-0.0173503295673747,62983100.0
3937,BSESN,2019-07-18,38897.460938,39204.46875,38861.25,39204.46875,24100.0,-318.1796870000035,318.1796870000035,0.0,42.84723086974913,38435.871094,40032.410156,28.911904192419673,-71.08809580758033,-101.13003901507909,-58.385802768794576,-0.015587872294874794,62959000.0
3938,BSESN,2019-07-19,38337.011719,39058.730469,38271.351563,39058.730469,19200.0,-560.4492189999946,560.4492189999946,0.0,30.476067094587478,38271.351563,40032.410156,3.7284481198409116,-96.2715518801591,-152.06229371737572,-77.12110095851081,-0.00990580951931952,62939800.0
3939,BSESN,2019-07-22,38031.128906,38333.519531,37890.320313,38333.519531,23000.0,-305.8828130000038,305.8828130000038,0.0,25.787284261623682,37890.320313,40032.410156,6.5734214398215345,-93.42657856017847,-214.6344864018829,-104.62377804718525,-0.018065494129623327,62916800.0
3940,BSESN,2019-07-23,37982.738281,38217.808594,37898.898438,38138.558594,19300.0,-48.390625,48.390625,0.0,25.08286314170992,37890.320313,40032.410156,4.314383372014406,-95.6856166279856,-265.0725278338941,-136.71352800452706,-0.014894836220738394,62897500.0
3941,BSESN,2019-07-24,37847.648438,38102.839844,37708.410156,37990.230469,16600.0,-135.08984300000157,135.08984300000157,0.0,23.05430196137374,37708.410156,40032.410156,5.991320223752084,-94.00867977624792,-312.34514004604716,-171.8398504128311,-0.02512578082239203,62880900.0
3942,BSESN,2019-07-25,37830.980469,38169.871094,37775.511719,37935.019531,18000.0,-16.667968999994628,16.667968999994628,0.0,22.791880676119092,37708.410156,39476.378906,6.932832551480551,-93.06716744851946,-347.152236713162,-206.90232767289734,-0.023369594538230953,62862900.0
3943,BSESN,2019-07-26,37882.789063,37978.070313,37690.46875,37831.179688,24100.0,51.80859399999463,0.0,51.80859399999463,25.820187273498675,37690.46875,39284.730469,12.063283632039358,-87.93671636796064,-366.3337239057655,-238.78860691947102,-0.02606703370411334,62887000.0
3944,BSESN,2019-07-29,37686.371094,38043.21875,37519.160156,38043.21875,21100.0,-196.41796899999463,196.41796899999463,0.0,22.0387927853223,37519.160156,39284.730469,9.470647346572338,-90.52935265342767,-392.855881211588,-269.6020617778944,-0.03691872241557692,62865900.0
3945,BSESN,2019-07-30,37397.238281,37950.210938,37359.03125,37735.539063,22800.0,-289.1328130000038,289.1328130000038,0.0,17.64873486635588,37359.03125,39284.730469,1.9840601597085685,-98.01593984029144,-432.22308491031436,-302.1262664043784,-0.046369313748779284,62843100.0
3946,BSESN,2019-07-31,37481.121094,37576.371094,37128.261719,37257.550781,27200.0,83.88281300000382,0.0,83.88281300000382,22.796769201401432,37128.261719,39284.730469,16.362832756097205,-83.6371672439028,-451.44921002002957,-331.99085512750867,-0.03641214130293868,62870300.0
3947,BSESN,2019-08-01,37018.320313,37387.179688,36694.179688,37387.179688,21000.0,-462.8007810000053,462.8007810000053,0.0,16.30716052590104,36694.179688,39284.730469,12.512421195421428,-87.48757880457858,-498.286273931968,-365.24993888840055,-0.034397344677401076,62849300.0
3948,BSESN,2019-08-02,37118.21875,37375.160156,36607.410156,36920.109375,28100.0,99.8984370000035,0.0,99.8984370000035,21.848265113136335,36607.410156,39284.730469,19.079099034946186,-80.9209009650538,-521.3343971344075,-396.466830537602,-0.024004287599676655,62877400.0
3949,BSESN,2019-08-05,36699.839844,36844.050781,36416.789063,36842.171875,25900.0,-418.3789059999981,418.3789059999981,0.0,16.55248225753722,36416.789063,39284.730469,9.869475729449572,-90.13052427055042,-566.8258662515946,-430.5386376804006,-0.033775828048757006,62851500.0
3950,BSESN,2019-08-06,36976.851563,37241.769531,36536.589844,36568.03125,25400.0,277.01171899999457,0.0,277.01171899999457,29.590732382814522,36416.789063,39204.46875,20.090633174671453,-79.90936682532855,-573.9099756824216,-459.21290528080476,-0.02300795190555871,62876900.0
3951,BSESN,2019-08-07,36690.5,37104.789063,36610.570313,37025.269531,25300.0,-286.3515629999965,286.3515629999965,0.0,24.942433626344766,36416.789063,39058.730469,10.360219813292971,-89.63978018670703,-595.7627789723047,-486.5228800191047,-0.030146733044218887,62851600.0
3952,BSESN,2019-08-08,37327.359375,37405.480469,36655.410156,36808.011719,24100.0,636.859375,0.0,636.859375,46.50652011159815,36416.789063,38333.519531,47.50643490058002,-52.49356509941998,-555.291004866398,-500.2765049885635,-0.014661795019271229,62875700.0
3953,BSESN,2019-08-09,37581.910156,37807.550781,37406.261719,37521.300781,27400.0,254.5507809999981,0.0,254.5507809999981,52.76513283443707,36416.789063,38217.808594,64.6923074928052,-35.3076925071948,-496.9482021125805,-499.610844413367,-0.0027718492114682247,62903100.0
3954,BSESN,2019-08-13,36958.160156,37755.160156,36888.488281,37755.160156,28600.0,-623.75,623.75,0.0,39.64927932813791,36416.789063,38169.871094,30.881104445020686,-69.1188955549793,-495.3326363981905,-498.7552028103317,-0.011740923800329872,62874500.0
3955,BSESN,2019-08-14,37311.53125,37473.609375,37000.769531,37233.5,22500.0,353.3710940000019,0.0,353.3710940000019,48.08480882323977,36416.789063,38169.871094,51.03823843825599,-48.96176156174402,-460.23291631542816,-491.050745511351,-0.0045246737304009965,62897000.0
3956,BSESN,2019-08-16,37350.328125,37444.449219,36974.410156,37383.0,26100.0,38.796875,0.0,38.796875,48.9880739441464,36416.789063,38043.21875,57.39805842587289,-42.60194157412712,-424.39340865725535,-477.71927814053197,0.00896874329231534,62923100.0
3957,BSESN,2019-08-19,37402.488281,37718.878906,37358.488281,37485.921875,17700.0,52.1601559999981,0.0,52.1601559999981,50.32872613934389,36416.789063,38043.21875,60.60509260736332,-39.394907392636675,-387.3167060685737,-459.63876372614027,0.007658490643492888,62940800.0
3958,BSESN,2019-08-20,37328.011719,37511.550781,37219.898438,37441.75,20900.0,-74.47656199999618,74.47656199999618,0.0,48.24000532375672,36416.789063,37950.210938,59.42413310101015,-40.57586689898986,-359.79529210799956,-439.6700694025121,0.017116474558749317,62919900.0
3959,BSESN,2019-08-21,37060.371094,37406.550781,37022.519531,37298.730469,28500.0,-267.640625,267.640625,0.0,41.15740461359999,36416.789063,37807.550781,46.275506628519715,-53.724493371480285,-355.48294878152956,-422.83264527831557,0.0022586977384406737,62891400.0
3960,BSESN,2019-08-22,36472.929688,37087.578125,36391.351563,37087.578125,33100.0,-587.4414060000054,587.4414060000054,0.0,30.001799326548777,36391.351563,37807.550781,5.760356591299849,-94.23964340870015,-394.9146671806593,-417.2490496587844,-0.0059298813589350186,62858300.0
3961,BSESN,2019-08-23,36701.160156,36807.339844,36102.351563,36387.679688,38400.0,228.2304680000016,0.0,228.2304680000016,37.58560034417357,36102.351563,37807.550781,35.11663544523166,-64.88336455476833,-403.10159249985736,-414.4195582269991,-0.01677587778736367,62896700.0
3962,BSESN,2019-08-26,37494.121094,37544.480469,36492.648438,37363.949219,35600.0,792.9609380000038,0.0,792.9609380000038,56.48551918602123,36102.351563,37807.550781,81.61917483356505,-18.380825166434946,-341.6659566844173,-399.86883791848277,-0.002335939329203618,62932300.0
3963,BSESN,2019-08-27,37641.269531,37731.511719,37449.691406,37658.480469,36500.0,147.1484369999962,0.0,147.1484369999962,59.135101019801034,36102.351563,37807.550781,90.2485734074504,-9.7514265925496,-277.9006577898763,-375.4752018927615,0.01848331659683833,62968800.0
3964,BSESN,2019-08-28,37451.839844,37687.820313,37249.191406,37655.769531,28600.0,-189.4296869999962,189.4296869999962,0.0,54.230254016490306,36102.351563,37807.550781,79.13962584282655,-20.860374157173457,-239.8863313193433,-348.3574277780779,0.0037604619617428447,62940200.0
3965,BSESN,2019-08-29,37068.929688,37381.800781,36987.351563,37381.800781,31700.0,-382.9101560000053,382.9101560000053,0.0,45.439766467759796,36102.351563,37807.550781,56.684175948290815,-43.315824051709185,-237.91481924904656,-326.26890607227165,-0.007534028511295809,62908500.0
3966,BSESN,2019-08-30,37332.789063,37397.96875,36829.808594,37222.261719,33400.0,263.859375,0.0,263.859375,51.66882267454835,36102.351563,37807.550781,72.15799110224545,-27.842008897754557,-212.6102961825818,-303.53718409433367,-0.001863491473518053,62941900.0
3967,BSESN,2019-09-03,36562.910156,37188.378906,36466.011719,37181.761719,23600.0,-769.8789069999983,769.8789069999983,0.0,37.32312135604059,36102.351563,37755.160156,27.865210463605155,-72.13478953639485,-251.77674737344205,-293.18509675015537,-0.020496713534050026,62918300.0
3968,BSESN,2019-09-04,36724.738281,36776.308594,36409.539063,36575.238281,25600.0,161.828125,0.0,161.828125,41.27749139360552,36102.351563,37731.511719,38.20291797020842,-61.79708202979158,-266.68409662698105,-287.8848967255205,-0.009056380254496177,62943900.0
3969,BSESN,2019-09-05,36644.421875,36898.988281,36541.878906,36821.710938,27400.0,-80.3164059999981,80.3164059999981,0.0,39.83813891752085,36102.351563,37731.511719,33.27299099499961,-66.72700900500038,-281.7315155050892,-286.65422048143427,0.00470190325995179,62916500.0
3970,BSESN,2019-09-06,36981.769531,37012.980469,36727.660156,36785.589844,23000.0,337.34765599999815,0.0,337.34765599999815,48.535422189106704,36102.351563,37731.511719,53.97983523972205,-46.02016476027796,-263.3992641132427,-282.003229207796,0.007645790318541845,62939500.0
3971,BSESN,2019-09-09,37145.449219,37244.078125,36784.46875,36969.480469,25300.0,163.6796880000038,0.0,163.6796880000038,52.38875802759409,36102.351563,37731.511719,64.02671045927555,-35.973289540724444,-232.97761894739233,-272.19810715571526,-0.009299374537300342,62964800.0
3972,BSESN,2019-09-11,37270.820313,37343.460938,37193.570313,37251.03125,36700.0,125.37109399999464,0.0,125.37109399999464,55.34378143810334,36102.351563,37731.511719,71.72215363214396,-28.277846367856043,-196.4868681542357,-257.05585935541933,-0.00984157077101011,63001500.0
3973,BSESN,2019-09-12,37104.28125,37435.148438,37048.671875,37330.46875,27500.0,-166.53906299999653,166.53906299999653,0.0,50.53626109100826,36102.351563,37731.511719,61.49976620223704,-38.50023379776297,-178.94324941709783,-241.43333736775503,-0.009280147395901106,62974000.0
3974,BSESN,2019-09-13,37384.988281,37413.5,37000.089844,37175.859375,34300.0,280.7070309999981,0.0,280.7070309999981,57.68503226832294,36102.351563,37731.511719,78.72993414896634,-21.270065851033657,-140.76642600290506,-221.29995509478502,0.008526240052253664,63008300.0
3975,BSESN,2019-09-16,37123.308594,37302.058594,37028.941406,37204.558594,19900.0,-261.6796869999962,261.6796869999962,0.0,49.92401596036955,36409.539063,37731.511719,53.99276057340799,-46.00723942659201,-130.1263664390499,-203.065237363638,-0.005611165794403683,62988400.0
3976,BSESN,2019-09-17,36481.089844,37169.558594,36419.089844,37169.460938,20500.0,-642.21875,642.21875,0.0,36.15082554964437,36409.539063,37731.511719,5.412425187106524,-94.58757481289346,-171.5383412372903,-196.7598581383685,-0.0022377953956864705,62967900.0
3977,BSESN,2019-09-18,36563.878906,36712.988281,36465.921875,36621.378906,25400.0,82.78906199999618,0.0,82.78906199999618,38.6676478125504,36409.539063,37687.820313,12.074012898178829,-87.92598710182116,-195.42451208791317,-196.49278892827743,-0.004380136728795225,62993300.0
3978,BSESN,2019-09-19,36093.46875,36613.929688,35987.800781,36613.929688,31700.0,-470.4101559999981,470.4101559999981,0.0,30.726809364006172,35987.800781,37435.148438,7.300800777819065,-92.69919922218094,-249.4372850325526,-207.0816881491325,-0.015035115764123419,62961600.0
3979,BSESN,2019-09-20,38014.621094,38378.019531,36085.738281,36214.921875,61000.0,1921.1523440000021,0.0,1921.1523440000021,64.79527541533609,35987.800781,38378.019531,84.79643601657814,-15.20356398342186,-135.6580764503451,-192.79696580937505,0.02792866799232563,63022600.0
3980,BSESN,2019-09-23,39090.03125,39441.121094,38674.039063,38844.0,2800.0,1075.410155999998,0.0,1075.410155999998,73.28216997303075,35987.800781,39441.121094,89.83326734336441,-10.166732656635594,40.81884387417813,-146.07380387266443,0.052350478238538445,63025400.0
3981,BSESN,2019-09-24,39097.140625,39306.371094,38913.058594,39135.28125,30600.0,7.109375,0.0,7.109375,73.33121063823396,35987.800781,39441.121094,90.03913805200492,-9.960861947995078,179.1861949105005,-81.02180411603143,0.049001344662193747,63056000.0
3982,BSESN,2019-09-25,38593.519531,39087.199219,38510.96875,39087.199219,28800.0,-503.6210940000019,503.6210940000019,0.0,63.76465540999013,35987.800781,39441.121094,75.45546065306445,-24.544539346935547,245.37675366647454,-15.74209255953022,0.04013656189607495,63027200.0
3983,BSESN,2019-09-26,38989.738281,39158.070313,38676.109375,38700.480469,33200.0,396.21875,0.0,396.21875,67.60147188870079,35987.800781,39441.121094,86.92901983923194,-13.070980160768055,326.04633099759667,52.61559215189518,0.04292498336332429,63060400.0
3984,BSESN,2019-09-27,38822.570313,39107.371094,38782.601563,39003.128906,39200.0,-167.16796800000157,167.16796800000157,0.0,64.28762847743803,35987.800781,39441.121094,82.08823031354854,-17.91176968645146,372.19802711745433,116.53207914500703,0.045773444861394674,63021200.0
3985,BSESN,2019-09-30,38667.328125,38873.121094,38401.089844,38873.121094,49000.0,-155.24218799999653,155.24218799999653,0.0,61.0793305008307,35987.800781,39441.121094,77.59278320962399,-22.407216790376,391.73119822996523,171.57190296199872,0.05992798708450775,62972200.0
3986,BSESN,2019-10-01,38305.410156,38923.78125,37929.890625,38813.480469,75400.0,-361.9179690000019,361.9179690000019,0.0,53.850246290403135,35987.800781,39441.121094,67.11249362752054,-32.88750637247946,373.69984247787943,211.99749086517488,0.047629827636099575,62896800.0
3987,BSESN,2019-10-03,38106.871094,38310.929688,37957.558594,38137.871094,59200.0,-198.5390619999962,198.5390619999962,0.0,50.097181715874136,35987.800781,39441.121094,61.363271313778114,-38.636728686221886,339.4761503475893,237.4932227616578,0.05578301043731071,62837600.0
3988,BSESN,2019-10-04,37673.308594,38403.539063,37633.359375,38401.488281,52900.0,-433.5625,433.5625,0.0,42.61373608589042,35987.800781,39441.121094,48.80832532837802,-51.19167467162199,274.20785992815945,244.83615019495815,-0.008978453294484434,62784700.0
3989,BSESN,2019-10-07,37531.980469,37919.46875,37480.53125,37853.800781,40400.0,-141.328125,141.328125,0.0,40.34688438642774,35987.800781,39441.121094,44.71579662584292,-55.28420337415708,208.67282059751597,237.60348427546973,-0.03985800806951256,62744300.0
3990,BSESN,2019-10-09,38177.949219,38209.839844,37415.828125,37628.050781,36400.0,645.96875,0.0,645.96875,53.41587997326745,35987.800781,39441.121094,63.42152593708737,-36.57847406291264,206.47993712652533,231.37877484568088,-0.023510450925719018,62780700.0
3991,BSESN,2019-10-10,37880.398438,38130.230469,37802.929688,38130.230469,27300.0,-297.5507810000054,297.5507810000054,0.0,47.84477790150782,35987.800781,39441.121094,54.80515809307715,-45.19484190692286,178.67257367630373,220.8375346118055,-0.01847774190242457,62753400.0
3992,BSESN,2019-10-11,38127.078125,38345.410156,37737.851563,37994.480469,39400.0,246.67968700000347,0.0,246.67968700000347,52.57615626997403,36085.738281,39441.121094,60.83776301443431,-39.16223698556569,174.52817479449004,211.5756626483424,-0.02212531281392005,62792800.0
3993,BSESN,2019-10-14,38214.46875,38513.691406,38066.128906,38208.238281,28500.0,87.390625,0.0,87.390625,54.271870562356746,37415.828125,39441.121094,39.433338150298944,-60.566661849701056,176.26354547347728,204.5132392133694,-0.015663609031995707,62821300.0
3994,BSESN,2019-10-15,38506.089844,38635.191406,38238.269531,38316.488281,26200.0,291.62109400000185,0.0,291.62109400000185,59.805662215214994,37415.828125,39306.371094,57.66923772045727,-42.330762279542725,198.8776861766819,203.38612860603192,-0.0041698842102242395,62847500.0
3995,BSESN,2019-10-16,38598.988281,38666.378906,38416.671875,38637.050781,27500.0,92.8984369999962,0.0,92.8984369999962,61.51741477646528,37415.828125,39158.070313,67.91020009440848,-32.08979990559151,221.7396069307506,207.0568242709757,0.007664142579452804,62875000.0
3996,BSESN,2019-10-17,39052.058594,39104.691406,38557.429688,38647.441406,47100.0,453.0703130000038,0.0,453.0703130000038,68.95694716048857,37415.828125,39158.070313,93.91521341119109,-6.084786588808906,273.2667822687654,220.29881587053367,0.024803597694191826,62922100.0
3997,BSESN,2019-10-18,39298.378906,39361.058594,38963.601563,39087.828125,42400.0,246.3203119999962,0.0,246.3203119999962,72.3144547717587,37415.828125,39361.058594,96.777775744371,-3.222224255629,330.17240855047567,242.2735344065221,0.04313585327779812,62964500.0
3998,BSESN,2019-10-22,38963.839844,39426.46875,38924.851563,39233.398438,54500.0,-334.5390619999962,334.5390619999962,0.0,61.83411739294498,37415.828125,39426.46875,76.99096993029283,-23.009030069707165,344.3070634144824,262.6802402081142,0.038150381544151735,62910000.0
3999,BSESN,2019-10-23,39058.828125,39196.671875,38866.078125,39063.839844,41000.0,94.9882809999981,0.0,94.9882809999981,63.56413427272051,37415.828125,39426.46875,81.71524933750904,-18.284750662490968,359.0349087191644,281.95117391032426,0.023072975998449152,62951000.0
4000,BSESN,2019-10-24,39020.390625,39327.148438,38840.761719,39223.011719,36600.0,-38.4375,38.4375,0.0,62.24671361442986,37415.828125,39426.46875,79.80354520092321,-20.196454799076786,363.41601363058726,298.2441418543769,0.030094514155279084,62914400.0
4001,BSESN,2019-10-25,39058.058594,39241.609375,38718.269531,39201.671875,48600.0,37.66796900000191,0.0,37.66796900000191,63.111226608550204,37415.828125,39426.46875,81.67697641143613,-18.323023588563874,365.71186242865224,311.73768596923196,0.02441782887080346,62963000.0
4002,BSESN,2019-10-29,39831.839844,39917.011719,39254.121094,39293.488281,50500.0,773.78125,0.0,773.78125,76.08915921812296,37415.828125,39917.011719,96.59473717945713,-3.4052628205428705,425.0690874136999,334.4039662581256,0.04232352684478968,63013500.0
4003,BSESN,2019-10-30,40051.871094,40178.121094,39805.109375,40055.628906,37200.0,220.03125,0.0,220.03125,78.56360081022598,37415.828125,40178.121094,95.42952172644799,-4.570478273552016,484.2822940269107,364.37963181188263,0.04014381247907628,63050700.0
4004,BSESN,2019-10-31,40129.050781,40392.21875,40054.890625,40211.988281,87900.0,77.17968699999618,0.0,77.17968699999618,79.42535092450862,37737.851563,40392.21875,90.08547233823225,-9.914527661767753,531.3123050768336,397.76616646487287,0.03963996384726909,63138600.0
4005,BSESN,2019-11-01,40165.03125,40283.300781,40014.230469,40196.070313,57000.0,35.98046900000191,0.0,35.98046900000191,79.86084521673304,37737.851563,40392.21875,91.44099199565642,-8.559008004343587,564.9745755908589,431.2078482900701,0.028499717968030414,63195600.0
4006,BSESN,2019-11-04,40301.960938,40483.210938,40186.289063,40293.851563,62600.0,136.9296879999965,0.0,136.9296879999965,81.57350633516859,38066.128906,40483.210938,92.50128884330724,-7.498711156692763,595.8328586478165,464.13285036161943,0.025537491874678242,63258200.0
4007,BSESN,2019-11-05,40248.230469,40466.550781,40053.550781,40445.671875,45400.0,-53.73046899999463,53.73046899999463,0.0,78.54908529854072,38238.269531,40483.210938,89.53289077980845,-10.467109220191546,608.9332668360585,493.0929336565073,0.032963656306522315,63212800.0
4008,BSESN,2019-11-06,40469.78125,40606.910156,40037.53125,40311.851563,37700.0,221.5507809999981,0.0,221.5507809999981,81.76559759036162,38416.671875,40606.910156,93.73908733174963,-6.2609126682503735,629.9312755324136,520.4606020316885,0.03612379563678991,63250500.0
4009,BSESN,2019-11-07,40653.738281,40688.269531,40421.070313,40625.640625,30200.0,183.9570309999981,0.0,183.9570309999981,84.05607335119636,38557.429688,40688.269531,98.37945352329326,-1.620546476706742,653.8786378041186,547.1442091861745,0.041858823805662526,63280700.0
4010,BSESN,2019-11-08,40323.609375,40749.328125,40263.941406,40630.558594,42600.0,-330.12890599999815,330.12890599999815,0.0,66.70559364537397,38718.269531,40749.328125,79.03956334604891,-20.960436653951085,638.8541383895936,565.4861950268584,0.03240178407624206,63238100.0
4011,BSESN,2019-11-11,40345.078125,40417.441406,40150.96875,40316.5,29500.0,21.46875,0.0,21.46875,67.21341353206114,38718.269531,40749.328125,80.0965860269022,-19.903413973097795,621.5150247355996,576.6919609686066,0.012885126145567805,63267600.0
4012,BSESN,2019-11-13,40116.058594,40447.171875,40061.230469,40346.429688,37700.0,-229.0195309999981,229.0195309999981,0.0,56.589429420755245,38718.269531,40749.328125,68.82071581436624,-31.179284185633765,582.57809247978,577.8691872708413,0.0016026092725944796,63229900.0
4013,BSESN,2019-11-14,40286.480469,40348.609375,40026.988281,40178.929688,27800.0,170.421875,0.0,170.421875,61.77692571710495,38718.269531,40749.328125,77.21150648399276,-22.788493516007232,559.0277898009517,574.1009077768634,0.0039230852695508744,63257700.0
4014,BSESN,2019-11-15,40356.691406,40650.058594,40308.089844,40408.199219,25800.0,70.21093699999618,0.0,70.21093699999618,63.83149235469293,38718.269531,40749.328125,80.66837066346095,-19.33162933653905,539.8068833625439,567.2421028939996,0.004771816429247622,63283500.0
4015,BSESN,2019-11-18,40284.191406,40542.398438,40221.96875,40431.078125,28700.0,-72.5,72.5,0.0,59.989545664613935,39254.121094,40749.328125,68.89148396467094,-31.10851603532906,512.8126474536766,556.356211805935,-0.00044090986111899877,63254800.0
4016,BSESN,2019-11-19,40469.699219,40544.128906,40290.210938,40455.359375,39100.0,185.5078130000038,0.0,185.5078130000038,66.026627970292,39805.109375,40749.328125,70.38515640575893,-29.61484359424107,500.61764260822383,545.2084979663928,0.005502571104848419,63293900.0
4017,BSESN,2019-11-20,40651.640625,40816.378906,40575.960938,40729.800781,32300.0,181.9414059999981,0.0,181.9414059999981,70.98163037789142,40014.230469,40816.378906,79.46286829204419,-20.5371317079558,499.8719516255078,536.1411886982157,0.004493707882347486,63326200.0
4018,BSESN,2019-11-21,40575.171875,40744.851563,40534.121094,40737.308594,21800.0,-76.46875,76.46875,0.0,66.29272531552854,40014.230469,40816.378906,69.92987583419061,-30.070124165809382,487.4911031162628,526.4111715818251,-0.0019325751904276656,63304400.0
4019,BSESN,2019-11-22,40359.410156,40653.171875,40276.828125,40653.171875,21700.0,-215.7617190000019,215.7617190000019,0.0,54.5591275717621,40026.988281,40816.378906,42.111201282634944,-57.888798717365056,455.0237929039795,512.1336958462559,0.000887836717865742,63282700.0
4020,BSESN,2019-11-25,40889.230469,40931.710938,40393.898438,40439.660156,28600.0,529.8203130000038,0.0,529.8203130000038,69.73626730385695,40026.988281,40931.710938,95.30458658558888,-4.69541341441112,466.6658535421666,503.04012738543804,0.013487452975405656,63311300.0
4021,BSESN,2019-11-26,40821.300781,41120.28125,40710.199219,41022.851563,32800.0,-67.92968800000382,67.92968800000382,0.0,66.45277995582988,40026.988281,41120.28125,72.65321579142055,-27.346784208579443,465.0501042468313,495.4421227577168,0.01758004678718561,63278500.0
4022,BSESN,2019-11-27,41020.609375,41075.761719,40848.699219,40979.390625,32400.0,199.3085940000019,0.0,199.3085940000019,71.06504057615408,40026.988281,41120.28125,90.88333339496673,-9.116666605033277,474.38374857389135,491.2304479209517,0.01822271137745335,63310900.0
4023,BSESN,2019-11-28,41130.171875,41163.789063,40996.078125,41161.539063,30900.0,109.5625,0.0,109.5625,73.38591998376674,40026.988281,41163.789063,97.04282504619208,-2.9571749538079204,485.0303787609082,489.990434088943,0.019166102127118556,63341800.0
4024,BSESN,2019-11-29,40793.808594,41143.21875,40664.179688,41138.261719,46700.0,-336.36328099999815,336.36328099999815,0.0,57.148148783665675,40026.988281,41163.789063,67.45423869703187,-32.54576130296813,461.0119454799569,484.1947363671458,0.012650550258384907,63295100.0
4025,BSESN,2019-12-02,40802.171875,41093.988281,40707.628906,41072.941406,39800.0,8.363280999998096,0.0,8.363280999998096,57.418451952085036,40026.988281,41163.789063,68.18992441544634,-31.810075584553655,437.6075435820094,474.8772978101186,0.008215347838412157,63334900.0
4026,BSESN,2019-12-03,40675.449219,40885.03125,40554.039063,40852.609375,33700.0,-126.7226559999981,126.7226559999981,0.0,51.71516826138912,40026.988281,41163.789063,57.042618923885,-42.957381076115,404.1748510912221,460.7368084663393,0.0005856736317146893,63301200.0
4027,BSESN,2019-12-04,40850.289063,40886.871094,40475.828125,40606.011719,44500.0,174.83984399999463,0.0,174.83984399999463,58.307846414232365,40221.96875,41163.789063,66.71339578550784,-33.28660421449215,387.3225029221867,446.05394735750883,0.006780431857381863,63345700.0
4028,BSESN,2019-12-05,40779.589844,41002.410156,40720.171875,40988.140625,33000.0,-70.69921899999463,70.69921899999463,0.0,54.81580745243166,40221.96875,41163.789063,59.20673893980921,-40.793261060190794,364.0653408419239,429.6562260543918,0.010410947196103582,63312700.0
4029,BSESN,2019-12-06,40445.148438,40952.128906,40337.53125,40952.128906,33100.0,-334.4414060000054,334.4414060000054,0.0,41.31140490757248,40276.828125,41163.789063,18.977195701486142,-81.02280429851385,315.015938268014,406.72816849711626,-0.010860611117068708,63279600.0
4030,BSESN,2019-12-09,40487.429688,40645.628906,40336.558594,40527.238281,32600.0,42.28125,0.0,42.28125,43.347347338504356,40276.828125,41163.789063,23.744175642602805,-76.25582435739719,276.3698571828427,380.6565062342616,-0.008178845029735093,63312200.0
4031,BSESN,2019-12-10,40239.878906,40588.808594,40208.699219,40588.808594,31400.0,-247.55078199999843,247.55078199999843,0.0,35.11737744134736,40208.699219,41163.789063,3.264581567469413,-96.73541843253058,223.1944337550667,349.16409173842266,-0.019032639468194223,63280800.0
4032,BSESN,2019-12-11,40412.570313,40466.128906,40135.371094,40285.199219,55500.0,172.69140699999843,0.0,172.69140699999843,43.718509974351846,40135.371094,41163.789063,26.953945512011572,-73.04605448798841,192.7652036078871,317.88431411231556,-0.017447083960185905,63336300.0
4033,BSESN,2019-12-12,40581.710938,40712.648438,40490.691406,40561.339844,41300.0,169.140625,0.0,169.140625,51.05165635333037,40135.371094,41163.789063,43.40062673486765,-56.59937326513235,180.22058365088742,290.35156802002996,-0.0051992609493981545,63377600.0
4034,BSESN,2019-12-13,41009.710938,41055.800781,40736.699219,40754.820313,27900.0,428.0,0.0,428.0,64.54109399039791,40135.371094,41163.789063,85.01794701722089,-14.982052982779107,202.480832019035,272.777420819831,0.005086470976001012,63405500.0
4035,BSESN,2019-12-16,40938.71875,41185.03125,40917.929688,41168.851563,21600.0,-70.99218799999653,70.99218799999653,0.0,61.3075094682431,40135.371094,41185.03125,76.53407166195223,-23.465928338047775,211.95052919613954,260.6120424950927,0.006472443108926251,63383900.0
4036,BSESN,2019-12-17,41352.171875,41401.648438,41005.179688,41052.359375,19000.0,413.453125,0.0,413.453125,71.05319098313839,40135.371094,41401.648438,96.09275462169235,-3.9072453783076404,249.9364326346622,258.4769205230066,0.012285906012219128,63402900.0
4037,BSESN,2019-12-18,41558.570313,41614.769531,41358.46875,41442.75,24300.0,206.39843799999653,0.0,206.39843799999653,74.72075470344038,40135.371094,41614.769531,96.20121147931145,-3.7987885206885417,293.31402231857646,265.44434088212057,0.01910221441608262,63427200.0
4038,BSESN,2019-12-19,41673.921875,41719.289063,41456.398438,41571.820313,33300.0,115.3515620000035,0.0,115.3515620000035,76.63015824653732,40135.371094,41719.289063,97.13576151745794,-2.8642384825420644,333.1585374462229,278.98718019494106,0.03038123197603393,63460500.0
4039,BSESN,2019-12-20,41681.539063,41809.960938,41636.109375,41746.199219,33600.0,7.617187999996531,0.0,7.617187999996531,76.76388436858024,40135.371094,41809.960938,92.3311445211416,-7.668855478858405,361.1867105924248,295.42708627443784,0.029493336183648244,63494100.0
4040,BSESN,2019-12-23,41642.660156,41701.621094,41474.609375,41548.261719,6200.0,-38.878906999998435,38.878906999998435,0.0,74.2612912016508,40135.371094,41809.960938,90.00944723273989,-9.990552767260123,375.9285663668852,311.5273822929273,0.034860473941208614,63487900.0
4041,BSESN,2019-12-24,41461.261719,41702.980469,41423.070313,41684.511719,4400.0,-181.3984369999962,181.3984369999962,0.0,63.173703894466385,40135.371094,41809.960938,79.17703727576198,-20.822962724238028,368.72383655636804,322.96667314561546,0.025949633935128835,63483500.0
4042,BSESN,2019-12-26,41163.761719,41543.800781,41132.890625,41543.800781,5600.0,-297.5,297.5,0.0,49.25681352620048,40135.371094,41809.960938,61.41149301034476,-38.58850698965524,335.1449304477792,325.40232460604824,0.01434268707618691,63477900.0
4043,BSESN,2019-12-27,41575.140625,41611.269531,41264.921875,41297.078125,6100.0,411.3789059999981,0.0,411.3789059999981,62.45380087272306,40135.371094,41809.960938,85.97744314278802,-14.022556857211974,337.83390613536903,327.88864091191243,0.013787702328720064,63484000.0
4044,BSESN,2019-12-30,41558.0,41714.730469,41453.378906,41686.269531,5700.0,-17.140625,17.140625,0.0,61.68255656503274,40135.371094,41809.960938,84.9538716060673,-15.046128393932701,334.72335111984285,329.25558295349856,0.015127030569318967,63478300.0
4045,BSESN,2019-12-31,41253.738281,41607.488281,41184.730469,41607.488281,5600.0,-304.26171900000185,304.26171900000185,0.0,49.230618378506605,40135.371094,41809.960938,66.78454375004557,-33.215456249954435,304.20020534846117,324.2445074324911,-0.0023803730139627666,63472700.0
4046,BSESN,2020-01-02,41626.640625,41649.289063,41328.449219,41340.269531,5300.0,372.9023440000019,0.0,372.9023440000019,60.50539750857338,40490.691406,41809.960938,86.10440788986577,-13.895592110134228,306.5665863270333,320.70892321139956,0.0016379368079153522,63478000.0
4047,BSESN,2020-01-03,41464.609375,41636.179688,41348.679688,41634.511719,8900.0,-162.03125,162.03125,0.0,54.44356037738026,40736.699219,41809.960938,67.82224159436379,-32.17775840563622,292.00138240623346,314.96741505036636,-0.00502262543534604,63469100.0
4048,BSESN,2020-01-06,40676.628906,41378.339844,40613.960938,41378.339844,8700.0,-787.9804690000018,787.9804690000018,0.0,34.851035437825374,40613.960938,41809.960938,5.239796655518526,-94.76020334448148,214.40340593943984,294.85461322818105,-0.024109238276473377,63460400.0
4049,BSESN,2020-01-07,40869.46875,41230.140625,40727.371094,40983.039063,11900.0,192.8398440000019,0.0,192.8398440000019,40.86068822589948,40613.960938,41809.960938,21.363529431438415,-78.63647056856158,166.5471622923651,269.1931230410179,-0.01856729140509994,63472300.0
4050,BSESN,2020-01-08,40817.738281,40866.359375,40476.550781,40574.828125,18200.0,-51.7304690000019,51.7304690000019,0.0,39.72641218459222,40476.550781,41809.960938,25.587588200739976,-74.41241179926003,123.0283338475856,239.9601652023314,-0.015521077056492527,63454100.0
4051,BSESN,2020-01-09,41452.351563,41482.121094,41175.71875,41216.671875,7800.0,634.6132819999984,0.0,634.6132819999984,56.72915838197791,40476.550781,41809.960938,73.18084213453308,-26.81915786546693,138.154774697432,219.59908710135153,0.0070107743303446934,63461900.0
4052,BSESN,2020-01-10,41599.71875,41775.109375,41447.800781,41568.199219,13200.0,147.36718700000347,0.0,147.36718700000347,59.76992060367229,40476.550781,41809.960938,84.2327443737931,-15.767255626206902,160.18734840374236,207.71673936182967,0.0005911735866799273,63475100.0
4053,BSESN,2020-01-13,41859.691406,41899.628906,41720.761719,41788.210938,10600.0,259.9726559999981,0.0,259.9726559999981,64.80435647607598,40476.550781,41899.628906,97.19358345136533,-2.806416548634672,196.36239895537437,205.44587128053863,0.007259526589344922,63485700.0
4054,BSESN,2020-01-14,41952.628906,41994.261719,41770.898438,41883.089844,14100.0,92.9375,0.0,92.9375,66.5319499501345,40476.550781,41994.261719,97.25686809275643,-2.743131907243572,229.88074455616152,210.33284593566322,0.01694126772801785,63499800.0
4055,BSESN,2020-01-15,41872.730469,41969.859375,41648.109375,41969.859375,6100.0,-79.89843699999618,79.89843699999618,0.0,63.44285968030508,40476.550781,41994.261719,91.99246398262436,-8.007536017375642,247.1481685618346,217.69591046089752,0.0059118353127973755,63493700.0
4056,BSESN,2020-01-16,41932.558594,42059.449219,41812.28125,41924.738281,6600.0,59.828125,0.0,59.828125,64.85281674726457,40476.550781,42059.449219,91.98365340733253,-8.016346592667475,262.63288772797387,226.6833059143128,0.011285508920823029,63500300.0
4057,BSESN,2020-01-17,41945.371094,42063.929688,41850.289063,41929.019531,9500.0,12.8125,0.0,12.8125,65.18462042853,40476.550781,42063.929688,92.531172395124,-7.4688276048759885,272.79390259913635,235.90542525127753,0.03119093745285406,63509800.0
4058,BSESN,2020-01-20,41528.910156,42273.871094,41503.371094,42263.0,7500.0,-416.4609380000038,416.4609380000038,0.0,48.140065871730506,40476.550781,42273.871094,58.55157633218147,-41.44842366781854,244.42409409534594,237.60915902009123,0.01613530653001205,63502300.0
4059,BSESN,2020-01-21,41323.808594,41532.589844,41294.300781,41487.570313,8900.0,-205.1015619999962,205.1015619999962,0.0,41.91239571622486,40476.550781,42273.871094,47.140056609375335,-52.859943390624665,203.05019822376926,230.69736686082686,0.012398293837744934,63493400.0
4060,BSESN,2020-01-22,41115.378906,41532.289063,41059.039063,41467.128906,7700.0,-208.4296880000038,208.4296880000038,0.0,36.392075568153984,40476.550781,42273.871094,35.54336533000607,-64.45663466999393,151.6939206694151,214.8966776225445,-0.008129156592910358,63485700.0
4061,BSESN,2020-01-23,41386.398438,41413.960938,41098.910156,41191.5,9900.0,271.01953199999843,0.0,271.01953199999843,46.88765006637702,40476.550781,42273.871094,50.62245446285103,-49.377545537148976,131.34860695396492,198.18706348882858,-0.005127926784360803,63495600.0
4062,BSESN,2020-01-24,41613.191406,41697.03125,41275.601563,41377.039063,6600.0,226.7929680000016,0.0,226.7929680000016,54.18665843034869,40476.550781,42273.871094,63.24084898939199,-36.75915101060801,132.0034428640356,184.95033936387,-0.005888719952786503,63502200.0
4063,BSESN,2020-01-27,41155.121094,41516.269531,41122.480469,41510.679688,7000.0,-458.0703119999962,458.0703119999962,0.0,41.04204532513738,40476.550781,42273.871094,37.754556496797484,-62.245443503202516,94.47095673243894,166.8544628375838,-0.019009721983976546,63495200.0
4064,BSESN,2020-01-28,40966.859375,41333.25,40869.75,41299.679688,9800.0,-188.2617190000019,188.2617190000019,0.0,36.807825684017544,40869.75,42273.871094,6.916025648710884,-93.08397435128911,48.970541789080016,143.27767862788306,-0.02163391505291623,63485400.0
4065,BSESN,2020-01-29,41198.660156,41334.859375,41108.191406,41131.570313,7800.0,231.8007809999981,0.0,231.8007809999981,44.88590071579798,40869.75,42273.871094,23.424628930188103,-76.57537106981191,31.25523008372693,120.87318891905183,-0.01750187593143948,63493200.0
4066,BSESN,2020-01-30,40913.820313,41380.140625,40829.910156,41380.140625,6700.0,-284.8398430000016,284.8398430000016,0.0,37.998641836220536,40829.910156,42273.871094,5.811109898597424,-94.18889010140258,-5.702739270425809,95.5580032811563,-0.024592720343045493,63486500.0
4067,BSESN,2020-01-31,40723.488281,41154.488281,40671.011719,41146.558594,11500.0,-190.33203199999843,190.33203199999843,0.0,33.97884479585453,40671.011719,42273.871094,3.2739342464148606,-96.72606575358515,-49.77660682400892,66.49108126012325,-0.01939424540577872,63475000.0
4068,BSESN,2020-02-03,39872.308594,40014.898438,39563.070313,39701.019531,10600.0,-851.1796869999962,851.1796869999962,0.0,21.98032924327977,39563.070313,42273.871094,11.407635823608123,-88.59236417639188,-151.640533849466,22.864758238205386,-0.03512502959881458,63464400.0
4069,BSESN,2020-02-04,40789.378906,40818.941406,40117.460938,40178.738281,15300.0,917.0703119999962,0.0,917.0703119999962,45.78140012241993,39563.070313,42273.871094,45.23787220349038,-54.76212779650962,-156.56375054634555,-13.02094351870481,-0.007928906620204512,63479700.0
4070,BSESN,2020-02-05,41142.660156,41177.0,40703.320313,40921.710938,13900.0,353.28125,0.0,353.28125,52.25552887465741,39563.070313,42273.871094,58.27022974433762,-41.72977025566239,-130.45478926275246,-36.50771266751435,-0.005889332998258778,63493600.0
4071,BSESN,2020-02-06,41306.03125,41405.429688,41113.109375,41209.128906,15000.0,163.3710940000019,0.0,163.3710940000019,55.11531621494848,39563.070313,42273.871094,64.29690256902725,-35.70309743097274,-95.47993415722885,-48.30215696545726,-0.00738131697237987,63508600.0
4072,BSESN,2020-02-07,41141.851563,41394.410156,41073.359375,41394.410156,15300.0,-164.17968700000347,164.17968700000347,0.0,51.535896695125345,39563.070313,41697.03125,73.98360591452557,-26.01639408547442,-80.0868468220433,-54.65909493677447,-0.0003224272131212569,63493300.0
4073,BSESN,2020-02-10,40979.621094,41172.058594,40798.980469,41166.71875,15200.0,-162.23046899999463,162.23046899999463,0.0,47.98295412154522,39563.070313,41697.03125,66.38128919976585,-33.618710800234155,-80.0555269574761,-59.738381340914806,0.000311513237643668,63478100.0
4074,BSESN,2020-02-11,41216.140625,41444.339844,41179.140625,41183.390625,7700.0,236.5195309999981,0.0,236.5195309999981,53.388660216200854,39563.070313,41697.03125,77.46488154201863,-22.53511845798137,-60.25102000993502,-59.84090907471885,0.00042429702650070844,63485800.0
4075,BSESN,2020-02-12,41565.898438,41671.859375,41330.851563,41330.851563,9600.0,349.7578129999965,0.0,349.7578129999965,60.40890947030403,39563.070313,41697.03125,93.85495724282777,-6.145042757172234,-16.14713894266606,-51.1021550483083,0.01593784496317996,63495400.0
4076,BSESN,2020-02-13,41459.789063,41709.300781,41338.308594,41707.210938,9100.0,-106.109375,106.109375,0.0,57.383512864666976,39563.070313,41709.300781,88.37442102699656,-11.625578973003444,10.126631283172173,-38.85639778201221,0.01808049391347266,63486300.0
4077,BSESN,2020-02-14,41257.738281,41702.359375,41183.128906,41510.191406,9800.0,-202.05078199999843,202.05078199999843,0.0,51.69516754874326,39563.070313,41709.300781,78.9602045664371,-21.0397954335629,14.478079690503364,-28.189502287509093,0.03474666343268806,63476500.0
4078,BSESN,2020-02-17,41055.691406,41420.339844,41030.578125,41324.039063,6900.0,-202.046875,202.046875,0.0,46.38930279236725,39563.070313,41709.300781,69.54617014597336,-30.453829854026633,1.6046423493389739,-22.23067336013948,0.0065289667835768395,63469600.0
4079,BSESN,2020-02-18,40894.378906,41042.460938,40610.949219,41042.460938,12300.0,-161.3125,161.3125,0.0,42.38200583666128,39563.070313,41709.300781,62.03008543814972,-37.96991456185028,-21.36790419829049,-22.058119527769684,-0.00603464260839226,63457300.0
4080,BSESN,2020-02-19,41323.0,41357.160156,41048.929688,41121.511719,5600.0,428.6210940000019,0.0,428.6210940000019,54.44649427653823,39563.070313,41709.300781,82.00096463265763,-17.99903536734238,-4.930833120815805,-18.63266224637891,0.00041080562538908794,63462900.0
4081,BSESN,2020-02-20,41170.121094,41399.929688,41134.308594,41334.960938,8400.0,-152.8789059999981,152.8789059999981,0.0,50.126894512892584,39563.070313,41709.300781,74.87782905707981,-25.12217094292018,-4.192062434791296,-15.744542284061387,0.0006871234503560419,63454500.0
4082,BSESN,2020-02-24,40363.230469,41037.011719,40306.359375,41037.011719,8100.0,-806.890625,806.890625,0.0,33.79742160150019,40117.460938,41709.300781,15.439337825394858,-84.56066217460514,-67.93282400632597,-26.18219862851431,-0.015041393954963844,63446400.0
4083,BSESN,2020-02-25,40281.199219,40536.0,40220.589844,40497.71875,7300.0,-82.03125,82.03125,0.0,32.55344865057562,40220.589844,41709.300781,4.071265515261016,-95.92873448473898,-123.64180730017688,-45.67412036284683,-0.022683865879303156,63439100.0
4084,BSESN,2020-02-26,39888.960938,40255.390625,39760.390625,40194.890625,9000.0,-392.2382810000053,392.2382810000053,0.0,27.058647220541374,39760.390625,41709.300781,6.597036431062482,-93.40296356893751,-197.16908662953938,-75.97311361618536,-0.040344069610364186,63430100.0
4085,BSESN,2020-02-27,39745.660156,39947.800781,39423.269531,39947.800781,9600.0,-143.30078199999843,143.30078199999843,0.0,25.261202628933447,39423.269531,41709.300781,14.10263420502235,-85.89736579497766,-263.9603896639019,-113.57056882572869,-0.041344371154308224,63420500.0
4086,BSESN,2020-02-28,38297.289063,39087.46875,38219.96875,39087.46875,12700.0,-1448.3710930000016,1448.3710930000016,0.0,14.234139746098876,38219.96875,41709.300781,2.2159058614389733,-97.78409413856103,-428.82123689977743,-176.62070244053845,-0.07175500503291876,63407800.0
4087,BSESN,2020-03-02,38144.019531,39083.171875,37785.988281,38910.949219,13400.0,-153.26953199999843,153.26953199999843,0.0,13.5138475120185,37785.988281,41709.300781,9.125738773039364,-90.87426122696064,-565.3254959831611,-254.361661149063,-0.07092005457188522,63394400.0
4088,BSESN,2020-03-03,38623.699219,38754.238281,38142.300781,38480.890625,10600.0,479.6796880000038,0.0,479.6796880000038,26.876115180907817,37785.988281,41709.300781,21.352133891960015,-78.64786610803999,-627.5657751854378,-329.002483956338,-0.055525471904571355,63405000.0
4089,BSESN,2020-03-04,38409.480469,38791.699219,37846.101563,38715.71875,15300.0,-214.21875,214.21875,0.0,24.89419679145719,37785.988281,41709.300781,15.891983827441832,-84.10801617255817,-686.2664551850976,-400.45527820208997,-0.07050600225056258,63389700.0
4090,BSESN,2020-03-05,38470.609375,38887.800781,38386.679688,38604.25,13500.0,61.1289059999981,0.0,61.1289059999981,26.674569564852092,37785.988281,41702.359375,17.481006716877825,-82.51899328312217,-719.5599361286004,-464.27620978739213,-0.06556968129475382,63403200.0
4091,BSESN,2020-03-06,37576.621094,37747.070313,37011.089844,37613.960938,19000.0,-893.9882809999982,893.9882809999982,0.0,19.053131519869112,37011.089844,41420.339844,12.82601916425696,-87.17398083574304,-808.7597634304402,-533.1729205160018,-0.06903831389660908,63384200.0
4092,BSESN,2020-03-09,35634.949219,36950.199219,35109.179688,36950.199219,18800.0,-1941.671875,1941.671875,0.0,11.103027193393004,35109.179688,41399.929688,8.357819512776782,-91.64218048722323,-1024.3202362346783,-631.4023836597371,-0.11534537427099334,63365400.0
4093,BSESN,2020-03-11,35697.398438,36021.511719,35261.921875,35468.898438,27900.0,62.44921899999463,0.0,62.44921899999463,12.458588259426094,35109.179688,41399.929688,9.350534514962446,-90.64946548503755,-1176.5517773863103,-740.4322624050518,-0.105080764237379,63393300.0
4094,BSESN,2020-03-12,32778.140625,34472.5,32493.099609,34472.5,25200.0,-2919.2578129999965,2919.2578129999965,0.0,6.836062273672653,32493.099609,41399.929688,3.2002520927400684,-96.79974790725994,-1515.288773030632,-895.4035645301678,-0.1753026494880896,63368100.0
4095,BSESN,2020-03-13,34103.480469,34769.480469,29388.970702999995,31214.130859,32600.0,1325.339844000002,0.0,1325.339844000002,24.649624295475235,29388.970702999995,41037.011719,40.47470093489585,-59.52529906510415,-1657.6876421989073,-1047.8603800639157,-0.10950666996562275,63400700.0
4096,BSESN,2020-03-16,31390.070313,33103.238281,31276.300781,33103.238281,18100.0,-2713.4101560000017,2713.4101560000017,0.0,16.979968029168234,29388.970702999995,40536.0,17.95186463301536,-82.04813536698464,-1966.8170519438645,-1231.6517144399056,-0.1770644337183972,63382600.0
4097,BSESN,2020-03-17,30579.089844,32047.980469,30394.939452999995,31611.570313,21500.0,-810.9804690000018,810.9804690000018,0.0,15.334538927083486,29388.970702999995,40255.390625,10.952265323287424,-89.04773467671258,-2251.2921875680477,-1435.5798090655342,-0.2082816907149756,63361100.0
4098,BSESN,2020-03-18,28869.509766000006,31101.769531,28613.050781,30968.839844,31300.0,-1709.5800779999954,1709.5800779999954,0.0,12.409544152722873,28613.050781,39947.800781,2.262590573237212,-97.7374094267628,-2584.8925742642823,-1665.4423621052838,-0.24837541634283844,63329800.0
4099,BSESN,2020-03-19,28288.230469,29370.529297000005,26714.460938,27773.359375,33200.0,-581.2792970000047,581.2792970000047,0.0,11.545547206853783,26714.460938,39087.46875,12.71937717095493,-87.28062282904507,-2863.1727918153047,-1904.9884480472883,-0.264679428567019,63296600.0
4100,BSESN,2020-03-20,29915.960938,30418.199219,27932.669922000005,28460.820313,32100.0,1627.7304690000021,0.0,1627.7304690000021,27.789822341004083,26714.460938,39083.171875,25.88386143315041,-74.11613856684959,-2918.7224087021095,-2107.7352401782528,-0.20386772234886252,63328700.0
4101,BSESN,2020-03-23,25981.240234,27900.830077999995,25880.830078,27608.800781,21800.0,-3934.720704,3934.720704,0.0,18.376789105292502,25880.830078,38887.800781,0.7719718779472808,-99.22802812205272,-3242.863248363261,-2334.7608418152545,-0.27090564730909716,63306900.0
4102,BSESN,2020-03-24,26674.029297,27462.869141000006,25638.900391,27056.230469,24700.0,692.7890630000003,0.0,692.7890630000003,23.632001230487717,25638.900391,38887.800781,7.812942021824664,-92.18705797817533,-3404.5988157403626,-2548.7284366002764,-0.25277385848360845,63331600.0
4103,BSESN,2020-03-25,28535.779297000005,28790.189452999995,26359.910156,26499.810547,141500.0,1861.7500000000039,0.0,1861.7500000000039,36.34083648336217,25638.900391,38887.800781,21.865051594670533,-78.13494840532947,-3344.000199688344,-2707.7827892178902,-0.12942653997781473,63473100.0
4104,BSESN,2020-03-26,29946.769531,30099.910156,28566.339844,29073.710938,35000.0,1410.9902339999971,0.0,1410.9902339999971,44.428076315638485,25638.900391,37747.070313,35.578201889724056,-64.42179811027596,-3145.8567616112523,-2795.397583696563,-0.12188524106149345,63508100.0
4105,BSESN,2020-03-27,29815.589844,31126.029297000005,29346.990234,30747.810547000005,116900.0,-131.1796870000035,131.1796870000035,0.0,43.830753883640995,25638.900391,36950.199219,36.924932463644375,-63.075067536355625,-2965.230433173514,-2829.3641535919533,-0.05015855183822071,63391200.0
4106,BSESN,2020-03-30,28440.320313,29497.570313,28290.990234,29226.550781,23200.0,-1375.2695309999979,1375.2695309999979,0.0,37.69941811163421,25638.900391,36021.511719,26.981843329192955,-73.01815667080704,-2899.6303899112027,-2843.4174008558034,-0.06994222332682187,63368000.0
4107,BSESN,2020-03-31,29468.490234,29770.880859,28667.359375,29294.939452999995,26400.0,1028.169920999997,0.0,1028.169920999997,44.407761722216804,25638.900391,34769.480469,41.94245940876573,-58.05754059123427,-2733.170870695307,-2821.3680948237043,0.020747857267234382,63394400.0
4108,BSESN,2020-04-01,28265.310547000005,29505.980469,28073.429688,29505.330077999995,18000.0,-1203.1796869999926,1203.1796869999926,0.0,38.770841058297385,25638.900391,34769.480469,28.7649868197126,-71.2350131802874,-2667.5867680424453,-2790.611829467453,-0.0008102281980879589,63376400.0
4109,BSESN,2020-04-03,27590.949219,28639.119141000006,27500.789063,28623.529297000005,18900.0,-674.3613280000062,674.3613280000062,0.0,35.82957214229903,25638.900391,33103.238281,26.151667525865435,-73.84833247413457,-2639.5985682769024,-2760.409177229343,-0.07771810251452471,63357500.0
4110,BSESN,2020-04-07,30067.210938,30157.650391000006,28602.310547000005,28898.359375,21900.0,2476.2617190000024,0.0,2476.2617190000024,51.43850881292102,25638.900391,32047.980469,69.09432388277926,-30.905676117220743,-2390.0530487879187,-2686.3379515410584,0.15726619157514077,63379400.0
4111,BSESN,2020-04-08,29893.960938,31227.970702999995,29602.939452999995,29701.919922000005,24700.0,-173.25,173.25,0.0,50.447891286822895,25638.900391,31227.970702999995,76.13181279656092,-23.86818720343907,-2181.1236184328736,-2585.2950849194217,0.12071410753688205,63354700.0
4112,BSESN,2020-04-09,31159.619141000006,31225.199219,30420.220702999995,30571.189452999995,18800.0,1265.6582030000027,0.0,1265.6582030000027,57.36843223909223,25638.900391,31227.970702999995,98.77704952372429,-1.2229504762757217,-1891.61217254863,-2446.5585024452635,0.09194912172158021,63373500.0
4113,BSESN,2020-04-13,30690.019531,31195.720702999995,30474.150391000006,31195.720702999995,16100.0,-469.5996100000011,469.5996100000011,0.0,54.13182664428758,25638.900391,31227.970702999995,90.37494356002308,-9.625056439976918,-1680.6910693339269,-2293.385015822996,0.02481903763377913,63357400.0
4114,BSESN,2020-04-15,30379.810547000005,31568.359375,30222.070313,31277.109375,23600.0,-310.2089839999972,310.2089839999972,0.0,51.90000862650262,25638.900391,31568.359375,79.95518931478968,-20.044810685210322,-1521.0323339795686,-2138.914479454311,0.01892368073052042,63333800.0
4115,BSESN,2020-04-16,30602.609375,30800.199219,30016.169922000005,30095.509766000006,16900.0,222.7988279999954,0.0,222.7988279999954,53.48916513024338,25638.900391,31568.359375,83.71267930841631,-16.287320691583687,-1360.8367535169855,-1983.2989342668457,0.07602899820406117,63350700.0
4116,BSESN,2020-04-17,31588.720702999995,31718.730469,30960.939452999995,31656.679688,22200.0,986.1113279999954,0.0,986.1113279999954,60.20382417005506,26359.910156,31718.730469,97.57391070410382,-2.4260892958961757,-1141.1551329321446,-1814.8701739999058,0.07194907008007245,63372900.0
4117,BSESN,2020-04-20,31648.0,32056.470702999995,31490.259766000006,32056.189452999995,17200.0,59.2792970000046,0.0,59.2792970000046,60.598380401644505,27500.789063,32056.470702999995,91.03381809181916,-8.966181908180832,-951.3064534205805,-1642.1574298840408,0.11967635902585272,63390100.0
4118,BSESN,2020-04-21,30636.710938,30900.119141000006,30378.259766000006,30836.189452999995,19700.0,-1011.2890619999997,1011.2890619999997,0.0,50.70321160531439,27500.789063,32056.470702999995,68.83540428869836,-31.16459571130165,-872.3961430406343,-1488.2051725153597,0.11038988527812577,63370400.0
4119,BSESN,2020-04-22,31379.550781,31471.140625,30578.550781,30856.140625,21000.0,742.8398430000017,0.0,742.8398430000017,56.69635210407092,27500.789063,32056.470702999995,85.14119344827628,-14.858806551723717,-741.3721101897827,-1338.8385600502443,0.043646876516285626,63391400.0
4120,BSESN,2020-04-23,31863.080077999995,31959.019531,31292.919922000005,31646.449219,24400.0,483.5292969999937,0.0,483.5292969999937,60.31951847317006,27500.789063,32056.470702999995,95.75495742937822,-4.2450425706217745,-591.6971307289714,-1189.4102741859897,0.06587013156550059,63415800.0
4121,BSESN,2020-04-24,31327.220702999995,31842.240234,31278.269531,31426.619141000006,17600.0,-535.859375,535.859375,0.0,54.489710606520596,27500.789063,32056.470702999995,83.9925162110318,-16.0074837889682,-510.4340384935349,-1053.6150270474986,0.005378806500861755,63398200.0
4122,BSESN,2020-04-27,31743.080077999995,32103.699219,31651.580077999995,31659.039063,12900.0,415.859375,0.0,415.859375,58.114660332311544,27500.789063,32103.699219,92.16540995200769,-7.834590047992303,-407.7754942806605,-924.447120494131,0.034312801460953724,63411100.0
4123,BSESN,2020-04-28,32114.519531,32199.910156,31661.339844,32101.910156,15600.0,371.4394530000063,0.0,371.4394530000063,61.29212791948293,28602.310547000005,32199.910156,97.62645557370028,-2.373544426299721,-293.0674990679436,-798.1711962088935,0.057100717639968934,63426700.0
4124,BSESN,2020-04-29,32720.160156,32897.589844,32171.650391000006,32311.039063,16000.0,605.640625,0.0,605.640625,66.12663600566464,29602.939452999995,32897.589844,94.61461257058762,-5.38538742941238,-151.54354983783196,-668.8456669346813,0.06919510539287144,63442700.0
4125,BSESN,2020-04-30,33717.621094,33887.25,33354.929688,33381.191406,21100.0,997.4609380000003,0.0,997.4609380000003,72.62417645250574,30016.169922000005,33887.25,95.61804709326402,-4.381952906735976,40.633562702430936,-526.9498210072588,0.06739432125207356,63463800.0
4126,BSESN,2020-05-04,31715.349609,32748.140625,31632.019531,32748.140625,18300.0,-2002.271485000005,2002.271485000005,0.0,50.28368466898112,30016.169922000005,33887.25,43.89420143119029,-56.1057985688097,31.011255345620157,-415.357605736683,0.0021280842075328543,63445500.0
4127,BSESN,2020-05-05,31453.509766000006,32264.0,31403.570313,32182.900391000006,19200.0,-261.8398429999943,261.8398429999943,0.0,48.05322328371941,30016.169922000005,33887.25,37.13020177930826,-62.86979822069174,2.231497087774187,-331.8397851717916,0.02666078710776021,63426300.0
4128,BSESN,2020-05-06,31685.75,31970.839844,31158.75,31577.630859,19200.0,232.24023399999714,0.0,232.24023399999714,50.30899442060131,30016.169922000005,33887.25,43.129567055161225,-56.870432944838775,-1.8158902548420883,-265.83500618840174,0.00975792232135464,63445500.0
4129,BSESN,2020-05-07,31443.380859,31705.25,31362.869141000006,31677.689452999995,19900.0,-242.36914100000286,242.36914100000286,0.0,47.80902833117606,30378.259766000006,33887.25,30.35406262119555,-69.64593737880445,-24.300516768234957,-217.52810830436837,-0.013171960085860523,63425600.0
4130,BSESN,2020-05-08,31642.699219,32088.509766000006,31598.0,32083.320313,15900.0,199.3183600000011,0.0,199.3183600000011,50.15915755902434,30378.259766000006,33887.25,36.03428247671761,-63.96571752328239,-25.739708061992133,-179.1704282558931,0.010070427855408015,63441500.0
4131,BSESN,2020-05-11,31561.220702999995,32301.580077999995,31500.869141000006,32030.339844,18100.0,-81.47851600000286,81.47851600000286,0.0,49.11596905986283,30378.259766000006,33887.25,33.712289237451074,-66.28771076254894,-33.073660260095494,-149.9510746567336,-0.005729102990419621,63423400.0
4132,BSESN,2020-05-12,31371.119141000006,31536.890625,30844.660156,31342.929688,23100.0,-190.10156199999253,190.10156199999253,0.0,46.51181697505923,30578.550781,33887.25,23.954077041779154,-76.04592295822084,-53.60752336391306,-130.68236439816948,-0.023148420118270674,63400300.0
4133,BSESN,2020-05-13,32008.609375,32845.480469,31901.919922000005,32841.871094,18400.0,637.4902339999971,0.0,637.4902339999971,55.617128012017844,30844.660156,33887.25,38.25521278509858,-61.74478721490142,-18.230474099222192,-108.19198633838002,-0.021746555567195847,63418700.0
4134,BSESN,2020-05-14,31122.890625,31630.939452999995,31052.650391000006,31466.330077999995,15200.0,-885.71875,885.71875,0.0,43.693164258212214,30844.660156,33887.25,9.144527631572494,-90.8554723684275,-60.961284799548594,-98.74584603061373,-0.07695473122988883,63403500.0
4135,BSESN,2020-05-15,31097.730469,31296.279297000005,30770.480469,31296.279297000005,13000.0,-25.16015600000173,25.16015600000173,0.0,43.388269599472345,30770.480469,33887.25,10.499653463148533,-89.50034653685147,-95.75220266675387,-98.14711735784178,-0.019473824114009997,63390500.0
4136,BSESN,2020-05-18,30028.980469,31248.259766000006,29968.449219,31248.259766000006,19500.0,-1068.75,1068.75,0.0,32.330653519632946,29968.449219,33887.25,1.5446370811570984,-98.45536291884291,-207.17526136423476,-119.9527461591204,-0.04528999490352159,63371000.0
4137,BSESN,2020-05-19,30196.169922000005,30739.960938,30116.820313,30450.740234,18700.0,167.18945300000632,0.0,167.18945300000632,35.30663074277216,29968.449219,33887.25,5.810979320614926,-94.18902067938507,-278.7745075532657,-151.7170984379495,-0.047011040546617866,63389700.0
4138,BSESN,2020-05-20,30818.609375,30878.310547000005,30157.75,30159.589844,16100.0,622.4394529999953,0.0,622.4394529999953,45.58635732004846,29968.449219,33887.25,21.694395900958696,-78.3056040990413,-282.0405758944871,-177.78179392925702,-0.019869729874202546,63405800.0
4139,BSESN,2020-05-21,30932.900391000006,31188.789063,30765.320313,30904.289063,15500.0,114.29101600000286,0.0,114.29101600000286,47.35855626166509,29968.449219,32845.480469,33.522443386737876,-66.47755661326212,-272.26809168440013,-196.67905348028566,-0.022431677622931412,63421300.0
4140,BSESN,2020-05-22,30672.589844,31107.910156,30474.880859,30822.779297000005,20600.0,-260.3105470000046,260.3105470000046,0.0,43.62464370184521,29968.449219,32845.480469,24.474556020203085,-75.52544397979692,-282.27433040659525,-213.7981088655476,-0.02815578229252491,63400700.0
4141,BSESN,2020-05-26,30609.300781,31086.699219,30512.140625,30864.269531,188300.0,-63.28906299999653,63.28906299999653,0.0,42.68062357641117,29968.449219,32845.480469,22.274751516863176,-77.72524848313682,-291.94587482532734,-229.42766205750357,-0.0242840670291663,63212400.0
4142,BSESN,2020-05-27,31605.220702999995,31660.599609,30525.679688,30793.109375,20500.0,995.9199219999936,0.0,995.9199219999936,58.849187162391935,29968.449219,32845.480469,56.89098733286247,-43.10901266713752,-216.74967368529906,-226.8920643830627,-0.012602505384537777,63232900.0
4143,BSESN,2020-05-28,32200.589844,32267.230469,31641.769531,31827.800781,27500.0,595.3691410000029,0.0,595.3691410000029,65.55182828452598,29968.449219,32845.480469,77.5848585238689,-22.415141476131094,-107.87135472162481,-203.08792245077512,0.034627221230354444,63260400.0
4144,BSESN,2020-05-29,32424.099609,32480.519531,31823.800781,32041.289063,37100.0,223.5097649999989,0.0,223.5097649999989,67.822126836189,29968.449219,32845.480469,85.35362241894312,-14.646377581056882,-3.5086864769109525,-163.1720752560023,0.04265163791686355,63297500.0
4145,BSESN,2020-06-01,33303.519531,33673.828125,32876.550781,32906.050781,22900.0,879.4199220000011,0.0,879.4199220000011,75.23258658526866,29968.449219,33673.828125,90.00618820924431,-9.993811790755677,148.4500779937589,-100.84764460605005,0.10904596196265892,63320400.0
4146,BSESN,2020-06-02,33825.53125,33866.628906,33301.289063,33450.191406,75600.0,522.0117190000019,0.0,522.0117190000019,78.60695355415251,29968.449219,33866.628906,98.94572186764366,-1.054278132356347,307.45631175289964,-19.1868533342601,0.12019277071810874,63396000.0
4147,BSESN,2020-06-03,34109.539063,34488.691406,34027.5,34185.410156,18400.0,284.0078129999965,0.0,284.0078129999965,80.29250146687815,29968.449219,34488.691406,91.61212325989024,-8.387876740109757,451.18596360689844,74.88771005397165,0.10678384764075677,63414400.0
4148,BSESN,2020-06-04,33980.699219,34310.140625,33711.238281,34072.5,17900.0,-128.83984399999463,128.83984399999463,0.0,77.11226272082948,29968.449219,34488.691406,88.76183695508712,-11.23816304491289,548.3751225055348,169.5851925442843,0.09852935836843679,63396500.0
4149,BSESN,2020-06-05,34287.238281,34405.429688,33958.019531,34198.550781,24600.0,306.5390619999962,0.0,306.5390619999962,79.3568861162444,29968.449219,34488.691406,95.54331125045977,-4.456688749540224,642.7244442807569,264.2130428915789,0.11784620911973875,63421100.0
4150,BSESN,2020-06-08,34370.578125,34927.800781,34211.828125,34841.171875,25700.0,83.3398440000019,0.0,83.3398440000019,79.97301416743885,30116.820313,34927.800781,88.41769032931359,-11.582309670686412,715.9685506712522,354.56414444751357,0.12288021117864689,63446800.0
4151,BSESN,2020-06-09,33956.691406,34811.289063,33881.191406,34520.789063,19200.0,-413.8867190000019,413.8867190000019,0.0,68.29287806756082,30157.75,34927.800781,79.64152962756476,-20.35847037243523,732.1777441832164,430.0868643946541,0.07440133783899827,63427600.0
4152,BSESN,2020-06-10,34247.050781,34350.171875,33949.460938,34029.140625,15500.0,290.359375,0.0,290.359375,71.64511424858335,30474.880859,34927.800781,84.71227841675972,-15.287721583240286,759.6959200779711,496.0086755313176,0.06355352330234787,63443100.0
4153,BSESN,2020-06-11,33538.371094,34219.390625,33480.421875,34214.691406,20900.0,-708.6796869999962,708.6796869999962,0.0,55.20752561639878,30474.880859,34927.800781,68.79733497709198,-31.202665022908015,716.0653886100081,540.0200181470557,0.03436553361348271,63422200.0
4154,BSESN,2020-06-12,33780.890625,33856.269531,32348.099609,32436.689452999995,23000.0,242.5195309999981,0.0,242.5195309999981,58.928343303909585,30512.140625,34927.800781,74.02630375796522,-25.973696242034766,693.0679218290097,570.6295988834465,0.01433395330951881,63445200.0
4155,BSESN,2020-06-15,33228.800781,33670.550781,32923.738281,33670.550781,18400.0,-552.0898440000019,552.0898440000019,0.0,48.373499934116786,30525.679688,34927.800781,61.40496901137833,-38.595030988621666,623.1103985125155,581.1257588092603,-0.017641421936277824,63426800.0
4156,BSESN,2020-06-16,33605.21875,34022.011719,32953.300781,33853.71875,27400.0,376.4179690000019,0.0,376.4179690000019,54.74964317807442,31641.769531,34927.800781,59.75138608313601,-40.24861391686399,591.2270441703877,583.1460158814858,-0.014785315980627045,63454200.0
4157,BSESN,2020-06-17,33507.921875,33933.660156,33332.960938,33438.308594,20200.0,-97.296875,97.296875,0.0,52.804581239012165,31823.800781,34927.800781,54.256478543814445,-45.74352145618556,551.7480039402872,576.8664134932461,-0.013913114057866438,63434000.0
4158,BSESN,2020-06-18,34208.050781,34276.011719,33371.519531,33371.519531,21200.0,700.1289059999982,0.0,700.1289059999982,63.55484209226931,32348.099609,34927.800781,72.09948160615866,-27.900518393841345,570.3801443646735,575.5691596675316,-0.0023095327582530745,63455200.0
4159,BSESN,2020-06-19,34731.730469,34848.371094,34136.390625,34335.378906,27900.0,523.6796880000038,0.0,523.6796880000038,69.54240850374688,32348.099609,34927.800781,92.39949517687793,-7.600504823122063,620.2529344024151,584.5059146145084,0.010507601666941868,63483100.0
4160,BSESN,2020-06-22,34911.320313,35213.519531,34794.398438,34892.03125,25100.0,179.58984399999463,0.0,179.58984399999463,71.40156812414305,32348.099609,35213.519531,89.45358006064697,-10.546419939353022,666.5849035043284,600.9217123924724,0.02811313079905431,63508200.0
4161,BSESN,2020-06-23,35430.429688,35482.160156,34843.691406,35015.730469,25200.0,519.109375,0.0,519.109375,76.2389627855818,32348.099609,35482.160156,98.34941070141356,-1.6505892985864388,736.6989046126109,628.0771508365001,0.034554184375389374,63533400.0
4162,BSESN,2020-06-24,34868.980469,35706.550781,34794.929688,35679.738281,26600.0,-561.4492189999946,561.4492189999946,0.0,62.95067036601934,32348.099609,35706.550781,75.06081615886012,-24.93918384113988,738.4481255651117,650.1513457822225,0.03967423973187678,63506800.0
4163,BSESN,2020-06-25,34842.101563,35081.609375,34499.78125,34525.390625,24600.0,-26.87890600000537,26.87890600000537,0.0,62.35035406745557,32348.099609,35706.550781,74.26047979476171,-25.739520205238293,729.2590483334207,665.9728862924621,0.0314145340269576,63482200.0
4164,BSESN,2020-06-26,35171.269531,35254.878906,34910.339844,35144.78125,24800.0,329.1679680000016,0.0,329.1679680000016,66.82124200816378,32348.099609,35706.550781,84.06166346967511,-15.93833653032489,740.0073978261571,680.7797885992012,0.05845738348495222,63507000.0
4165,BSESN,2020-06-29,34961.519531,35032.359375,34662.058594,34926.949219,18300.0,-209.75,209.75,0.0,61.45554355202156,32348.099609,35706.550781,77.8162250441079,-22.183774955892098,723.263142895099,689.2764594583808,0.040359825986849174,63488700.0
4166,BSESN,2020-06-30,34915.800781,35233.910156,34812.800781,35168.300781,18500.0,-45.71875,45.71875,0.0,60.23899424405291,32348.099609,35706.550781,76.45492045283781,-23.545079547162185,698.2550298534479,691.0721735373943,0.04201630024243319,63470200.0
4167,BSESN,2020-07-01,35414.449219,35467.230469,34927.199219,35009.589844,19400.0,498.6484380000038,0.0,498.6484380000038,68.16890430890037,32348.099609,35706.550781,91.30249192141608,-8.697508078583922,710.4826795917106,694.9542747482576,0.035266506288925026,63489600.0
4168,BSESN,2020-07-02,35843.699219,36014.921875,35595.359375,35604.0,20600.0,429.25,0.0,429.25,73.43192155413901,32923.738281,36014.921875,94.46093540570214,-5.539064594297857,746.2082435793345,705.205068514473,0.032015932836761296,63510200.0
4169,BSESN,2020-07-03,36021.421875,36110.210938,35872.378906,36025.378906,16500.0,177.7226559999981,0.0,177.7226559999981,75.37686488102057,32953.300781,36110.210938,97.18746943738265,-2.812530562617357,779.871866058762,720.1384280233309,0.0317977536239622,63526700.0
4170,BSESN,2020-07-06,36487.28125,36661.660156,36254.019531,36313.460938,22300.0,465.859375,0.0,465.859375,79.84048172493172,33332.960938,36661.660156,94.76134986732832,-5.238650132671675,834.5216416075054,743.0150707401659,0.029828923084101122,63549000.0
4171,BSESN,2020-07-07,36674.519531,36723.269531,36271.089844,36660.351563,20600.0,187.2382809999981,0.0,187.2382809999981,81.40382681472133,33371.519531,36723.269531,98.54553591407473,-1.4544640859252629,882.7645862726713,770.9649738466671,0.05178066687683036,63569600.0
4172,BSESN,2020-07-08,36329.011719,36828.429688,36234.171875,36738.378906,24800.0,-345.5078119999962,345.5078119999962,0.0,69.86764843396861,34136.390625,36828.429688,81.44833870116857,-18.55166129883143,882.9398931154865,793.3599577004311,0.04267567366197578,63544800.0
4173,BSESN,2020-07-09,36737.691406,36806.300781,36422.300781,36450.691406,17400.0,408.6796869999962,0.0,408.6796869999962,74.75115470742789,34499.78125,36828.429688,96.10339282996576,-3.8966071700342506,905.6164772901684,815.8112616183787,0.044536972815819365,63562200.0
4174,BSESN,2020-07-10,36594.328125,36748.890625,36401.109375,36555.128906,20900.0,-143.3632809999981,143.3632809999981,0.0,70.14938005373617,34499.78125,36828.429688,89.94689111590158,-10.05310888409841,901.626229059053,832.9742551065136,0.04670302137617921,63541300.0
4175,BSESN,2020-07-13,36693.691406,37024.199219,36533.960938,36880.660156,16500.0,99.3632809999981,0.0,99.3632809999981,71.55001630464817,34499.78125,37024.199219,86.9075637608883,-13.092436239111699,896.1514389969598,845.6096918846029,0.05091937132278135,63557800.0
4176,BSESN,2020-07-14,36033.058594,36538.101563,35877.421875,36517.28125,14100.0,-660.6328119999963,660.6328119999963,0.0,52.61185711803249,34499.78125,37024.199219,60.737855728676315,-39.262144271323685,828.9494681734213,842.2776471423666,0.017467711305477973,63543700.0
4177,BSESN,2020-07-15,36051.808594,36810.25,35894.960938,36314.761719,23500.0,18.75,0.0,18.75,53.01908595713755,34662.058594,37024.199219,58.83434649450644,-41.16565350549356,768.3473603410384,827.491589782101,0.005806023918694336,63567200.0
4178,BSESN,2020-07-16,36471.679688,36524.621094,36038.410156,36401.199219,18500.0,419.8710939999947,0.0,419.8710939999947,61.55534227397782,34662.058594,37024.199219,76.60937180655765,-23.39062819344235,745.6049715567933,811.1142661370395,0.012499723485720926,63585700.0
4179,BSESN,2020-07-17,37020.140625,37125.980469,36512.921875,36547.75,16500.0,548.4609370000035,0.0,548.4609370000035,69.82026860123933,34812.800781,37125.980469,95.42448671198942,-4.575513288010582,763.0418075513953,801.4997744199108,0.014603975871729347,63602200.0
4180,BSESN,2020-07-20,37418.988281,37478.871094,37185.78125,37409.03125,20100.0,398.8476559999981,0.0,398.8476559999981,74.43240475897431,34927.199219,37478.871094,97.65319304622567,-2.3468069537743292,799.8244201904599,801.1647035740207,0.020299345690697246,63622300.0
4181,BSESN,2020-07-21,37930.328125,37990.550781,37742.050781,37823.609375,22700.0,511.3398440000019,0.0,511.3398440000019,79.14665803955634,35595.359375,37990.550781,97.48568503339068,-2.5143149666093176,860.3185410650476,812.9954710722262,0.044078171418093115,63645000.0
4182,BSESN,2020-07-22,37871.519531,38199.269531,37601.621094,38178.070313,22300.0,-58.8085940000019,58.8085940000019,0.0,77.25633426896958,35872.378906,38199.269531,85.91467959522163,-14.085320404778374,893.2187360629105,829.040124070363,0.030862802794811017,63622700.0
4183,BSESN,2020-07-23,38140.46875,38225.03125,37738.589844,37814.921875,19600.0,268.9492190000019,0.0,268.9492190000019,79.80193755237183,35877.421875,38225.03125,96.39793140628431,-3.6020685937156816,930.2707497727679,849.2862492108441,0.04225082695106863,63642300.0
4184,BSESN,2020-07-24,38128.898438,38235.730469,37748.410156,37949.589844,19900.0,-11.570312000003467,11.570312000003467,0.0,79.36101717180307,35877.421875,38235.730469,95.46997236613534,-4.530027633864667,947.7757413258223,868.9841476338398,0.03911318204865366,63622400.0
4185,BSESN,2020-07-27,37934.730469,38275.339844,37769.441406,38275.339844,18600.0,-194.16796899999463,194.16796899999463,0.0,71.6910723631394,35877.421875,38275.339844,85.79562022540564,-14.204379774594356,935.2004324363224,882.2274045943363,0.0527757550761081,63603800.0
4186,BSESN,2020-07-28,38492.949219,38554.71875,37998.128906,38052.179688,15500.0,558.21875,0.0,558.21875,78.56354139697112,35877.421875,38554.71875,97.69283968555045,-2.3071603144495545,959.2206983213473,897.6260633397385,0.06771201557433848,63619300.0
4187,BSESN,2020-07-29,38071.128906,38617.03125,37884.410156,38427.148438,17600.0,-421.8203130000038,421.8203130000038,0.0,64.83903086658185,35877.421875,38617.03125,80.07371602018985,-19.926283979810147,933.459221287434,904.7926949292778,0.04385455322273679,63601700.0
4188,BSESN,2020-07-30,37736.070313,38413.808594,37678.421875,38262.828125,14800.0,-335.0585930000016,335.0585930000016,0.0,55.89044236708649,35877.421875,38617.03125,67.84355663843486,-32.15644336156513,875.9096951521715,899.0160949738565,0.01933892405358728,63586900.0
4189,BSESN,2020-07-31,37606.890625,37897.78125,37431.679688,37847.878906,20200.0,-129.1796879999965,129.1796879999965,0.0,52.657488259367206,35877.421875,38617.03125,63.12829725953175,-36.87170274046825,810.5342258307937,881.3197211452439,0.0050215773496851135,63566700.0
4190,BSESN,2020-08-03,36939.601563,37596.019531,36911.230469,37595.730469,14300.0,-667.2890620000035,667.2890620000035,0.0,39.15724017728891,35894.960938,38617.03125,38.37669513512547,-61.62330486487453,696.8462352247952,844.4250239611541,-0.02611964122047794,63552400.0
4191,BSESN,2020-08-04,37687.910156,37745.601563,36987.730469,37092.859375,15100.0,748.3085930000017,0.0,748.3085930000017,54.31329270050171,36038.410156,38617.03125,63.96829700331299,-36.031702996687,659.5273128500121,807.4454817389259,-0.004848217797273846,63567500.0
4192,BSESN,2020-08-05,37663.328125,38139.960938,37550.601563,37892.359375,19800.0,-24.582030999998093,24.582030999998093,0.0,53.80526556284885,36512.921875,38617.03125,54.67426093284718,-45.32573906715282,620.8119003928514,770.1187654697111,-0.012510088119984109,63547700.0
4193,BSESN,2020-08-06,38025.449219,38221.398438,37755.101563,37946.800781,16600.0,362.1210940000019,0.0,362.1210940000019,60.1421856198493,36911.230469,38617.03125,65.31939499680655,-34.680605003193435,612.2916855914518,738.5533494940594,-0.00271314470750339,63564300.0
4194,BSESN,2020-08-07,38040.570313,38109.679688,37787.378906,37951.070313,15300.0,15.121093999994626,0.0,15.121093999994626,60.403892741979924,36911.230469,38617.03125,66.20584634378801,-33.79415365621198,599.8448617146641,710.8116519381804,0.002790051298413365,63579600.0
4195,BSESN,2020-08-10,38182.078125,38430.691406,38073.289063,38168.421875,17200.0,141.50781200000347,0.0,141.50781200000347,63.02539769395698,36911.230469,38617.03125,74.50152855804089,-25.498471441959115,594.5456102133176,687.5584435932079,-0.008076052895592545,63596800.0
4196,BSESN,2020-08-11,38407.011719,38556.269531,38313.058594,38371.339844,18700.0,224.9335940000019,0.0,224.9335940000019,67.02900980166315,36911.230469,38617.03125,87.68792151233056,-12.312078487669442,601.5617470460129,670.3591042837689,0.008822507308078986,63615500.0
4197,BSESN,2020-08-12,38369.628906,38414.371094,38125.808594,38321.128906,25300.0,-37.382813000003814,37.382813000003814,0.0,65.66552141838795,36911.230469,38617.03125,85.49641043926792,-14.503589560732074,597.2212110824985,655.7315256435149,0.016789204274450853,63590200.0
4198,BSESN,2020-08-13,38310.488281,38516.851563,38215.050781,38456.640625,15400.0,-59.140625,59.140625,0.0,63.314515279641924,36911.230469,38617.03125,82.02938042856938,-17.970619571430614,582.2967958850786,641.0445796918277,0.018709274930915676,63574800.0
4199,BSESN,2020-08-14,37877.339844,38540.570313,37654.921875,38432.941406,18600.0,-433.1484369999962,433.1484369999962,0.0,48.607659738980956,36911.230469,38617.03125,56.63670610079296,-43.36329389920704,529.4148654040691,618.718636834276,0.02538571726066685,63556200.0
4200,BSESN,2020-08-17,38050.78125,38119.378906,37734.140625,38062.070313,21500.0,173.4414059999981,0.0,173.4414059999981,53.58853595874203,36911.230469,38617.03125,66.8044471366671,-33.195552863332914,495.7857173246084,594.1320529323425,0.009628315618934069,63577700.0
4201,BSESN,2020-08-18,38528.320313,38571.230469,38062.011719,38084.699219,13600.0,477.5390629999965,0.0,477.5390629999965,64.51454887304769,36911.230469,38571.230469,97.41505084337318,-2.5849491566268297,501.88239872873964,575.682122091622,0.02296642997478049,63591300.0
4202,BSESN,2020-08-19,38614.789063,38788.511719,38550.648438,38727.890625,12800.0,86.46875,0.0,86.46875,66.17808712717174,36911.230469,38788.511719,90.7460506517068,-9.253949348293196,507.8373354558571,562.113164764469,0.01549856362263613,63604100.0
4203,BSESN,2020-08-20,38220.390625,38402.449219,38155.78125,38283.898438,15800.0,-394.3984379999965,394.3984379999965,0.0,53.081707437645946,36911.230469,38788.511719,69.73702826893935,-30.262971731060645,475.2535804533909,544.7412479022535,0.004727066669096391,63588300.0
4204,BSESN,2020-08-21,38434.71875,38579.828125,38411.371094,38471.929688,16800.0,214.328125,0.0,214.328125,58.261005614274914,36987.730469,38788.511719,80.35336224208233,-19.646637757917677,461.40640254030586,528.0742788298639,0.006616733226853411,63605100.0
4205,BSESN,2020-08-24,38799.078125,38894.941406,38545.761719,38566.960938,28100.0,364.359375,0.0,364.359375,65.69025442641868,37550.601563,38894.941406,92.86911851202211,-7.130881487977887,474.36498648259294,517.3324203604097,0.01020819867133893,63633200.0
4206,BSESN,2020-08-25,38843.878906,39008.890625,38679.671875,38948.460938,15700.0,44.80078099999809,0.0,44.80078099999809,66.53532518542028,37654.921875,39008.890625,87.81273799709174,-12.187262002908259,482.68570587346767,510.4030774630213,0.012360036141132458,63648900.0
4207,BSESN,2020-08-26,39073.921875,39111.550781,38765.089844,38930.179688,16400.0,230.0429690000019,0.0,230.0429690000019,70.796948821087,37654.921875,39111.550781,97.4167129428092,-2.583287057190814,502.0551022865693,508.733482427731,0.019927534945531455,63665300.0
4208,BSESN,2020-08-27,39113.46875,39326.980469,39046.941406,39293.53125,14500.0,39.546875,0.0,39.546875,71.51645356002425,37654.921875,39326.980469,87.23060784076795,-12.769392159232051,514.6638661169272,509.9195591655704,0.03263505069498196,63679800.0
4209,BSESN,2020-08-28,39467.308594,39579.578125,39235.03125,39264.480469,22500.0,353.8398440000019,0.0,353.8398440000019,77.29235735228946,37654.921875,39579.578125,94.16677492409369,-5.833225075906313,546.9039522163002,517.3164377757164,0.037227286732778975,63702300.0
4210,BSESN,2020-08-31,38628.289063,40010.171875,38395.890625,39888.148438,27900.0,-839.0195310000054,839.0195310000054,0.0,49.71198045515081,37654.921875,40010.171875,41.32755282878661,-58.67244717121339,499.00042230308463,513.65323468119,0.0025946822801479197,63674400.0
4211,BSESN,2020-09-01,38900.800781,39226.820313,38542.109375,38754.0,22000.0,272.5117180000016,0.0,272.5117180000016,55.64369234233316,37654.921875,40010.171875,52.89794739411944,-47.10205260588056,477.52137868102,506.42686348115603,0.007406792188696665,63696400.0
4212,BSESN,2020-09-02,39086.03125,39141.839844,38736.21875,38892.640625,17100.0,185.2304690000019,0.0,185.2304690000019,59.39964807856145,37654.921875,40010.171875,60.76252520963804,-39.23747479036196,470.0274488269133,499.1469805503075,0.0226486598081439,63713500.0
4213,BSESN,2020-09-03,38990.941406,39236.359375,38943.429688,39165.800781,9200.0,-95.0898440000019,95.0898440000019,0.0,56.56261640759299,37734.140625,40010.171875,55.21895980118894,-44.78104019881106,451.21418347880535,489.56042113600705,0.014471880479156596,63704300.0
4214,BSESN,2020-09-04,38357.179688,38729.660156,38249.769531,38325.0,15400.0,-633.7617180000016,633.7617180000016,0.0,41.36813125812916,38062.011719,40010.171875,15.151114146900504,-84.8488858530995,380.7759133687068,467.80351958254704,-0.011389405582687528,63688900.0
4215,BSESN,2020-09-07,38417.230469,38519.921875,38060.738281,38284.78125,12500.0,60.05078100000537,0.0,60.05078100000537,43.040990842741536,38060.738281,40010.171875,18.286962382161732,-81.71303761783827,326.04028355174523,439.4508723763867,-0.010983672306065562,63701400.0
4216,BSESN,2020-09-08,38365.351563,38746.480469,38275.449219,38498.070313,11900.0,-51.87890600000537,51.87890600000537,0.0,41.850712145433285,38060.738281,40010.171875,15.625732671148281,-84.37426732885172,275.30219608202606,406.6211371175146,-0.01813409757706852,63689500.0
4217,BSESN,2020-09-09,38193.921875,38252.671875,37935.261719,37988.558594,14000.0,-171.42968799999653,171.42968799999653,0.0,37.85883823221104,37935.261719,40010.171875,12.466089447392841,-87.53391055260717,218.73748353929113,369.04440640186994,-0.023509724511457497,63675500.0
4218,BSESN,2020-09-10,38840.320313,38878.25,38367.070313,38516.878906,16500.0,646.3984379999965,0.0,646.3984379999965,56.08362981128766,37935.261719,40010.171875,43.619170275052404,-56.3808297249476,223.4922139683258,339.93396791516113,-0.01588626899923251,63692000.0
4219,BSESN,2020-09-11,38854.550781,38978.519531,38711.800781,38865.171875,11400.0,14.230468000001563,0.0,14.230468000001563,56.40838266492469,37935.261719,40010.171875,44.30500565731469,-55.69499434268531,225.80570432761306,317.10831519765156,0.005857409776316658,63703400.0
4220,BSESN,2020-09-14,38756.628906,39230.160156,38573.171875,39073.511719,14700.0,-97.921875,97.921875,0.0,53.28014064276802,37935.261719,40010.171875,39.585674812225314,-60.414325187774686,217.23355199568323,297.1333625572579,-0.003706141573065369,63688700.0
4221,BSESN,2020-09-15,39044.351563,39102.25,38753.679688,38904.671875,11600.0,287.72265699999843,0.0,287.72265699999843,60.67410798976167,37935.261719,40010.171875,53.45242736379935,-46.547572636200655,230.994116943657,283.90551343453774,-0.001066357613373814,63700300.0
4222,BSESN,2020-09-16,39302.851563,39359.511719,39037.960938,39161.011719,11700.0,258.5,0.0,258.5,66.21669508839614,37935.261719,40010.171875,65.91079811553999,-34.08920188446001,259.76385737932287,279.0771822234948,0.00799955440296185,63712000.0
4223,BSESN,2020-09-17,38979.851563,39234.808594,38926.339844,39120.640625,11400.0,-323.0,323.0,0.0,55.03381976391903,37935.261719,40010.171875,50.343859033094226,-49.656140966905774,253.57759866220294,273.97726551123645,0.016233515604245685,63700600.0
4224,BSESN,2020-09-18,38845.820313,39200.421875,38635.730469,39200.421875,14300.0,-134.03125,134.03125,0.0,50.9166633172071,37935.261719,39359.511719,63.932497384588004,-36.067502615411996,235.14908999594627,266.2116304081784,0.011156187959614483,63686300.0
4225,BSESN,2020-09-21,38034.140625,38990.761719,37938.53125,38812.691406,15800.0,-811.6796879999965,811.6796879999965,0.0,33.437304708553654,37935.261719,39359.511719,6.9425245567841385,-93.05747544321586,153.28166120048263,243.62563656663923,-0.008633074493168968,63670500.0
4226,BSESN,2020-09-22,37734.078125,38209.96875,37531.140625,38200.710938,15300.0,-300.0625,300.0625,0.0,29.16637036428608,37531.140625,39359.511719,11.099360554646779,-88.90063944535322,63.45710403936391,207.5919300611842,-0.012039710179671093,63655200.0
4227,BSESN,2020-09-23,37668.421875,38140.070313,37313.089844,38124.941406,15000.0,-65.65625,65.65625,0.0,28.25519453321813,37313.089844,39359.511719,17.36357665742789,-82.6364233425721,-12.878954751133278,163.49775309872072,-0.030172213528521286,63640200.0
4228,BSESN,2020-09-24,36553.601563,37304.261719,36495.980469,37282.179688,13900.0,-1114.8203120000037,1114.8203120000037,0.0,17.527345421265068,36495.980469,39359.511719,2.012239049250628,-97.98776095074938,-161.471174364764,98.50396760602376,-0.05921955528373202,63626300.0
4229,BSESN,2020-09-25,37388.660156,37471.171875,36730.519531,36991.890625,13500.0,835.0585930000017,0.0,835.0585930000017,37.90417945844949,36495.980469,39359.511719,31.174085737670794,-68.8259142623292,-209.43509200660628,36.91615568349774,-0.035296381254361964,63639800.0
4230,BSESN,2020-09-28,37981.628906,38035.871094,37544.050781,37756.25,13600.0,592.96875,0.0,592.96875,48.35835055337826,36495.980469,39359.511719,51.88169107635881,-48.11830892364118,-197.3245848370425,-9.931992420610321,-0.027218345662246235,63653400.0
4231,BSESN,2020-09-29,37973.21875,38235.941406,37831.351563,38176.859375,10600.0,-8.410155999998096,8.410155999998096,0.0,48.225481464309226,36495.980469,39359.511719,51.58799230844776,-48.41200769155224,-186.25847816187888,-45.19728956886404,-0.033830441307004855,63642800.0
4232,BSESN,2020-09-30,38067.929688,38236.339844,37828.109375,38068.890625,18400.0,94.7109379999965,0.0,94.7109379999965,50.01023228401501,36495.980469,39359.511719,54.895479803127515,-45.10452019687249,-167.91055932336894,-69.73994351976503,-0.023394698502792743,63661200.0
4233,BSESN,2020-10-01,38697.050781,38738.890625,38410.199219,38410.199219,12900.0,629.1210930000016,0.0,629.1210930000016,60.45759392155853,36495.980469,39359.511719,76.86559425534456,-23.134405744655442,-101.43560057155992,-76.07907493012402,-0.0038297436069386626,63674100.0
4234,BSESN,2020-10-05,38973.699219,39263.851563,38819.890625,38956.78125,15500.0,276.6484380000038,0.0,276.6484380000038,64.24864707473284,36495.980469,39359.511719,86.5266879835867,-13.4733120164133,-26.129297656938434,-66.08911947548691,0.024703032027557636,63689600.0
4235,BSESN,2020-10-06,39574.570313,39623.761719,39191.101563,39336.339844,11300.0,600.8710939999946,0.0,600.8710939999946,71.17451751890201,36495.980469,39623.761719,98.42727473348702,-1.5727252665129754,81.10187363692239,-36.65092085300504,0.048775331993088145,63700900.0
4236,BSESN,2020-10-07,39878.949219,39968.039063,39450.820313,39633.191406,15000.0,304.3789060000054,0.0,304.3789060000054,74.10645400227706,36495.980469,39968.039063,97.43409157455035,-2.565908425449653,188.47160007357888,8.373583332311759,0.05868383207917449,63715900.0
4237,BSESN,2020-10-08,40182.671875,40468.878906,40062.230469,40204.320313,14400.0,303.72265599999815,0.0,303.72265599999815,76.82092170603481,36495.980469,40468.878906,92.79601440765452,-7.20398559234547,294.673944055874,65.63365547702423,0.09928078648407102,63730300.0
4238,BSESN,2020-10-09,40509.488281,40585.359375,40066.539063,40226.25,16600.0,326.81640599999815,0.0,326.81640599999815,79.49039191657114,36495.980469,40585.359375,98.14467928396944,-1.8553207160305614,400.5936255000561,132.62564948163063,0.083469910715674,63746900.0
4239,BSESN,2020-10-12,40593.800781,40905.488281,40387.398438,40716.949219,17600.0,84.3125,0.0,84.3125,80.17019538406562,36495.980469,40905.488281,92.93146733629145,-7.0685326637085515,485.7397448594638,203.2484685571973,0.0687746142079586,63764500.0
4240,BSESN,2020-10-13,40625.511719,40786.820313,40461.96875,40592.539063,11000.0,31.71093800000381,0.0,31.71093800000381,80.45138995126099,36495.980469,40905.488281,93.65061648744401,-6.349383512555991,549.4438192423695,272.48753869423183,0.06984640903004835,63775500.0
4241,BSESN,2020-10-14,40794.738281,40880.25,40279.550781,40623.191406,15000.0,169.2265619999962,0.0,169.2265619999962,82.0212313712386,36495.980469,40905.488281,97.48838181670513,-2.5116181832948774,606.592505607965,339.3085320769785,0.07163007327555193,63790500.0
4242,BSESN,2020-10-15,39728.410156,41048.050781,39667.46875,41048.050781,30400.0,-1066.328125,1066.328125,0.0,51.78559515445074,36730.519531,41048.050781,69.43529650190719,-30.564703498092804,559.3911700755125,383.3250596766853,0.026652144134622135,63760100.0
4243,BSESN,2020-10-16,39982.980469,40125.710938,39699.421875,39936.609375,11000.0,254.5703130000038,0.0,254.5703130000038,56.23019101022766,37544.050781,41048.050781,69.60415776255718,-30.395842237442817,536.3428419053525,413.9286161224188,0.02589647044609933,63771100.0
4244,BSESN,2020-10-19,40431.601563,40519.480469,40211.21875,40318.570313,12300.0,448.6210939999947,0.0,448.6210939999947,63.1395256425872,37828.109375,41048.050781,80.85526597312244,-19.144734026877565,547.960303493921,440.7349535967193,0.02165611005303747,63783400.0
4245,BSESN,2020-10-20,40544.371094,40732.011719,40305.589844,40420.289063,12100.0,112.76953100000536,0.0,112.76953100000536,64.75329011574772,37828.109375,41048.050781,84.35748905053224,-15.642510949467772,559.8136014736301,464.5506831721015,0.016686043339451118,63795500.0
4246,BSESN,2020-10-21,40707.308594,40976.019531,40150.480469,40767.140625,16700.0,162.9375,0.0,162.9375,67.15090703023026,38410.199219,41048.050781,87.08258675701795,-12.917413242982043,575.7185944608791,486.78426542985704,0.01305629253903362,63812200.0
4247,BSESN,2020-10-22,40558.488281,40721.570313,40309.050781,40531.308594,13900.0,-148.8203130000038,148.8203130000038,0.0,62.6589712176711,38819.890625,41048.050781,78.02839716518115,-21.971602834818864,569.7471697590299,503.3768462956917,0.0012095931614861666,63798300.0
4248,BSESN,2020-10-23,40685.5,40811.121094,40590.898438,40728.390625,12400.0,127.0117190000019,0.0,127.0117190000019,64.96673702651243,39191.101563,41048.050781,80.47599915572931,-19.52400084427068,568.7078468529216,516.4430464071377,0.0022589463720017466,63810700.0
4249,BSESN,2020-10-26,40145.5,40724.398438,39948.289063,40649.761719,10100.0,-540.0,540.0,0.0,49.8523920613235,39450.820313,41048.050781,43.49276456451886,-56.50723543548114,518.3356383441132,516.8215647945328,-0.011815524252843046,63800600.0
4250,BSESN,2020-10-27,40522.101563,40555.601563,39978.390625,40199.078125,13900.0,376.6015629999965,0.0,376.6015629999965,57.760204308041246,39667.46875,41048.050781,61.90380533788055,-38.09619466211945,503.00556390167185,514.0583646159606,-0.00668313438174406,63814500.0
4251,BSESN,2020-10-28,39922.460938,40664.351563,39774.601563,40664.351563,29400.0,-599.640625,599.640625,0.0,44.78543230336415,39667.46875,41048.050781,18.469904886078943,-81.53009511392106,437.4279849065715,498.7322886740828,0.004884433614081862,63785100.0
4252,BSESN,2020-10-29,39749.851563,40010.828125,39524.25,39537.171875,19500.0,-172.609375,172.609375,0.0,41.67601881353269,39524.25,41048.050781,14.805187516175502,-85.1948124838245,367.29519669210276,472.4448702776868,-0.005830703545993909,63765600.0
4253,BSESN,2020-10-30,39614.070313,39988.25,39241.871094,39779.820313,12000.0,-135.78125,135.78125,0.0,39.20537226901909,39241.871094,41048.050781,20.606987315763973,-79.39301268423603,297.33060254468,437.4220167310855,-0.02022010552132425,63753600.0
4254,BSESN,2020-11-02,39757.578125,39968.03125,39334.921875,39880.378906,15400.0,143.50781200000347,0.0,143.50781200000347,43.30419351008371,39241.871094,41048.050781,28.552365786848714,-71.44763421315129,250.57457102125773,400.05252758911996,-0.019405726313422522,63769000.0
4255,BSESN,2020-11-03,40261.128906,40354.730469,39952.789063,39990.75,21400.0,503.5507809999981,0.0,503.5507809999981,55.46166786098292,39241.871094,41048.050781,56.43169499336742,-43.56830500663258,251.25609499553684,370.2932410704034,-0.010960677662334328,63790400.0
4256,BSESN,2020-11-04,40616.140625,40693.511719,40076.46875,40171.710938,20900.0,355.0117190000019,0.0,355.0117190000019,62.07688040539246,39241.871094,40976.019531,79.2475143233659,-20.752485676634087,277.24675837144605,351.68394453061194,0.0014214618552981229,63811300.0
4257,BSESN,2020-11-05,41340.160156,41370.910156,41030.171875,41112.121094,42600.0,724.0195309999982,0.0,724.0195309999982,71.89869682379002,39241.871094,41370.910156,98.5556864339016,-1.4443135660983966,352.20685028851585,351.78852568219276,0.01609074869425231,63853900.0
4258,BSESN,2020-11-06,41893.058594,41954.929688,41383.289063,41438.761719,19000.0,552.8984380000038,0.0,552.8984380000038,77.12007687556206,39241.871094,41954.929688,97.71950763847032,-2.280492361529688,451.02837205502146,371.63649495675855,0.043530622211704895,63872900.0
4259,BSESN,2020-11-09,42597.429688,42645.328125,42263.640625,42273.96875,24300.0,704.3710939999946,0.0,704.3710939999946,82.02854658654508,39241.871094,42645.328125,98.59265339436561,-1.4073466056343902,579.5018638771508,413.2095687408371,0.051214720978216555,63897200.0
